집계일자,출발영업소코드,도착영업소코드,출발영업소명,도착영업소명,도착지방향1종교통량,도착지방향2종교통량,도착지방향3종교통량,도착지방향4종교통량,도착지방향5종교통량,도착지방향6종교통량,도착지방향총교통량,출발지방향1종교통량,출발지방향2종교통량,출발지방향3종교통량,출발지방향4종교통량,출발지방향5종교통량,출발지방향6종교통량,출발지방향총교통량,Unnamed: 19
20220909,101,102,서울,동수원,2705,13,150,3,0,126,2997,3106,17,244,16,4,160,3547,
20220909,101,103,서울,수원신갈,15702,205,852,247,14,636,17656,13709,254,867,229,26,522,15607,
20220909,101,105,서울,기흥,7026,23,148,39,5,257,7498,4818,25,150,71,6,182,5252,
20220909,101,106,서울,오산,3758,135,216,57,1,190,4357,3478,226,262,70,3,183,4222,
20220909,101,107,서울,안성,2879,24,209,15,2,129,3258,3274,18,188,9,5,169,3663,
20220909,101,108,서울,천안,7652,17,257,14,6,212,8158,5283,16,258,11,1,177,5746,
20220909,101,110,서울,목천,859,4,9,4,2,25,903,359,4,7,47,9,16,442,
20220909,101,111,서울,청주,904,5,416,8,2,29,1364,774,3,303,3,2,36,1121,
20220909,101,113,서울,신탄진,986,1,21,2,0,31,1041,788,3,5,0,3,26,825,
20220909,101,115,서울,대전,832,6,155,1,0,28,1022,593,4,159,0,0,26,782,
20220909,101,119,서울,판암,106,0,3,0,0,3,112,112,0,0,0,0,2,114,
20220909,101,123,서울,구미,84,0,86,0,0,5,175,64,0,50,0,0,2,116,
20220909,101,127,서울,서대구,440,0,240,0,0,16,696,188,0,62,0,0,3,253,
20220909,101,128,서울,금왕꽃동네,99,0,6,1,0,3,109,126,0,4,2,0,2,134,
20220909,101,129,서울,북대구,540,0,11,0,0,12,563,282,0,60,0,0,11,353,
20220909,101,136,서울,음성,876,3,3,0,0,13,895,126,3,0,0,2,4,135,
20220909,101,151,서울,북대전,325,1,116,5,0,7,454,532,0,107,0,0,9,648,
20220909,101,152,서울,유성,301,5,63,0,0,3,372,238,1,60,0,0,4,303,
20220909,101,153,서울,서대전,104,0,2,0,0,3,109,98,0,1,0,0,3,102,
20220909,101,158,서울,전주,157,0,240,0,0,1,398,27,0,77,0,0,0,104,
20220909,101,171,서울,마성,2878,25,106,41,2,103,3155,2660,11,99,33,0,97,2900,
20220909,101,172,서울,용인,2307,35,43,13,1,108,2507,2372,54,52,25,3,110,2616,
20220909,101,173,서울,양지,2716,75,92,20,10,88,3001,2891,183,95,27,20,81,3297,
20220909,101,175,서울,덕평,535,28,62,6,1,7,639,401,76,64,10,2,12,565,
20220909,101,176,서울,이천,661,1,67,3,1,15,748,218,8,34,5,1,6,272,
20220909,101,177,서울,여주,260,2,26,1,0,6,295,235,0,33,1,5,4,278,
20220909,101,178,서울,문막,221,0,123,0,0,7,351,110,0,50,0,1,4,165,
20220909,101,193,서울,일죽,234,0,14,1,0,8,257,279,1,5,6,1,10,302,
20220909,101,195,서울,대소,125,2,31,2,2,7,169,98,1,22,2,1,7,131,
20220909,101,197,서울,증평,215,0,5,0,3,8,231,137,0,11,0,1,3,152,
20220909,101,198,서울,서청주,104,0,0,0,0,1,105,100,0,1,0,0,3,104,
20220909,101,199,서울,오창,184,1,0,0,0,5,190,143,0,1,1,0,3,148,
20220909,101,212,서울,북수원,99,0,0,0,0,3,102,105,2,3,0,0,2,112,
20220909,101,225,서울,서진주,409,0,10,0,0,10,429,136,0,34,0,0,1,171,
20220909,101,229,서울,북천안,901,15,83,10,1,31,1041,755,13,12,6,3,31,820,
20220909,101,239,서울,칠원,394,0,212,1,0,12,619,256,1,126,1,0,3,387,
20220909,101,291,서울,사천,295,3,22,0,0,2,322,100,0,13,0,0,1,114,
20220909,101,292,서울,진주,115,0,100,0,0,3,218,64,0,64,0,0,2,130,
20220909,101,516,서울,통영,358,1,37,0,0,14,410,260,2,30,0,0,12,304,
20220909,101,528,서울,기흥동탄,6046,23,384,115,5,200,6773,5625,16,384,111,4,210,6350,
20220909,101,541,서울,송탄,515,2,3,3,0,37,560,561,8,7,2,2,25,605,
20220909,101,542,서울,서안성,590,4,40,45,10,18,707,2129,21,51,121,12,97,2431,
20220909,101,543,서울,남안성,784,28,23,22,4,32,893,1077,47,41,46,9,44,1264,
20220909,101,555,서울,북진천,750,2,2,3,4,13,774,192,7,3,3,0,7,212,
20220909,101,560,서울,감곡,336,2,17,1,0,11,367,204,0,1,0,0,3,208,
20220909,101,561,서울,북충주,209,0,64,0,0,2,275,185,2,54,2,0,6,249,
20220909,101,562,서울,충주,178,0,5,0,0,8,191,154,1,0,0,1,6,162,
20220909,101,566,서울,점촌함창,119,1,19,0,0,4,143,81,0,20,0,0,2,103,
20220909,101,601,서울,남천안,3278,2,112,13,8,75,3488,351,1,6,2,1,9,370,
20220909,101,673,서울,북오산,1541,13,77,12,1,65,1709,1147,7,81,10,1,57,1303,
20220909,101,677,서울,북평택,3780,14,83,16,21,132,4046,1264,7,137,8,11,65,1492,
20220909,101,705,서울,남이천,146,0,2,0,0,1,149,172,6,4,0,0,4,186,
20220909,101,733,서울,옥산,191,1,15,0,0,3,210,160,2,3,0,0,2,167,
20220909,101,741,서울,평택고덕,157,0,9,0,0,8,174,292,1,11,1,0,21,326,
20220909,102,101,동수원,서울,3106,17,244,16,4,160,3547,2705,13,150,3,0,126,2997,
20220909,102,103,동수원,수원신갈,778,12,4,1,0,31,826,192,7,2,0,0,16,217,
20220909,102,105,동수원,기흥,594,4,2,0,0,23,623,309,1,5,0,0,16,331,
20220909,102,108,동수원,천안,232,2,0,0,0,5,239,114,0,1,0,0,10,125,
20220909,102,171,동수원,마성,595,1,12,1,0,22,631,518,3,15,1,0,31,568,
20220909,102,172,동수원,용인,612,4,2,4,1,23,646,524,10,4,2,0,31,571,
20220909,102,173,동수원,양지,635,9,16,4,9,33,706,1125,21,14,1,2,47,1210,
20220909,102,175,동수원,덕평,242,12,13,2,1,8,278,164,8,13,1,0,9,195,
20220909,102,176,동수원,이천,390,2,22,0,1,20,435,310,9,14,1,0,14,348,
20220909,102,177,동수원,여주,166,0,7,1,0,6,180,197,3,22,8,2,5,237,
20220909,102,178,동수원,문막,195,1,15,0,0,6,217,165,1,16,0,0,8,190,
20220909,102,189,동수원,강릉,199,0,8,0,0,7,214,103,0,12,1,0,10,126,
20220909,102,212,동수원,북수원,2886,6,130,1,0,108,3131,3267,16,134,4,0,122,3543,
20220909,102,213,동수원,부곡,573,8,4,0,0,28,613,560,11,4,5,0,31,611,
20220909,102,214,동수원,동군포,1468,19,1,1,0,52,1541,1136,16,0,5,0,46,1203,
20220909,102,215,동수원,군포,1022,5,1,2,0,54,1084,1369,4,4,0,1,84,1462,
20220909,102,218,동수원,남원주,121,0,0,0,1,6,128,124,0,0,0,0,12,136,
20220909,102,240,동수원,제천,248,0,9,0,0,15,272,136,0,10,0,2,4,152,
20220909,102,253,동수원,서서울,5586,20,23,3,4,217,5853,5096,26,21,7,1,216,5367,
20220909,102,254,동수원,군자,4056,20,34,4,6,166,4286,4833,34,50,10,7,230,5164,
20220909,102,255,동수원,서안산,871,20,3,3,2,42,941,1192,22,3,6,3,54,1280,
20220909,102,256,동수원,안산,405,4,0,0,0,21,430,414,3,1,0,0,20,438,
20220909,102,281,동수원,매송,294,0,0,0,0,5,299,325,2,0,0,0,16,343,
20220909,102,560,동수원,감곡,174,0,3,0,0,5,182,166,0,4,0,0,4,174,
20220909,103,101,수원신갈,서울,13709,254,867,229,26,522,15607,15702,205,852,247,14,636,17656,
20220909,103,102,수원신갈,동수원,192,7,2,0,0,16,217,778,12,4,1,0,31,826,
20220909,103,105,수원신갈,기흥,2564,13,7,2,9,105,2700,2348,16,4,3,6,92,2469,
20220909,103,106,수원신갈,오산,535,16,8,6,3,30,598,505,24,8,7,0,29,573,
20220909,103,107,수원신갈,안성,429,2,25,1,2,20,479,604,6,23,0,4,31,668,
20220909,103,108,수원신갈,천안,991,4,26,1,0,26,1048,782,4,27,2,0,33,848,
20220909,103,110,수원신갈,목천,119,1,1,0,1,2,124,107,1,0,5,2,1,116,
20220909,103,111,수원신갈,청주,182,0,14,0,0,5,201,223,0,15,0,5,11,254,
20220909,103,113,수원신갈,신탄진,215,1,1,1,1,6,225,218,2,0,2,2,5,229,
20220909,103,115,수원신갈,대전,163,0,13,0,0,5,181,176,3,11,0,0,3,193,
20220909,103,171,수원신갈,마성,459,1,2,0,1,18,481,305,0,1,0,0,15,321,
20220909,103,172,수원신갈,용인,235,5,4,3,0,10,257,170,4,1,1,1,5,182,
20220909,103,173,수원신갈,양지,260,23,24,6,1,6,320,270,17,24,13,2,15,341,
20220909,103,176,수원신갈,이천,201,2,11,1,1,5,221,158,4,9,1,1,7,180,
20220909,103,177,수원신갈,여주,112,3,9,4,0,7,135,96,0,14,6,2,1,119,
20220909,103,212,수원신갈,북수원,781,29,13,9,1,37,870,1663,39,20,10,3,73,1808,
20220909,103,213,수원신갈,부곡,146,21,1,1,5,15,189,179,17,5,2,1,13,217,
20220909,103,214,수원신갈,동군포,545,27,6,6,0,25,609,526,16,9,6,4,18,579,
20220909,103,215,수원신갈,군포,298,14,7,0,0,11,330,475,9,6,1,2,23,516,
20220909,103,229,수원신갈,북천안,141,2,3,3,0,2,151,108,1,0,1,0,5,115,
20220909,103,253,수원신갈,서서울,2040,53,46,30,8,94,2271,2466,30,26,26,5,99,2652,
20220909,103,254,수원신갈,군자,1716,46,28,23,24,83,1920,2228,32,30,60,26,112,2488,
20220909,103,255,수원신갈,서안산,377,24,11,7,11,16,446,589,39,11,14,6,27,686,
20220909,103,256,수원신갈,안산,156,5,3,0,0,6,170,184,2,4,0,0,10,200,
20220909,103,528,수원신갈,기흥동탄,1071,6,11,0,0,40,1128,1262,6,4,1,1,62,1336,
20220909,103,543,수원신갈,남안성,113,1,3,4,0,4,125,155,4,6,3,0,1,169,
20220909,103,555,수원신갈,북진천,178,3,7,9,0,3,200,111,4,9,9,1,5,139,
20220909,103,673,수원신갈,북오산,234,2,1,0,1,8,246,210,2,2,0,1,8,223,
20220909,103,677,수원신갈,북평택,517,2,0,1,0,24,544,320,1,1,3,0,14,339,
20220909,105,101,기흥,서울,4818,25,150,71,6,182,5252,7026,23,148,39,5,257,7498,
20220909,105,102,기흥,동수원,309,1,5,0,0,16,331,594,4,2,0,0,23,623,
20220909,105,103,기흥,수원신갈,2348,16,4,3,6,92,2469,2564,13,7,2,9,105,2700,
20220909,105,212,기흥,북수원,579,5,3,2,2,31,622,778,6,3,1,2,36,826,
20220909,105,214,기흥,동군포,163,4,0,7,2,6,182,159,1,1,5,0,8,174,
20220909,105,253,기흥,서서울,725,3,2,16,0,37,783,811,5,2,2,2,38,860,
20220909,105,254,기흥,군자,596,7,2,12,2,28,647,785,8,3,9,4,24,833,
20220909,105,255,기흥,서안산,108,4,3,8,1,6,130,167,8,1,5,2,6,189,
20220909,106,101,오산,서울,3478,226,262,70,3,183,4222,3758,135,216,57,1,190,4357,
20220909,106,103,오산,수원신갈,505,24,8,7,0,29,573,535,16,8,6,3,30,598,
20220909,106,107,오산,안성,964,10,6,1,1,49,1031,798,15,10,5,0,53,881,
20220909,106,108,오산,천안,1850,17,5,4,5,55,1936,656,19,13,3,3,31,725,
20220909,106,111,오산,청주,317,5,29,1,0,8,360,188,6,23,1,1,5,224,
20220909,106,113,오산,신탄진,266,3,8,2,6,10,295,135,0,0,1,9,5,150,
20220909,106,115,오산,대전,166,1,18,0,0,7,192,98,1,18,0,0,10,127,
20220909,106,212,오산,북수원,132,10,5,2,0,19,168,211,4,5,4,1,15,240,
20220909,106,229,오산,북천안,326,1,2,1,1,11,342,132,1,2,6,1,4,146,
20220909,106,253,오산,서서울,253,30,7,3,1,8,302,288,13,8,4,2,9,324,
20220909,106,254,오산,군자,193,16,10,11,1,12,243,282,8,11,14,0,18,333,
20220909,106,528,오산,기흥동탄,189,12,11,5,1,10,228,484,13,30,3,6,30,566,
20220909,106,542,오산,서안성,156,3,6,18,1,10,194,335,10,9,20,2,21,397,
20220909,106,543,오산,남안성,406,5,5,2,1,16,435,309,8,3,10,4,16,350,
20220909,106,555,오산,북진천,468,9,4,2,3,14,500,161,7,2,4,2,6,182,
20220909,106,671,오산,봉담,250,20,8,1,1,21,301,436,12,12,3,1,13,477,
20220909,107,101,안성,서울,3274,18,188,9,5,169,3663,2879,24,209,15,2,129,3258,
20220909,107,103,안성,수원신갈,604,6,23,0,4,31,668,429,2,25,1,2,20,479,
20220909,107,106,안성,오산,798,15,10,5,0,53,881,964,10,6,1,1,49,1031,
20220909,107,108,안성,천안,1176,2,19,3,3,64,1267,1163,13,20,5,2,66,1269,
20220909,107,110,안성,목천,125,1,1,0,0,4,131,112,2,1,0,0,4,119,
20220909,107,111,안성,청주,179,3,16,0,1,13,212,194,4,14,0,0,10,222,
20220909,107,113,안성,신탄진,109,0,0,1,1,3,114,115,0,0,1,0,7,123,
20220909,107,115,안성,대전,106,0,4,2,0,6,118,113,0,5,0,0,4,122,
20220909,107,212,안성,북수원,195,1,3,0,0,5,204,172,1,2,0,0,6,181,
20220909,107,229,안성,북천안,341,5,1,0,2,14,363,255,0,1,0,3,15,274,
20220909,107,253,안성,서서울,297,2,3,0,0,21,323,222,2,0,0,0,11,235,
20220909,107,254,안성,군자,98,2,0,2,0,4,106,122,1,1,1,0,6,131,
20220909,107,520,안성,평택,145,1,0,0,0,12,158,556,4,2,0,0,19,581,
20220909,107,528,안성,기흥동탄,430,6,4,0,1,33,474,407,6,4,1,3,29,450,
20220909,107,540,안성,청북,317,0,1,0,0,15,333,636,5,2,2,2,27,674,
20220909,107,541,안성,송탄,512,6,0,1,0,36,555,950,18,4,5,2,73,1052,
20220909,107,542,안성,서안성,228,6,0,3,0,17,254,365,6,1,2,0,13,387,
20220909,107,671,안성,봉담,414,3,8,0,0,23,448,256,1,6,0,0,13,276,
20220909,107,673,안성,북오산,485,6,1,2,0,47,541,345,1,1,1,0,29,377,
20220909,107,741,안성,평택고덕,109,0,0,1,1,7,118,202,0,0,0,0,16,218,
20220909,107,742,안성,남사진위,657,25,29,15,2,34,762,1220,13,31,15,1,49,1329,
20220909,108,101,천안,서울,5283,16,258,11,1,177,5746,7652,17,257,14,6,212,8158,
20220909,108,102,천안,동수원,114,0,1,0,0,10,125,232,2,0,0,0,5,239,
20220909,108,103,천안,수원신갈,782,4,27,2,0,33,848,991,4,26,1,0,26,1048,
20220909,108,106,천안,오산,656,19,13,3,3,31,725,1850,17,5,4,5,55,1936,
20220909,108,107,천안,안성,1163,13,20,5,2,66,1269,1176,2,19,3,3,64,1267,
20220909,108,108,천안,천안,161,1,3,1,0,6,172,161,1,3,1,0,6,172,
20220909,108,110,천안,목천,879,5,19,3,4,18,928,358,6,25,10,7,13,419,
20220909,108,111,천안,청주,653,7,35,2,11,22,730,506,3,33,4,8,15,569,
20220909,108,113,천안,신탄진,387,3,8,0,5,18,421,257,4,1,1,0,14,277,
20220909,108,115,천안,대전,316,1,34,0,0,17,368,327,0,38,0,1,14,380,
20220909,108,212,천안,북수원,231,0,0,1,0,8,240,272,0,0,0,0,7,279,
20220909,108,229,천안,북천안,1597,24,45,8,5,68,1747,2206,25,41,9,7,96,2384,
20220909,108,253,천안,서서울,462,2,1,1,0,18,484,610,1,2,0,0,19,632,
20220909,108,254,천안,군자,181,3,2,1,1,13,201,250,1,8,0,1,12,272,
20220909,108,520,천안,평택,108,0,2,0,0,1,111,710,0,1,2,0,26,739,
20220909,108,528,천안,기흥동탄,396,8,5,1,7,24,441,539,9,13,1,5,21,588,
20220909,108,540,천안,청북,150,1,1,0,1,7,160,479,1,3,1,0,18,502,
20220909,108,541,천안,송탄,362,18,4,2,1,22,409,919,21,6,3,1,34,984,
20220909,108,542,천안,서안성,533,8,34,9,10,23,617,1037,6,27,16,7,33,1126,
20220909,108,601,천안,남천안,1401,3,7,3,10,45,1469,132,6,5,1,3,4,151,
20220909,108,671,천안,봉담,408,0,22,0,0,22,452,353,1,17,1,0,19,391,
20220909,108,673,천안,북오산,401,3,0,0,0,23,427,411,2,1,0,1,17,432,
20220909,108,733,천안,옥산,218,2,0,1,0,7,228,141,1,0,0,0,3,145,
20220909,108,742,천안,남사진위,431,11,7,11,3,21,484,2483,19,10,15,2,62,2591,
20220909,109,114,계룡,남대전,97,0,0,2,0,4,103,143,2,2,3,0,7,157,
20220909,109,119,계룡,판암,157,2,3,0,0,5,167,327,2,2,0,0,13,344,
20220909,109,151,계룡,북대전,133,0,3,5,8,7,156,144,0,0,0,3,4,151,
20220909,109,152,계룡,유성,238,7,6,4,1,20,276,322,7,7,0,2,14,352,
20220909,109,154,계룡,안영,110,4,4,1,0,10,129,222,1,1,1,1,11,237,
20220909,109,155,계룡,논산,219,2,3,10,2,11,247,136,4,3,0,1,6,150,
20220909,110,101,목천,서울,359,4,7,47,9,16,442,859,4,9,4,2,25,903,
20220909,110,103,목천,수원신갈,107,1,0,5,2,1,116,119,1,1,0,1,2,124,
20220909,110,107,목천,안성,112,2,1,0,0,4,119,125,1,1,0,0,4,131,
20220909,110,108,목천,천안,358,6,25,10,7,13,419,879,5,19,3,4,18,928,
20220909,110,111,목천,청주,119,2,1,1,2,4,129,276,6,1,4,5,15,307,
20220909,110,113,목천,신탄진,95,2,1,4,1,4,107,189,3,2,9,6,12,221,
20220909,110,115,목천,대전,90,2,6,0,0,7,105,250,2,10,0,0,13,275,
20220909,110,229,목천,북천안,143,5,2,7,4,6,167,277,2,3,9,1,9,301,
20220909,111,101,청주,서울,774,3,303,3,2,36,1121,904,5,416,8,2,29,1364,
20220909,111,103,청주,수원신갈,223,0,15,0,5,11,254,182,0,14,0,0,5,201,
20220909,111,106,청주,오산,188,6,23,1,1,5,224,317,5,29,1,0,8,360,
20220909,111,107,청주,안성,194,4,14,0,0,10,222,179,3,16,0,1,13,212,
20220909,111,108,청주,천안,506,3,33,4,8,15,569,653,7,35,2,11,22,730,
20220909,111,110,청주,목천,276,6,1,4,5,15,307,119,2,1,1,2,4,129,
20220909,111,113,청주,신탄진,620,7,4,2,3,14,650,238,2,2,2,3,7,254,
20220909,111,115,청주,대전,446,2,5,0,1,28,482,266,2,13,0,1,11,293,
20220909,111,212,청주,북수원,110,0,6,0,0,4,120,101,0,8,0,1,6,116,
20220909,111,229,청주,북천안,148,8,2,5,1,6,170,236,2,4,4,0,10,256,
20220909,111,253,청주,서서울,226,0,2,2,1,11,242,170,0,2,3,0,4,179,
20220909,111,254,청주,군자,99,0,1,0,1,3,104,115,2,12,0,0,5,134,
20220909,111,528,청주,기흥동탄,130,0,1,0,1,6,138,122,0,0,0,0,5,127,
20220909,111,540,청주,청북,110,1,2,1,0,1,115,124,2,1,0,0,6,133,
20220909,111,671,청주,봉담,219,0,12,0,0,15,246,138,0,10,0,1,4,153,
20220909,111,673,청주,북오산,141,1,0,0,0,4,146,101,0,2,0,0,5,108,
20220909,111,742,청주,남사진위,115,1,7,3,0,2,128,189,1,3,4,2,6,205,
20220909,112,113,남청주,신탄진,575,19,5,3,4,16,622,236,18,5,2,3,10,274,
20220909,112,115,남청주,대전,660,24,43,0,0,27,754,762,39,40,1,0,44,886,
20220909,112,116,남청주,옥천,357,4,4,2,0,12,379,270,4,5,2,1,9,291,
20220909,112,119,남청주,판암,139,1,0,0,0,11,151,238,8,2,0,0,12,260,
20220909,112,151,남청주,북대전,189,8,11,3,1,10,222,162,8,3,1,0,12,186,
20220909,112,152,남청주,유성,244,6,25,2,0,9,286,311,10,27,0,0,12,360,
20220909,112,153,남청주,서대전,107,4,1,0,0,9,121,222,9,2,1,0,8,242,
20220909,112,167,남청주,광주,237,1,0,2,3,5,248,98,1,2,6,3,3,113,
20220909,112,190,남청주,동서울,406,0,0,1,4,12,423,553,1,1,1,0,17,573,
20220909,112,196,남청주,진천,132,5,0,8,7,6,158,549,11,4,3,5,17,589,
20220909,112,197,남청주,증평,153,6,1,1,3,4,168,304,2,0,1,6,9,322,
20220909,112,198,남청주,서청주,113,13,0,2,2,6,136,427,10,2,1,5,22,467,
20220909,112,199,남청주,오창,139,6,1,8,4,5,163,451,1,2,4,4,12,474,
20220909,112,533,남청주,보은,120,4,0,0,0,9,133,131,4,2,2,0,9,148,
20220909,113,101,신탄진,서울,788,3,5,0,3,26,825,986,1,21,2,0,31,1041,
20220909,113,103,신탄진,수원신갈,218,2,0,2,2,5,229,215,1,1,1,1,6,225,
20220909,113,106,신탄진,오산,135,0,0,1,9,5,150,266,3,8,2,6,10,295,
20220909,113,107,신탄진,안성,115,0,0,1,0,7,123,109,0,0,1,1,3,114,
20220909,113,108,신탄진,천안,257,4,1,1,0,14,277,387,3,8,0,5,18,421,
20220909,113,110,신탄진,목천,189,3,2,9,6,12,221,95,2,1,4,1,4,107,
20220909,113,111,신탄진,청주,238,2,2,2,3,7,254,620,7,4,2,3,14,650,
20220909,113,112,신탄진,남청주,236,18,5,2,3,10,274,575,19,5,3,4,16,622,
20220909,113,115,신탄진,대전,374,3,2,0,1,35,415,650,4,2,0,1,48,705,
20220909,113,116,신탄진,옥천,221,2,1,1,1,18,244,252,5,2,1,4,20,284,
20220909,113,119,신탄진,판암,128,0,0,1,0,14,143,386,2,1,0,1,19,409,
20220909,113,151,신탄진,북대전,106,0,2,0,0,5,113,197,1,2,1,6,8,215,
20220909,113,152,신탄진,유성,204,2,2,0,0,10,218,269,1,0,0,0,16,286,
20220909,113,153,신탄진,서대전,117,0,0,1,0,6,124,222,3,0,1,0,16,242,
20220909,113,190,신탄진,동서울,945,3,0,2,1,42,993,1064,1,0,1,1,23,1090,
20220909,113,196,신탄진,진천,296,10,5,10,5,12,338,340,3,2,5,7,10,367,
20220909,113,197,신탄진,증평,382,4,1,4,16,14,421,262,0,1,2,13,9,287,
20220909,113,198,신탄진,서청주,639,4,4,7,9,27,690,890,6,4,5,4,33,942,
20220909,113,199,신탄진,오창,580,5,1,4,26,16,632,597,1,1,3,14,25,641,
20220909,113,253,신탄진,서서울,173,0,0,0,0,7,180,180,0,0,0,2,6,188,
20220909,113,297,신탄진,동충주,196,0,0,2,2,3,203,108,0,0,0,3,1,112,
20220909,114,109,남대전,계룡,143,2,2,3,0,7,157,97,0,0,2,0,4,103,
20220909,114,115,남대전,대전,314,0,0,3,0,16,333,305,3,3,0,0,6,317,
20220909,114,119,남대전,판암,92,0,1,0,0,8,101,513,2,3,0,0,23,541,
20220909,114,151,남대전,북대전,138,0,1,1,1,8,149,123,0,0,0,0,5,128,
20220909,114,152,남대전,유성,532,2,1,0,0,32,567,742,2,2,1,0,27,774,
20220909,114,153,남대전,서대전,1271,9,10,4,0,77,1371,1750,3,4,3,1,69,1830,
20220909,114,154,남대전,안영,610,5,11,0,0,38,664,688,0,8,0,0,38,734,
20220909,114,164,남대전,무주,425,3,0,0,0,22,450,282,0,1,0,0,15,298,
20220909,114,200,남대전,금산,298,2,3,1,1,19,324,275,2,4,0,0,8,289,
20220909,114,579,남대전,남세종,185,1,1,0,0,10,197,307,2,1,1,0,19,330,
20220909,115,101,대전,서울,593,4,159,0,0,26,782,832,6,155,1,0,28,1022,
20220909,115,103,대전,수원신갈,176,3,11,0,0,3,193,163,0,13,0,0,5,181,
20220909,115,106,대전,오산,98,1,18,0,0,10,127,166,1,18,0,0,7,192,
20220909,115,107,대전,안성,113,0,5,0,0,4,122,106,0,4,2,0,6,118,
20220909,115,108,대전,천안,327,0,38,0,1,14,380,316,1,34,0,0,17,368,
20220909,115,110,대전,목천,250,2,10,0,0,13,275,90,2,6,0,0,7,105,
20220909,115,111,대전,청주,266,2,13,0,1,11,293,446,2,5,0,1,28,482,
20220909,115,112,대전,남청주,762,39,40,1,0,44,886,660,24,43,0,0,27,754,
20220909,115,113,대전,신탄진,650,4,2,0,1,48,705,374,3,2,0,1,35,415,
20220909,115,114,대전,남대전,305,3,3,0,0,6,317,314,0,0,3,0,16,333,
20220909,115,115,대전,대전,130,0,0,1,0,5,136,130,0,0,1,0,5,136,
20220909,115,116,대전,옥천,2215,15,8,1,2,90,2331,1875,9,12,0,0,85,1981,
20220909,115,117,대전,금강,195,0,0,0,0,13,208,109,0,0,0,0,9,118,
20220909,115,118,대전,영동,467,1,3,0,0,21,492,354,2,0,0,0,15,371,
20220909,115,120,대전,황간,360,0,0,0,0,11,371,239,0,1,0,0,5,245,
20220909,115,122,대전,김천,344,0,0,2,0,11,357,154,0,0,0,0,3,157,
20220909,115,123,대전,구미,208,1,0,0,0,13,222,209,0,0,0,0,5,214,
20220909,115,127,대전,서대구,362,2,11,1,0,20,396,156,0,9,1,0,2,168,
20220909,115,129,대전,북대구,379,2,1,0,1,7,390,157,0,5,0,0,4,166,
20220909,115,135,대전,경주,193,0,1,0,0,7,201,121,0,3,1,0,4,129,
20220909,115,151,대전,북대전,443,2,2,0,5,33,485,340,4,0,0,7,30,381,
20220909,115,152,대전,유성,263,2,3,0,0,11,279,249,1,7,0,0,10,267,
20220909,115,153,대전,서대전,460,2,1,0,0,24,487,594,2,0,0,0,42,638,
20220909,115,154,대전,안영,196,0,5,0,0,14,215,225,1,2,0,0,12,240,
20220909,115,155,대전,논산,165,2,2,1,0,5,175,109,1,3,0,0,6,119,
20220909,115,164,대전,무주,401,1,14,0,0,21,437,223,0,16,0,0,17,256,
20220909,115,190,대전,동서울,732,0,5,0,0,28,765,817,0,2,0,0,30,849,
20220909,115,196,대전,진천,218,10,12,0,0,14,254,105,4,6,1,0,8,124,
20220909,115,197,대전,증평,351,0,9,1,0,13,374,131,0,5,0,0,7,143,
20220909,115,198,대전,서청주,552,5,2,2,1,32,594,378,4,0,0,0,20,402,
20220909,115,199,대전,오창,405,0,11,0,0,22,438,304,1,4,0,0,12,321,
20220909,115,200,대전,금산,284,0,4,0,0,16,304,344,0,3,1,0,17,365,
20220909,115,204,대전,추부,410,5,1,1,0,25,442,430,2,0,0,0,31,463,
20220909,115,229,대전,북천안,91,1,6,0,0,3,101,97,0,3,0,0,2,102,
20220909,115,239,대전,칠원,247,0,13,0,0,5,265,169,0,12,0,0,5,186,
20220909,115,253,대전,서서울,178,0,0,0,1,5,184,200,0,0,0,0,4,204,
20220909,115,298,대전,서산,264,0,22,0,0,12,298,175,1,20,0,0,10,206,
20220909,115,527,대전,포항,187,2,6,0,0,9,204,120,1,5,0,0,10,136,
20220909,115,573,대전,예산수덕사,428,2,0,0,0,21,451,240,0,0,0,0,11,251,
20220909,115,578,대전,서세종,354,20,6,0,0,15,395,200,9,4,0,0,11,224,
20220909,115,579,대전,남세종,504,3,8,0,0,36,551,480,6,11,0,0,20,517,
20220909,115,595,대전,서공주,340,0,4,0,0,21,365,158,2,5,0,0,14,179,
20220909,115,641,대전,울산,123,0,0,0,0,6,129,121,0,1,0,1,2,125,
20220909,115,671,대전,봉담,116,0,14,0,0,5,135,111,0,12,0,0,2,125,
20220909,116,112,옥천,남청주,270,4,5,2,1,9,291,357,4,4,2,0,12,379,
20220909,116,113,옥천,신탄진,252,5,2,1,4,20,284,221,2,1,1,1,18,244,
20220909,116,115,옥천,대전,1875,9,12,0,0,85,1981,2215,15,8,1,2,90,2331,
20220909,116,119,옥천,판암,418,1,0,1,1,17,438,858,4,0,0,0,32,894,
20220909,116,151,옥천,북대전,380,2,0,1,2,27,412,466,1,2,0,0,24,493,
20220909,116,152,옥천,유성,295,2,0,0,0,14,311,428,3,1,0,0,15,447,
20220909,116,153,옥천,서대전,473,3,1,0,5,20,502,997,2,3,0,0,43,1045,
20220909,116,154,옥천,안영,290,3,0,0,0,15,308,442,2,0,1,0,18,463,
20220909,116,190,옥천,동서울,96,0,0,2,1,2,101,327,0,0,0,0,8,335,
20220909,116,198,옥천,서청주,133,0,0,1,0,6,140,190,0,1,1,0,14,206,
20220909,116,579,옥천,남세종,256,2,1,0,0,23,282,529,1,0,0,0,19,549,
20220909,117,115,금강,대전,109,0,0,0,0,9,118,195,0,0,0,0,13,208,
20220909,117,117,금강,금강,220,1,0,0,1,16,238,220,1,0,0,1,16,238,
20220909,118,115,영동,대전,354,2,0,0,0,15,371,467,1,3,0,0,21,492,
20220909,118,119,영동,판암,132,0,0,0,0,3,135,197,3,1,0,0,8,209,
20220909,119,101,판암,서울,112,0,0,0,0,2,114,106,0,3,0,0,3,112,
20220909,119,109,판암,계룡,327,2,2,0,0,13,344,157,2,3,0,0,5,167,
20220909,119,112,판암,남청주,238,8,2,0,0,12,260,139,1,0,0,0,11,151,
20220909,119,113,판암,신탄진,386,2,1,0,1,19,409,128,0,0,1,0,14,143,
20220909,119,114,판암,남대전,513,2,3,0,0,23,541,92,0,1,0,0,8,101,
20220909,119,116,판암,옥천,858,4,0,0,0,32,894,418,1,0,1,1,17,438,
20220909,119,118,판암,영동,197,3,1,0,0,8,209,132,0,0,0,0,3,135,
20220909,119,120,판암,황간,178,0,0,0,0,7,185,110,0,0,0,0,4,114,
20220909,119,151,판암,북대전,362,0,0,0,3,21,386,160,0,0,0,0,9,169,
20220909,119,152,판암,유성,364,0,0,0,0,19,383,317,1,2,0,0,21,341,
20220909,119,153,판암,서대전,1726,2,5,0,3,105,1841,1867,4,4,0,0,98,1973,
20220909,119,154,판암,안영,624,2,4,0,0,28,658,529,4,4,0,0,26,563,
20220909,119,155,판암,논산,245,0,2,0,0,8,255,213,2,3,0,0,7,225,
20220909,119,164,판암,무주,412,1,0,0,0,12,425,156,0,1,0,0,6,163,
20220909,119,167,판암,광주,173,3,0,0,0,2,178,98,0,1,0,0,2,101,
20220909,119,190,판암,동서울,140,0,0,0,0,7,147,133,1,0,0,0,4,138,
20220909,119,200,판암,금산,403,0,2,0,0,11,416,239,0,3,0,0,9,251,
20220909,119,204,판암,추부,422,1,2,0,0,23,448,187,2,1,0,0,8,198,
20220909,119,579,판암,남세종,349,3,0,0,0,6,358,200,3,2,0,0,7,212,
20220909,120,115,황간,대전,239,0,1,0,0,5,245,360,0,0,0,0,11,371,
20220909,120,119,황간,판암,110,0,0,0,0,4,114,178,0,0,0,0,7,185,
20220909,120,122,황간,김천,213,0,4,1,0,5,223,198,1,2,0,1,8,210,
20220909,120,123,황간,구미,191,0,3,0,1,1,196,412,0,3,0,0,17,432,
20220909,120,127,황간,서대구,125,1,1,0,0,6,133,154,0,0,0,0,3,157,
20220909,120,129,황간,북대구,123,0,0,1,0,0,124,127,0,0,0,0,5,132,
20220909,120,130,황간,동김천,110,0,1,0,0,6,117,137,0,3,1,0,3,144,
20220909,120,723,황간,북구미,102,0,0,0,0,3,105,149,0,0,0,0,6,155,
20220909,121,121,추풍령,추풍령,104,0,1,0,0,17,122,104,0,1,0,0,17,122,
20220909,121,122,추풍령,김천,147,3,0,2,1,5,158,157,0,0,1,0,4,162,
20220909,121,123,추풍령,구미,95,0,0,0,0,6,101,145,1,0,0,0,9,155,
20220909,121,130,추풍령,동김천,101,0,1,0,0,0,102,119,0,0,0,0,1,120,
20220909,122,115,김천,대전,154,0,0,0,0,3,157,344,0,0,2,0,11,357,
20220909,122,120,김천,황간,198,1,2,0,1,8,210,213,0,4,1,0,5,223,
20220909,122,121,김천,추풍령,157,0,0,1,0,4,162,147,3,0,2,1,5,158,
20220909,122,123,김천,구미,683,2,3,0,4,32,724,733,3,4,5,3,40,788,
20220909,122,125,김천,남구미,118,8,1,3,1,3,134,200,6,1,1,1,15,224,
20220909,122,127,김천,서대구,292,4,1,0,0,14,311,397,2,1,1,0,15,416,
20220909,122,129,김천,북대구,304,1,1,0,0,10,316,388,1,0,1,0,13,403,
20220909,122,130,김천,동김천,352,0,1,1,1,21,376,312,1,1,0,0,15,329,
20220909,122,723,김천,북구미,407,3,0,0,0,17,427,424,2,0,0,0,18,444,
20220909,123,101,구미,서울,64,0,50,0,0,2,116,84,0,86,0,0,5,175,
20220909,123,115,구미,대전,209,0,0,0,0,5,214,208,1,0,0,0,13,222,
20220909,123,120,구미,황간,412,0,3,0,0,17,432,191,0,3,0,1,1,196,
20220909,123,121,구미,추풍령,145,1,0,0,0,9,155,95,0,0,0,0,6,101,
20220909,123,122,구미,김천,733,3,4,5,3,40,788,683,2,3,0,4,32,724,
20220909,123,125,구미,남구미,311,7,0,1,0,13,332,259,12,2,0,1,11,285,
20220909,123,126,구미,왜관,428,15,2,1,1,14,461,393,14,3,1,1,25,437,
20220909,123,127,구미,서대구,1773,8,8,3,1,91,1884,1881,11,19,2,2,89,2004,
20220909,123,129,구미,북대구,1663,6,48,0,1,61,1779,1816,2,58,1,0,72,1949,
20220909,123,130,구미,동김천,1319,3,5,9,7,56,1399,981,4,8,6,4,43,1046,
20220909,123,131,구미,경산,160,0,4,0,1,11,176,244,6,8,5,6,13,282,
20220909,123,135,구미,경주,218,0,0,0,1,6,225,168,0,2,0,3,14,187,
20220909,123,190,구미,동서울,202,0,12,5,1,7,227,136,0,3,0,1,4,144,
20220909,123,201,구미,칠곡,131,1,1,0,0,5,138,181,0,1,0,0,11,193,
20220909,123,230,구미,팔공산,232,0,0,0,0,11,243,203,0,1,0,0,13,217,
20220909,123,231,구미,화원옥포,102,1,0,0,1,2,106,103,1,0,1,0,0,105,
20220909,123,239,구미,칠원,229,1,1,1,0,7,239,179,0,2,3,0,3,187,
20220909,123,527,구미,포항,242,0,1,0,1,9,253,223,0,1,1,1,7,233,
20220909,123,621,구미,동대구,257,1,3,2,5,12,280,288,1,1,1,4,9,304,
20220909,123,641,구미,울산,115,0,2,2,1,6,126,131,0,3,1,4,6,145,
20220909,123,723,구미,북구미,146,3,0,0,0,10,159,153,3,1,0,0,12,169,
20220909,123,730,구미,유천,155,0,0,0,0,6,161,157,0,0,0,0,8,165,
20220909,123,772,구미,북달성,402,1,9,3,0,18,433,449,1,8,5,2,17,482,
20220909,123,773,구미,북다사,113,2,0,0,0,6,121,143,0,0,0,0,7,150,
20220909,123,774,구미,남칠곡,396,2,2,1,2,6,409,448,2,3,0,5,18,476,
20220909,124,127,상주,서대구,123,0,2,0,0,5,130,243,3,2,0,0,6,254,
20220909,124,129,상주,북대구,114,1,1,0,0,3,119,181,0,1,0,0,10,192,
20220909,125,122,남구미,김천,200,6,1,1,1,15,224,118,8,1,3,1,3,134,
20220909,125,123,남구미,구미,259,12,2,0,1,11,285,311,7,0,1,0,13,332,
20220909,125,126,남구미,왜관,188,8,2,4,4,18,224,169,13,2,5,2,8,199,
20220909,125,127,남구미,서대구,1714,9,30,6,5,83,1847,1525,9,28,6,6,94,1668,
20220909,125,129,남구미,북대구,1379,5,8,2,1,63,1458,1340,5,12,3,0,62,1422,
20220909,125,130,남구미,동김천,284,12,2,8,5,13,324,146,5,1,4,0,3,159,
20220909,125,131,남구미,경산,215,4,5,1,2,8,235,223,7,11,3,6,13,263,
20220909,125,135,남구미,경주,212,3,9,1,0,9,234,101,0,12,0,4,8,125,
20220909,125,230,남구미,팔공산,224,3,3,1,0,15,246,173,1,4,0,0,13,191,
20220909,125,239,남구미,칠원,237,2,8,0,0,12,259,132,0,6,0,1,8,147,
20220909,125,527,남구미,포항,251,0,2,1,0,19,273,163,0,0,0,1,7,171,
20220909,125,621,남구미,동대구,228,1,1,1,6,13,250,171,1,3,1,7,13,196,
20220909,125,641,남구미,울산,126,0,4,2,32,5,169,66,0,4,2,38,2,112,
20220909,125,723,남구미,북구미,226,5,0,0,0,11,242,242,5,0,0,0,10,257,
20220909,125,772,남구미,북달성,330,3,7,1,1,21,363,273,4,10,5,1,20,313,
20220909,125,774,남구미,남칠곡,282,3,2,0,5,14,306,323,3,1,1,5,17,350,
20220909,126,123,왜관,구미,393,14,3,1,1,25,437,428,15,2,1,1,14,461,
20220909,126,125,왜관,남구미,169,13,2,5,2,8,199,188,8,2,4,4,18,224,
20220909,126,127,왜관,서대구,2196,50,6,2,3,103,2360,2361,39,20,7,2,105,2534,
20220909,126,129,왜관,북대구,2599,30,13,6,2,90,2740,3061,31,18,4,1,121,3236,
20220909,126,131,왜관,경산,222,6,5,1,2,17,253,365,18,13,9,10,18,433,
20220909,126,132,왜관,영천,120,2,1,3,2,1,129,132,1,1,2,1,4,141,
20220909,126,135,왜관,경주,169,3,4,0,2,4,182,189,6,0,0,0,8,203,
20220909,126,527,왜관,포항,227,13,1,1,3,11,256,320,7,3,2,5,10,347,
20220909,126,621,왜관,동대구,365,7,2,2,1,17,394,447,13,1,1,2,20,484,
20220909,126,730,왜관,유천,186,5,0,0,0,1,192,166,2,0,0,0,4,172,
20220909,126,772,왜관,북달성,427,19,4,8,3,30,491,452,13,9,6,2,29,511,
20220909,126,773,왜관,북다사,132,5,1,0,0,2,140,163,2,1,1,0,4,171,
20220909,126,774,왜관,남칠곡,500,7,3,2,2,16,530,658,8,4,2,1,33,706,
20220909,127,101,서대구,서울,188,0,62,0,0,3,253,440,0,240,0,0,16,696,
20220909,127,115,서대구,대전,156,0,9,1,0,2,168,362,2,11,1,0,20,396,
20220909,127,120,서대구,황간,154,0,0,0,0,3,157,125,1,1,0,0,6,133,
20220909,127,122,서대구,김천,397,2,1,1,0,15,416,292,4,1,0,0,14,311,
20220909,127,123,서대구,구미,1881,11,19,2,2,89,2004,1773,8,8,3,1,91,1884,
20220909,127,124,서대구,상주,243,3,2,0,0,6,254,123,0,2,0,0,5,130,
20220909,127,125,서대구,남구미,1525,9,28,6,6,94,1668,1714,9,30,6,5,83,1847,
20220909,127,126,서대구,왜관,2361,39,20,7,2,105,2534,2196,50,6,2,3,103,2360,
20220909,127,129,서대구,북대구,939,7,4,2,2,28,982,180,3,1,1,0,6,191,
20220909,127,130,서대구,동김천,783,5,17,3,6,28,842,454,3,14,1,4,12,488,
20220909,127,131,서대구,경산,987,15,4,8,5,74,1093,1097,28,9,8,6,55,1203,
20220909,127,132,서대구,영천,784,4,3,2,0,30,823,429,4,0,3,1,20,457,
20220909,127,133,서대구,건천,265,1,1,1,1,10,279,114,1,0,1,1,6,123,
20220909,127,134,서대구,선산,309,1,0,1,0,8,319,123,1,0,1,0,7,132,
20220909,127,135,서대구,경주,852,6,19,4,1,28,910,664,2,15,6,1,25,713,
20220909,127,190,서대구,동서울,406,2,9,1,0,12,430,633,0,4,3,0,12,652,
20220909,127,201,서대구,칠곡,2710,9,13,1,3,116,2852,921,5,4,0,0,36,966,
20220909,127,202,서대구,다부,305,0,1,3,2,8,319,474,4,1,3,2,9,493,
20220909,127,203,서대구,가산,1707,11,18,0,1,63,1800,2660,14,19,6,4,84,2787,
20220909,127,205,서대구,군위,664,3,1,0,0,24,692,734,3,3,0,1,25,766,
20220909,127,206,서대구,의성,1113,2,7,0,0,42,1164,666,4,2,0,0,23,695,
20220909,127,207,서대구,남안동,769,3,1,3,0,32,808,568,4,2,1,1,17,593,
20220909,127,208,서대구,서안동,433,1,8,0,0,17,459,352,2,0,0,2,9,365,
20220909,127,210,서대구,영주,514,1,6,0,0,25,546,345,2,4,2,1,11,365,
20220909,127,230,서대구,팔공산,1015,7,3,8,0,41,1074,682,3,4,5,1,29,724,
20220909,127,253,서대구,서서울,117,1,1,0,0,6,125,188,0,2,0,0,4,194,
20220909,127,518,서대구,칠곡물류,280,39,33,47,11,10,420,296,34,35,53,8,15,441,
20220909,127,524,서대구,청통와촌,743,22,6,5,3,28,807,441,12,4,7,2,16,482,
20220909,127,525,서대구,북영천,1087,3,0,3,3,27,1123,490,1,2,2,0,17,512,
20220909,127,527,서대구,포항,1626,11,17,7,12,94,1767,1087,14,18,3,7,40,1169,
20220909,127,565,서대구,문경새재,104,0,1,0,0,3,108,687,0,1,2,0,12,702,
20220909,127,566,서대구,점촌함창,124,1,0,0,0,4,129,441,0,0,2,0,7,450,
20220909,127,570,서대구,북상주,356,0,0,0,1,10,367,232,2,3,1,1,11,250,
20220909,127,621,서대구,동대구,1104,15,37,7,9,51,1223,707,8,2,7,6,39,769,
20220909,127,641,서대구,울산,322,1,26,4,7,14,374,353,2,14,1,4,15,389,
20220909,127,716,서대구,청송,293,0,0,0,0,11,304,155,0,0,0,0,1,156,
20220909,127,723,서대구,북구미,299,1,0,0,0,10,310,339,3,0,0,0,18,360,
20220909,127,748,서대구,동청송영양,301,1,1,0,0,9,312,99,3,0,0,0,2,104,
20220909,127,749,서대구,영덕,364,1,0,0,0,10,375,148,2,2,1,1,5,159,
20220909,127,774,서대구,남칠곡,461,0,4,0,0,12,477,236,1,5,0,1,14,257,
20220909,128,101,금왕꽃동네,서울,126,0,4,2,0,2,134,99,0,6,1,0,3,109,
20220909,128,136,금왕꽃동네,음성,449,5,0,2,3,12,471,156,3,2,1,0,5,167,
20220909,128,188,금왕꽃동네,서충주,227,1,0,0,3,13,244,155,1,2,2,2,15,177,
20220909,128,190,금왕꽃동네,동서울,455,4,3,7,0,19,488,251,1,2,4,0,5,263,
20220909,128,297,금왕꽃동네,동충주,1590,1,5,3,11,39,1649,719,3,12,2,6,27,769,
20220909,128,523,금왕꽃동네,남제천,292,1,1,0,4,7,305,175,2,1,1,5,5,189,
20220909,128,542,금왕꽃동네,서안성,121,2,3,3,6,4,139,137,1,1,2,4,3,148,
20220909,128,543,금왕꽃동네,남안성,338,2,11,9,14,24,398,209,3,6,4,3,8,233,
20220909,128,555,금왕꽃동네,북진천,67,3,2,9,16,4,101,129,0,1,2,1,4,137,
20220909,128,561,금왕꽃동네,북충주,415,1,1,1,0,15,433,101,1,0,0,0,2,104,
20220909,129,101,북대구,서울,282,0,60,0,0,11,353,540,0,11,0,0,12,563,
20220909,129,115,북대구,대전,157,0,5,0,0,4,166,379,2,1,0,1,7,390,
20220909,129,120,북대구,황간,127,0,0,0,0,5,132,123,0,0,1,0,0,124,
20220909,129,122,북대구,김천,388,1,0,1,0,13,403,304,1,1,0,0,10,316,
20220909,129,123,북대구,구미,1816,2,58,1,0,72,1949,1663,6,48,0,1,61,1779,
20220909,129,124,북대구,상주,181,0,1,0,0,10,192,114,1,1,0,0,3,119,
20220909,129,125,북대구,남구미,1340,5,12,3,0,62,1422,1379,5,8,2,1,63,1458,
20220909,129,126,북대구,왜관,3061,31,18,4,1,121,3236,2599,30,13,6,2,90,2740,
20220909,129,127,북대구,서대구,180,3,1,1,0,6,191,939,7,4,2,2,28,982,
20220909,129,130,북대구,동김천,794,1,14,1,0,20,830,491,5,15,0,0,11,522,
20220909,129,131,북대구,경산,798,16,7,4,4,38,867,1745,52,27,15,12,101,1952,
20220909,129,132,북대구,영천,648,8,2,1,5,27,691,791,11,3,1,4,27,837,
20220909,129,133,북대구,건천,177,1,0,0,1,13,192,181,4,2,1,2,10,200,
20220909,129,135,북대구,경주,649,8,2,2,1,23,685,928,7,11,4,1,27,978,
20220909,129,190,북대구,동서울,518,2,0,2,2,11,535,638,2,1,2,0,12,655,
20220909,129,203,북대구,가산,568,2,1,0,0,17,588,936,1,2,1,0,14,954,
20220909,129,205,북대구,군위,241,0,1,0,0,5,247,227,0,0,0,0,5,232,
20220909,129,206,북대구,의성,419,1,1,0,0,10,431,257,0,0,0,0,14,271,
20220909,129,207,북대구,남안동,408,1,1,1,1,11,423,321,1,0,0,1,14,337,
20220909,129,208,북대구,서안동,236,0,36,0,0,7,279,190,1,43,0,0,7,241,
20220909,129,210,북대구,영주,314,0,14,0,0,12,340,172,1,17,0,0,4,194,
20220909,129,230,북대구,팔공산,245,3,0,0,0,16,264,303,3,1,2,0,17,326,
20220909,129,231,북대구,화원옥포,314,0,4,5,0,13,336,254,1,3,0,2,7,267,
20220909,129,233,북대구,현풍,196,1,4,1,0,11,213,171,3,4,0,2,7,187,
20220909,129,241,북대구,동고령,187,1,3,0,0,6,197,101,2,10,0,0,5,118,
20220909,129,242,북대구,고령,165,1,1,0,4,4,175,112,1,3,0,4,5,125,
20220909,129,253,북대구,서서울,150,0,1,0,0,6,157,187,0,0,2,0,3,192,
20220909,129,518,북대구,칠곡물류,266,27,12,3,1,17,326,206,18,8,1,2,17,252,
20220909,129,524,북대구,청통와촌,820,23,5,4,0,36,888,971,38,11,4,9,36,1069,
20220909,129,525,북대구,북영천,1080,1,4,0,0,48,1133,1021,4,4,1,1,42,1073,
20220909,129,526,북대구,서포항,329,0,1,2,0,7,339,162,0,0,2,0,6,170,
20220909,129,527,북대구,포항,1869,11,7,6,12,70,1975,2423,13,12,7,26,100,2581,
20220909,129,565,북대구,문경새재,120,0,0,0,0,3,123,570,0,0,0,0,9,579,
20220909,129,566,북대구,점촌함창,116,1,0,0,1,4,122,415,0,1,0,0,4,420,
20220909,129,570,북대구,북상주,317,0,1,0,0,11,329,204,0,1,0,0,4,209,
20220909,129,621,북대구,동대구,282,2,1,4,0,14,303,526,7,6,1,8,19,567,
20220909,129,641,북대구,울산,185,1,0,1,2,8,197,450,2,6,5,11,13,487,
20220909,129,723,북대구,북구미,336,1,2,1,0,12,352,364,0,0,0,0,13,377,
20220909,129,725,북대구,임고,194,0,0,0,0,2,196,176,0,0,0,0,5,181,
20220909,129,730,북대구,유천,293,1,0,0,0,11,305,295,1,1,0,0,8,305,
20220909,129,772,북대구,북달성,389,2,0,1,1,25,418,527,0,3,0,0,25,555,
20220909,129,773,북대구,북다사,133,0,1,1,0,10,145,395,1,2,1,0,17,416,
20220909,130,120,동김천,황간,137,0,3,1,0,3,144,110,0,1,0,0,6,117,
20220909,130,121,동김천,추풍령,119,0,0,0,0,1,120,101,0,1,0,0,0,102,
20220909,130,122,동김천,김천,312,1,1,0,0,15,329,352,0,1,1,1,21,376,
20220909,130,123,동김천,구미,981,4,8,6,4,43,1046,1319,3,5,9,7,56,1399,
20220909,130,125,동김천,남구미,146,5,1,4,0,3,159,284,12,2,8,5,13,324,
20220909,130,127,동김천,서대구,454,3,14,1,4,12,488,783,5,17,3,6,28,842,
20220909,130,129,동김천,북대구,491,5,15,0,0,11,522,794,1,14,1,0,20,830,
20220909,130,723,동김천,북구미,525,4,2,0,0,18,549,606,4,1,0,0,24,635,
20220909,130,774,동김천,남칠곡,134,1,0,2,5,4,146,225,0,0,2,1,2,230,
20220909,131,123,경산,구미,244,6,8,5,6,13,282,160,0,4,0,1,11,176,
20220909,131,125,경산,남구미,223,7,11,3,6,13,263,215,4,5,1,2,8,235,
20220909,131,126,경산,왜관,365,18,13,9,10,18,433,222,6,5,1,2,17,253,
20220909,131,127,경산,서대구,1097,28,9,8,6,55,1203,987,15,4,8,5,74,1093,
20220909,131,129,경산,북대구,1745,52,27,15,12,101,1952,798,16,7,4,4,38,867,
20220909,131,132,경산,영천,696,13,6,5,4,41,765,403,4,0,2,2,22,433,
20220909,131,133,경산,건천,438,14,16,2,7,16,493,245,3,9,1,7,4,269,
20220909,131,135,경산,경주,838,3,16,2,2,34,895,511,5,11,2,0,15,544,
20220909,131,201,경산,칠곡,204,9,3,0,1,10,227,172,5,0,0,1,8,186,
20220909,131,230,경산,팔공산,825,28,12,5,0,61,931,648,11,5,4,2,41,711,
20220909,131,621,경산,동대구,1658,25,11,3,11,92,1800,989,9,1,6,3,61,1069,
20220909,131,641,경산,울산,216,4,11,0,6,16,253,200,0,8,1,2,8,219,
20220909,131,772,경산,북달성,132,8,3,5,1,7,156,116,3,4,0,0,2,125,
20220909,131,776,경산,연경,519,23,9,3,8,24,586,572,11,9,7,7,23,629,
20220909,131,777,경산,파군재,191,1,0,1,0,12,205,129,0,1,0,1,9,140,
20220909,131,779,경산,율암,364,8,3,0,0,29,404,118,1,0,0,0,5,124,
20220909,132,126,영천,왜관,132,1,1,2,1,4,141,120,2,1,3,2,1,129,
20220909,132,127,영천,서대구,429,4,0,3,1,20,457,784,4,3,2,0,30,823,
20220909,132,129,영천,북대구,791,11,3,1,4,27,837,648,8,2,1,5,27,691,
20220909,132,131,영천,경산,403,4,0,2,2,22,433,696,13,6,5,4,41,765,
20220909,132,135,영천,경주,195,6,2,3,2,3,211,287,2,5,1,3,9,307,
20220909,132,140,영천,부산,248,0,2,1,1,13,265,529,1,1,0,0,15,546,
20220909,132,230,영천,팔공산,327,1,2,0,2,11,343,419,4,2,0,0,16,441,
20220909,132,252,영천,대동,111,1,0,1,1,6,120,302,1,0,8,6,8,325,
20220909,132,621,영천,동대구,1057,3,14,0,2,37,1113,1314,4,11,0,1,40,1370,
20220909,132,641,영천,울산,200,4,5,4,8,9,230,516,1,3,2,5,25,552,
20220909,132,730,영천,유천,110,0,0,0,0,3,113,123,0,0,0,0,2,125,
20220909,132,776,영천,연경,130,0,1,1,0,9,141,274,0,0,0,3,12,289,
20220909,132,779,영천,율암,220,2,1,0,1,9,233,145,0,1,0,0,6,152,
20220909,133,127,건천,서대구,114,1,0,1,1,6,123,265,1,1,1,1,10,279,
20220909,133,129,건천,북대구,181,4,2,1,2,10,200,177,1,0,0,1,13,192,
20220909,133,131,건천,경산,245,3,9,1,7,4,269,438,14,16,2,7,16,493,
20220909,133,135,건천,경주,279,0,0,0,1,14,294,293,3,0,1,1,14,312,
20220909,133,140,건천,부산,328,0,3,1,0,11,343,497,2,4,0,0,16,519,
20220909,133,230,건천,팔공산,123,0,0,0,0,3,126,137,0,1,0,0,5,143,
20220909,133,252,건천,대동,246,2,0,2,6,5,261,450,0,2,0,4,11,467,
20220909,133,621,건천,동대구,296,3,0,0,0,17,316,433,4,3,0,0,26,466,
20220909,133,641,건천,울산,267,2,1,2,3,8,283,419,2,3,1,3,16,444,
20220909,134,127,선산,서대구,123,1,0,1,0,7,132,309,1,0,1,0,8,319,
20220909,135,115,경주,대전,121,0,3,1,0,4,129,193,0,1,0,0,7,201,
20220909,135,123,경주,구미,168,0,2,0,3,14,187,218,0,0,0,1,6,225,
20220909,135,125,경주,남구미,101,0,12,0,4,8,125,212,3,9,1,0,9,234,
20220909,135,126,경주,왜관,189,6,0,0,0,8,203,169,3,4,0,2,4,182,
20220909,135,127,경주,서대구,664,2,15,6,1,25,713,852,6,19,4,1,28,910,
20220909,135,129,경주,북대구,928,7,11,4,1,27,978,649,8,2,2,1,23,685,
20220909,135,131,경주,경산,511,5,11,2,0,15,544,838,3,16,2,2,34,895,
20220909,135,132,경주,영천,287,2,5,1,3,9,307,195,6,2,3,2,3,211,
20220909,135,133,경주,건천,293,3,0,1,1,14,312,279,0,0,0,1,14,294,
20220909,135,137,경주,통도사,224,2,1,1,0,5,233,267,4,1,1,0,7,280,
20220909,135,138,경주,양산,293,0,12,0,5,19,329,549,7,12,4,2,27,601,
20220909,135,139,경주,서울산,364,4,24,0,2,16,410,357,4,21,0,0,21,403,
20220909,135,140,경주,부산,1898,4,8,2,4,90,2006,2512,5,8,2,3,105,2635,
20220909,135,146,경주,동창원,119,0,1,0,0,5,125,183,0,0,0,0,6,189,
20220909,135,148,경주,서김해,267,3,9,3,4,4,290,518,2,14,2,0,19,555,
20220909,135,149,경주,동김해,222,0,7,0,0,13,242,376,0,10,1,0,18,405,
20220909,135,230,경주,팔공산,324,1,4,1,0,15,345,396,2,1,1,0,20,420,
20220909,135,245,경주,장유,398,0,7,2,5,23,435,682,1,5,0,3,32,723,
20220909,135,250,경주,남양산,399,4,10,2,0,13,428,680,4,16,0,1,17,718,
20220909,135,252,경주,대동,1653,7,41,7,22,67,1797,2711,7,37,4,15,111,2885,
20220909,135,261,경주,동광주,143,0,4,0,0,0,147,243,0,4,0,0,4,251,
20220909,135,289,경주,마산,248,2,6,2,3,8,269,377,0,4,0,0,12,393,
20220909,135,529,경주,노포,144,0,70,0,0,5,219,148,0,66,0,0,11,225,
20220909,135,544,경주,완주,113,0,1,3,1,0,118,118,1,1,0,0,3,123,
20220909,135,621,경주,동대구,1003,5,38,1,0,37,1084,1209,1,40,1,0,43,1294,
20220909,135,641,경주,울산,404,1,24,3,3,19,454,488,1,22,1,3,22,537,
20220909,135,730,경주,유천,156,1,0,0,0,5,162,121,0,0,0,0,6,127,
20220909,135,755,경주,광재,94,0,0,1,2,3,100,150,4,0,1,1,1,157,
20220909,135,776,경주,연경,166,0,0,1,0,12,179,302,0,0,0,1,12,315,
20220909,135,779,경주,율암,362,4,1,1,0,12,380,201,1,0,0,0,7,209,
20220909,136,101,음성,서울,126,3,0,0,2,4,135,876,3,3,0,0,13,895,
20220909,136,128,음성,금왕꽃동네,156,3,2,1,0,5,167,449,5,0,2,3,12,471,
20220909,136,190,음성,동서울,520,1,2,1,1,20,545,1202,0,1,4,1,37,1245,
20220909,136,253,음성,서서울,119,0,0,1,0,6,126,503,0,0,0,1,10,514,
20220909,136,297,음성,동충주,803,4,8,7,6,24,852,361,2,2,1,3,17,386,
20220909,136,523,음성,남제천,207,0,0,0,10,3,220,199,1,0,1,14,5,220,
20220909,136,542,음성,서안성,133,1,1,3,4,2,144,1317,2,0,18,10,34,1381,
20220909,136,543,음성,남안성,225,3,5,2,13,10,258,1412,1,9,10,10,29,1471,
20220909,137,135,통도사,경주,267,4,1,1,0,7,280,224,2,1,1,0,5,233,
20220909,137,138,통도사,양산,300,11,12,0,0,23,346,272,12,12,1,1,16,314,
20220909,137,139,통도사,서울산,143,6,2,0,1,3,155,219,5,2,1,1,9,237,
20220909,137,140,통도사,부산,890,17,5,1,8,41,962,822,11,9,1,12,40,895,
20220909,137,250,통도사,남양산,305,10,11,0,1,21,348,284,7,11,0,1,19,322,
20220909,137,252,통도사,대동,440,12,8,6,7,22,495,403,7,6,2,10,17,445,
20220909,137,641,통도사,울산,760,26,10,1,1,38,836,918,17,18,1,1,46,1001,
20220909,137,771,통도사,배내골,114,1,0,0,0,8,123,96,1,0,0,0,4,101,
20220909,138,135,양산,경주,549,7,12,4,2,27,601,293,0,12,0,5,19,329,
20220909,138,137,양산,통도사,272,12,12,1,1,16,314,300,11,12,0,0,23,346,
20220909,138,139,양산,서울산,707,18,26,1,0,41,793,616,7,27,3,1,41,695,
20220909,138,140,양산,부산,4555,85,21,12,10,193,4876,4681,94,26,11,12,203,5027,
20220909,138,148,양산,서김해,218,8,3,3,4,12,248,198,8,4,3,2,7,222,
20220909,138,149,양산,동김해,284,14,2,6,0,19,325,223,11,1,2,4,15,256,
20220909,138,245,양산,장유,190,15,2,2,2,9,220,149,13,0,4,3,8,177,
20220909,138,250,양산,남양산,191,9,6,1,0,7,214,356,10,1,0,2,19,388,
20220909,138,252,양산,대동,1830,95,16,28,30,79,2078,1816,78,19,24,29,87,2053,
20220909,138,286,양산,통도사휴게소,273,7,0,0,0,22,302,368,5,1,0,0,14,388,
20220909,138,289,양산,마산,170,9,3,3,0,5,190,115,7,2,0,2,6,132,
20220909,138,529,양산,노포,419,8,1,1,0,26,455,317,2,0,0,1,16,336,
20220909,138,641,양산,울산,412,26,24,3,2,19,486,499,16,28,4,1,23,571,
20220909,138,755,양산,광재,108,4,4,0,0,2,118,112,3,5,1,0,6,127,
20220909,139,135,서울산,경주,357,4,21,0,0,21,403,364,4,24,0,2,16,410,
20220909,139,137,서울산,통도사,219,5,2,1,1,9,237,143,6,2,0,1,3,155,
20220909,139,138,서울산,양산,616,7,27,3,1,41,695,707,18,26,1,0,41,793,
20220909,139,140,서울산,부산,1605,30,4,1,1,70,1711,1652,28,7,1,3,64,1755,
20220909,139,148,서울산,서김해,153,1,1,0,2,6,163,146,0,0,1,0,8,155,
20220909,139,149,서울산,동김해,173,0,15,1,0,8,197,140,0,17,4,0,6,167,
20220909,139,245,서울산,장유,203,0,0,1,0,7,211,169,0,1,0,1,10,181,
20220909,139,250,서울산,남양산,540,11,5,2,0,29,587,591,6,4,1,0,35,637,
20220909,139,251,서울산,물금,121,0,1,1,0,4,127,142,7,1,1,1,10,162,
20220909,139,252,서울산,대동,1020,9,8,0,5,42,1084,1011,9,9,2,8,55,1094,
20220909,139,289,서울산,마산,227,0,0,0,1,9,237,113,1,1,1,0,3,119,
20220909,139,529,서울산,노포,165,2,0,0,0,7,174,169,1,0,0,0,8,178,
20220909,139,641,서울산,울산,1296,11,14,3,8,82,1414,1084,8,12,0,7,64,1175,
20220909,139,771,서울산,배내골,126,0,1,0,0,10,137,109,0,1,1,0,9,120,
20220909,140,132,부산,영천,529,1,1,0,0,15,546,248,0,2,1,1,13,265,
20220909,140,133,부산,건천,497,2,4,0,0,16,519,328,0,3,1,0,11,343,
20220909,140,135,부산,경주,2512,5,8,2,3,105,2635,1898,4,8,2,4,90,2006,
20220909,140,137,부산,통도사,822,11,9,1,12,40,895,890,17,5,1,8,41,962,
20220909,140,138,부산,양산,4681,94,26,11,12,203,5027,4555,85,21,12,10,193,4876,
20220909,140,139,부산,서울산,1652,28,7,1,3,64,1755,1605,30,4,1,1,70,1711,
20220909,140,146,부산,동창원,789,0,0,2,1,22,814,278,2,0,0,0,14,294,
20220909,140,149,부산,동김해,112,0,0,1,0,8,121,146,1,0,0,1,2,150,
20220909,140,250,부산,남양산,7226,69,147,8,8,383,7841,7269,65,146,7,3,367,7857,
20220909,140,251,부산,물금,472,61,8,6,13,26,586,774,50,9,7,6,47,893,
20220909,140,252,부산,대동,960,13,10,10,9,52,1054,1047,9,9,9,23,58,1155,
20220909,140,286,부산,통도사휴게소,1378,2,2,0,0,44,1426,1322,4,4,0,0,44,1374,
20220909,140,289,부산,마산,1653,5,2,2,3,29,1694,751,6,5,1,0,19,782,
20220909,140,291,부산,사천,136,1,0,0,0,2,139,109,3,0,0,0,3,115,
20220909,140,641,부산,울산,365,3,0,1,0,20,389,421,2,2,0,1,17,443,
20220909,140,722,부산,활천,297,3,1,0,0,20,321,192,12,2,0,0,8,214,
20220909,140,755,부산,광재,985,7,11,0,0,42,1045,837,6,3,0,1,51,898,
20220909,140,756,부산,한림,332,3,5,2,0,9,351,268,1,3,3,0,7,282,
20220909,140,757,부산,진영,735,4,3,6,0,31,779,489,2,4,9,0,27,531,
20220909,140,771,부산,배내골,171,1,0,0,0,15,187,102,0,0,0,0,5,107,
20220909,142,144,군북,함안,375,2,8,0,0,27,412,855,5,9,2,0,45,916,
20220909,142,145,군북,산인,3045,14,32,5,5,130,3231,6119,6,28,3,2,210,6368,
20220909,142,148,군북,서김해,97,0,0,3,1,3,104,168,0,0,1,1,7,177,
20220909,142,150,군북,북부산,380,0,0,0,0,16,396,567,0,0,0,0,29,596,
20220909,142,244,군북,서부산,394,2,3,4,6,17,426,657,1,0,3,4,25,690,
20220909,142,245,군북,장유,101,2,1,1,0,2,107,142,0,1,1,0,5,149,
20220909,142,291,군북,사천,144,5,0,2,0,6,157,136,8,1,2,0,4,151,
20220909,142,292,군북,진주,143,2,2,0,0,13,160,135,1,2,0,0,13,151,
20220909,142,293,군북,문산,147,3,0,0,0,11,161,158,2,0,0,0,9,169,
20220909,142,294,군북,북창원,191,3,0,0,1,7,202,684,2,1,1,0,19,707,
20220909,143,144,장지,함안,98,1,0,0,0,4,103,114,0,1,0,1,2,118,
20220909,143,145,장지,산인,612,2,3,0,0,37,654,671,2,3,0,2,41,719,
20220909,144,142,함안,군북,855,5,9,2,0,45,916,375,2,8,0,0,27,412,
20220909,144,143,함안,장지,114,0,1,0,1,2,118,98,1,0,0,0,4,103,
20220909,144,145,함안,산인,1457,7,10,3,4,82,1563,1545,3,7,4,3,75,1637,
20220909,144,150,함안,북부산,143,1,0,1,1,8,154,119,0,1,0,1,11,132,
20220909,144,244,함안,서부산,154,1,0,1,2,8,166,148,2,1,0,3,6,160,
20220909,144,291,함안,사천,351,3,2,2,3,9,370,124,3,2,0,3,6,138,
20220909,144,292,함안,진주,276,6,0,0,2,5,289,169,2,0,0,0,10,181,
20220909,144,293,함안,문산,222,2,2,1,0,9,236,156,0,0,0,0,9,165,
20220909,144,294,함안,북창원,172,1,2,1,0,7,183,251,5,1,1,0,17,275,
20220909,144,295,함안,진성,238,1,6,1,0,11,257,127,0,6,1,0,9,143,
20220909,145,142,산인,군북,6119,6,28,3,2,210,6368,3045,14,32,5,5,130,3231,
20220909,145,143,산인,장지,671,2,3,0,2,41,719,612,2,3,0,0,37,654,
20220909,145,144,산인,함안,1545,3,7,4,3,75,1637,1457,7,10,3,4,82,1563,
20220909,145,221,산인,생초,544,0,0,0,0,17,561,127,1,0,0,1,7,136,
20220909,145,223,산인,단성,1019,0,2,0,0,27,1048,269,1,4,0,1,9,284,
20220909,145,224,산인,함양,524,1,4,1,0,17,547,136,2,6,1,1,6,152,
20220909,145,225,산인,서진주,713,8,2,2,2,22,749,387,4,0,1,0,12,404,
20220909,145,261,산인,동광주,835,1,60,3,1,31,931,456,3,52,5,0,15,531,
20220909,145,271,산인,순천,234,0,2,0,1,6,243,173,0,2,0,0,4,179,
20220909,145,272,산인,광양,2879,2,31,5,2,59,2978,778,4,22,5,2,35,846,
20220909,145,275,산인,옥곡,548,1,23,5,37,10,624,460,3,28,3,15,11,520,
20220909,145,277,산인,하동,1299,3,1,3,0,41,1347,396,3,1,3,7,15,425,
20220909,145,278,산인,진교,1985,3,15,1,0,51,2055,421,3,19,0,0,11,454,
20220909,145,279,산인,곤양,420,1,8,0,0,10,439,143,0,8,0,0,3,154,
20220909,145,291,산인,사천,4277,27,37,3,3,121,4468,1721,31,33,4,2,63,1854,
20220909,145,292,산인,진주,2229,16,130,3,9,87,2474,1492,11,137,3,5,73,1721,
20220909,145,293,산인,문산,1724,12,14,4,3,67,1824,1156,10,9,5,0,42,1222,
20220909,145,295,산인,진성,1639,8,3,2,2,54,1708,784,7,5,4,1,22,823,
20220909,145,296,산인,지수,329,7,1,0,0,14,351,127,4,0,1,0,4,136,
20220909,145,544,산인,완주,529,0,6,2,9,14,560,299,1,12,3,0,15,330,
20220909,145,545,산인,소양,318,0,24,0,0,8,350,207,1,24,0,0,7,239,
20220909,145,556,산인,동순천,172,0,8,0,1,6,187,137,0,11,0,1,7,156,
20220909,145,569,산인,북광주,118,0,0,2,4,4,128,188,0,6,2,0,3,199,
20220909,146,135,동창원,경주,183,0,0,0,0,6,189,119,0,1,0,0,5,125,
20220909,146,140,동창원,부산,278,2,0,0,0,14,294,789,0,0,2,1,22,814,
20220909,146,147,동창원,진례,139,9,4,3,1,9,165,252,12,6,3,5,15,293,
20220909,146,148,동창원,서김해,284,5,2,1,1,20,313,716,4,4,0,3,39,766,
20220909,146,149,동창원,동김해,209,4,3,1,0,16,233,408,2,4,2,0,27,443,
20220909,146,150,동창원,북부산,938,2,4,0,1,56,1001,2223,7,5,3,2,94,2334,
20220909,146,244,동창원,서부산,1346,9,7,1,8,56,1427,2843,9,19,7,14,90,2982,
20220909,146,245,동창원,장유,821,6,2,0,0,59,888,1463,3,7,5,1,70,1549,
20220909,146,250,동창원,남양산,144,3,3,1,0,4,155,321,5,3,1,0,10,340,
20220909,146,251,동창원,물금,130,6,1,0,0,3,140,329,5,2,0,0,14,350,
20220909,146,289,동창원,마산,2564,17,14,2,12,162,2771,1956,19,10,4,3,138,2130,
20220909,146,294,동창원,북창원,85,5,0,2,1,8,101,157,2,0,0,0,9,168,
20220909,146,753,동창원,금정,117,0,0,0,0,7,124,161,0,0,0,1,9,171,
20220909,146,755,동창원,광재,96,10,1,2,0,7,116,204,17,1,2,2,6,232,
20220909,147,146,진례,동창원,252,12,6,3,5,15,293,139,9,4,3,1,9,165,
20220909,147,148,진례,서김해,152,2,4,4,0,10,172,242,6,3,7,0,11,269,
20220909,147,149,진례,동김해,219,3,3,4,0,18,247,274,13,7,1,0,15,310,
20220909,147,150,진례,북부산,613,11,8,0,1,28,661,1100,24,6,2,0,45,1177,
20220909,147,244,진례,서부산,940,23,11,17,13,49,1053,1412,36,15,11,10,56,1540,
20220909,147,245,진례,장유,823,8,13,4,0,68,916,996,12,17,3,1,62,1091,
20220909,147,289,진례,마산,422,22,18,10,0,33,505,506,19,12,12,2,30,581,
20220909,148,135,서김해,경주,518,2,14,2,0,19,555,267,3,9,3,4,4,290,
20220909,148,138,서김해,양산,198,8,4,3,2,7,222,218,8,3,3,4,12,248,
20220909,148,139,서김해,서울산,146,0,0,1,0,8,155,153,1,1,0,2,6,163,
20220909,148,142,서김해,군북,168,0,0,1,1,7,177,97,0,0,3,1,3,104,
20220909,148,146,서김해,동창원,716,4,4,0,3,39,766,284,5,2,1,1,20,313,
20220909,148,147,서김해,진례,242,6,3,7,0,11,269,152,2,4,4,0,10,172,
20220909,148,149,서김해,동김해,497,12,0,2,0,54,565,469,8,5,1,2,37,522,
20220909,148,150,서김해,북부산,6303,44,23,15,9,423,6817,5879,34,16,20,5,337,6291,
20220909,148,250,서김해,남양산,852,8,9,8,4,44,925,620,10,8,4,1,42,685,
20220909,148,251,서김해,물금,699,15,7,5,4,32,762,699,27,10,7,6,36,785,
20220909,148,289,서김해,마산,1601,8,37,3,0,64,1713,1215,5,39,2,2,63,1326,
20220909,148,291,서김해,사천,150,0,1,0,0,6,157,102,1,1,1,1,10,116,
20220909,148,294,서김해,북창원,110,0,1,0,0,12,123,150,2,0,0,1,9,162,
20220909,148,529,서김해,노포,183,1,3,2,0,11,200,261,2,5,3,2,17,290,
20220909,148,641,서김해,울산,356,0,7,14,1,16,394,451,1,11,11,5,25,504,
20220909,149,135,동김해,경주,376,0,10,1,0,18,405,222,0,7,0,0,13,242,
20220909,149,138,동김해,양산,223,11,1,2,4,15,256,284,14,2,6,0,19,325,
20220909,149,139,동김해,서울산,140,0,17,4,0,6,167,173,0,15,1,0,8,197,
20220909,149,140,동김해,부산,146,1,0,0,1,2,150,112,0,0,1,0,8,121,
20220909,149,146,동김해,동창원,408,2,4,2,0,27,443,209,4,3,1,0,16,233,
20220909,149,147,동김해,진례,274,13,7,1,0,15,310,219,3,3,4,0,18,247,
20220909,149,148,동김해,서김해,469,8,5,1,2,37,522,497,12,0,2,0,54,565,
20220909,149,150,동김해,북부산,10296,97,76,15,10,658,11152,8368,88,53,14,4,519,9046,
20220909,149,245,동김해,장유,626,15,6,7,2,49,705,435,19,9,4,1,31,499,
20220909,149,250,동김해,남양산,895,13,44,1,0,58,1011,736,9,37,5,0,40,827,
20220909,149,251,동김해,물금,719,26,4,9,1,50,809,807,15,2,6,2,59,891,
20220909,149,289,동김해,마산,888,7,9,9,2,41,956,640,9,10,10,4,33,706,
20220909,149,529,동김해,노포,192,1,1,0,0,16,210,264,2,2,0,0,22,290,
20220909,149,641,동김해,울산,273,1,3,1,0,26,304,338,2,4,0,0,21,365,
20220909,150,142,북부산,군북,567,0,0,0,0,29,596,380,0,0,0,0,16,396,
20220909,150,144,북부산,함안,119,0,1,0,1,11,132,143,1,0,1,1,8,154,
20220909,150,146,북부산,동창원,2223,7,5,3,2,94,2334,938,2,4,0,1,56,1001,
20220909,150,147,북부산,진례,1100,24,6,2,0,45,1177,613,11,8,0,1,28,661,
20220909,150,148,북부산,서김해,5879,34,16,20,5,337,6291,6303,44,23,15,9,423,6817,
20220909,150,149,북부산,동김해,8368,88,53,14,4,519,9046,10296,97,76,15,10,658,11152,
20220909,150,235,북부산,창녕,154,1,0,0,0,3,158,188,0,2,0,0,9,199,
20220909,150,237,북부산,남지,115,0,0,1,0,5,121,126,0,0,0,1,3,130,
20220909,150,238,북부산,칠서,103,2,3,3,0,8,119,175,5,8,9,1,5,203,
20220909,150,245,북부산,장유,4214,7,57,4,12,231,4525,3217,16,63,1,7,174,3478,
20220909,150,261,북부산,동광주,185,1,0,0,0,6,192,238,1,0,0,1,7,247,
20220909,150,272,북부산,광양,677,0,0,0,0,15,692,348,0,1,0,1,9,359,
20220909,150,275,북부산,옥곡,99,0,0,1,4,4,108,194,0,0,0,8,4,206,
20220909,150,277,북부산,하동,262,0,0,0,1,11,274,133,0,0,0,2,6,141,
20220909,150,278,북부산,진교,318,0,0,0,0,12,330,122,0,1,0,0,6,129,
20220909,150,280,북부산,거창,171,0,2,0,0,3,176,98,3,3,0,0,5,109,
20220909,150,289,북부산,마산,5223,8,50,0,2,145,5428,3202,11,53,0,6,125,3397,
20220909,150,291,북부산,사천,589,1,0,0,0,30,620,472,3,0,0,0,12,487,
20220909,150,292,북부산,진주,241,0,8,0,0,7,256,328,2,8,1,2,11,352,
20220909,150,293,북부산,문산,211,1,0,1,0,14,227,222,1,0,0,0,10,233,
20220909,150,294,북부산,북창원,201,0,0,0,0,14,215,336,0,1,0,0,15,352,
20220909,150,295,북부산,진성,189,0,0,0,0,9,198,144,1,0,0,0,6,151,
20220909,150,544,북부산,완주,91,0,2,1,4,4,102,149,0,0,0,0,5,154,
20220909,151,101,북대전,서울,532,0,107,0,0,9,648,325,1,116,5,0,7,454,
20220909,151,109,북대전,계룡,144,0,0,0,3,4,151,133,0,3,5,8,7,156,
20220909,151,112,북대전,남청주,162,8,3,1,0,12,186,189,8,11,3,1,10,222,
20220909,151,113,북대전,신탄진,197,1,2,1,6,8,215,106,0,2,0,0,5,113,
20220909,151,114,북대전,남대전,123,0,0,0,0,5,128,138,0,1,1,1,8,149,
20220909,151,115,북대전,대전,340,4,0,0,7,30,381,443,2,2,0,5,33,485,
20220909,151,116,북대전,옥천,466,1,2,0,0,24,493,380,2,0,1,2,27,412,
20220909,151,119,북대전,판암,160,0,0,0,0,9,169,362,0,0,0,3,21,386,
20220909,151,152,북대전,유성,405,1,5,0,4,19,434,468,2,3,0,4,20,497,
20220909,151,153,북대전,서대전,293,2,0,0,2,16,313,579,3,2,6,10,27,627,
20220909,151,154,북대전,안영,142,0,0,2,1,7,152,175,0,4,3,6,14,202,
20220909,151,155,북대전,논산,160,0,0,2,7,4,173,121,2,1,0,7,4,135,
20220909,151,156,북대전,익산,96,0,0,1,8,4,109,110,0,0,2,15,4,131,
20220909,151,158,북대전,전주,122,1,1,0,1,9,134,105,2,0,2,1,7,117,
20220909,151,190,북대전,동서울,626,3,3,0,0,15,647,338,1,0,0,0,13,352,
20220909,151,198,북대전,서청주,273,4,0,1,0,9,287,233,2,0,1,0,12,248,
20220909,151,199,북대전,오창,242,1,1,3,0,10,257,107,1,1,1,1,6,117,
20220909,151,204,북대전,추부,103,0,1,0,0,8,112,94,1,0,0,0,5,100,
20220909,151,298,북대전,서산,203,0,1,0,5,9,218,187,1,1,1,7,12,209,
20220909,151,573,북대전,예산수덕사,404,4,3,0,7,14,432,244,1,2,1,6,4,258,
20220909,151,578,북대전,서세종,424,3,0,0,1,17,445,199,9,2,1,0,9,220,
20220909,151,579,북대전,남세종,227,2,2,0,2,7,240,312,3,4,0,0,12,331,
20220909,151,595,북대전,서공주,287,1,0,0,1,11,300,197,4,1,0,1,6,209,
20220909,152,101,유성,서울,238,1,60,0,0,4,303,301,5,63,0,0,3,372,
20220909,152,109,유성,계룡,322,7,7,0,2,14,352,238,7,6,4,1,20,276,
20220909,152,112,유성,남청주,311,10,27,0,0,12,360,244,6,25,2,0,9,286,
20220909,152,113,유성,신탄진,269,1,0,0,0,16,286,204,2,2,0,0,10,218,
20220909,152,114,유성,남대전,742,2,2,1,0,27,774,532,2,1,0,0,32,567,
20220909,152,115,유성,대전,249,1,7,0,0,10,267,263,2,3,0,0,11,279,
20220909,152,116,유성,옥천,428,3,1,0,0,15,447,295,2,0,0,0,14,311,
20220909,152,119,유성,판암,317,1,2,0,0,21,341,364,0,0,0,0,19,383,
20220909,152,151,유성,북대전,468,2,3,0,4,20,497,405,1,5,0,4,19,434,
20220909,152,152,유성,유성,105,2,1,0,0,3,111,105,2,1,0,0,3,111,
20220909,152,153,유성,서대전,300,1,5,0,0,19,325,444,4,7,1,0,28,484,
20220909,152,154,유성,안영,914,4,10,1,2,29,960,686,6,6,1,0,37,736,
20220909,152,155,유성,논산,602,10,11,6,4,19,652,440,6,12,0,2,17,477,
20220909,152,156,유성,익산,359,2,5,2,0,14,382,388,8,10,2,1,10,419,
20220909,152,158,유성,전주,560,1,46,4,0,29,640,376,1,56,2,2,13,450,
20220909,152,159,유성,서전주,260,1,1,1,0,5,268,196,4,0,0,0,6,206,
20220909,152,163,유성,정읍,278,3,1,1,1,9,293,112,0,2,2,0,5,121,
20220909,152,164,유성,무주,391,0,2,0,0,11,404,119,1,0,0,0,6,126,
20220909,152,167,유성,광주,1250,0,36,1,0,39,1326,392,3,40,1,0,8,444,
20220909,152,190,유성,동서울,510,3,2,0,0,16,531,394,1,0,1,0,12,408,
20220909,152,198,유성,서청주,253,1,2,3,1,8,268,184,1,1,0,0,8,194,
20220909,152,199,유성,오창,203,2,9,1,0,6,221,118,1,9,0,0,5,133,
20220909,152,200,유성,금산,269,0,1,0,0,11,281,178,2,1,0,0,5,186,
20220909,152,204,유성,추부,376,2,0,0,1,19,398,229,0,1,0,0,14,244,
20220909,152,298,유성,서산,388,2,1,0,0,13,404,277,2,0,1,4,9,293,
20220909,152,544,유성,완주,163,1,1,1,0,6,172,93,0,1,0,0,6,100,
20220909,152,556,유성,동순천,549,2,0,1,0,8,560,113,0,1,1,1,4,120,
20220909,152,571,유성,면천,203,2,0,0,0,9,214,127,1,0,0,0,7,135,
20220909,152,573,유성,예산수덕사,819,5,0,3,0,19,846,479,3,0,1,1,16,500,
20220909,152,576,유성,마곡사,183,0,0,1,0,8,192,150,0,0,2,0,3,155,
20220909,152,578,유성,서세종,346,12,4,0,0,8,370,349,15,3,3,2,13,385,
20220909,152,579,유성,남세종,139,0,4,1,0,2,146,486,3,1,0,0,13,503,
20220909,152,590,유성,동전주,168,0,0,0,0,3,171,115,0,0,0,0,8,123,
20220909,152,595,유성,서공주,446,5,2,1,7,11,472,294,2,3,2,5,10,316,
20220909,152,599,유성,양촌,615,2,2,0,0,12,631,154,1,0,0,0,3,158,
20220909,153,101,서대전,서울,98,0,1,0,0,3,102,104,0,2,0,0,3,109,
20220909,153,112,서대전,남청주,222,9,2,1,0,8,242,107,4,1,0,0,9,121,
20220909,153,113,서대전,신탄진,222,3,0,1,0,16,242,117,0,0,1,0,6,124,
20220909,153,114,서대전,남대전,1750,3,4,3,1,69,1830,1271,9,10,4,0,77,1371,
20220909,153,115,서대전,대전,594,2,0,0,0,42,638,460,2,1,0,0,24,487,
20220909,153,116,서대전,옥천,997,2,3,0,0,43,1045,473,3,1,0,5,20,502,
20220909,153,119,서대전,판암,1867,4,4,0,0,98,1973,1726,2,5,0,3,105,1841,
20220909,153,151,서대전,북대전,579,3,2,6,10,27,627,293,2,0,0,2,16,313,
20220909,153,152,서대전,유성,444,4,7,1,0,28,484,300,1,5,0,0,19,325,
20220909,153,154,서대전,안영,1568,15,19,1,1,66,1670,929,15,12,0,1,34,991,
20220909,153,155,서대전,논산,774,4,11,1,1,28,819,604,6,16,1,0,17,644,
20220909,153,156,서대전,익산,315,12,0,2,2,11,342,342,13,0,2,0,10,367,
20220909,153,158,서대전,전주,365,2,4,2,1,16,390,385,2,4,1,1,19,412,
20220909,153,159,서대전,서전주,144,5,0,0,0,6,155,151,4,1,0,1,5,162,
20220909,153,163,서대전,정읍,223,0,0,0,0,4,227,109,0,3,0,0,4,116,
20220909,153,164,서대전,무주,472,1,4,0,0,15,492,202,0,0,0,0,5,207,
20220909,153,167,서대전,광주,582,1,9,1,0,13,606,261,3,2,0,0,13,279,
20220909,153,190,서대전,동서울,297,0,0,0,0,11,308,203,0,0,0,0,6,209,
20220909,153,198,서대전,서청주,155,1,0,0,0,10,166,106,0,1,0,0,5,112,
20220909,153,200,서대전,금산,469,1,6,1,0,22,499,327,1,4,0,0,14,346,
20220909,153,204,서대전,추부,625,1,2,0,0,31,659,356,1,0,0,0,17,374,
20220909,153,556,서대전,동순천,184,1,1,0,1,6,193,98,0,1,0,2,4,105,
20220909,153,573,서대전,예산수덕사,365,1,0,0,0,6,372,120,0,0,0,0,5,125,
20220909,153,578,서대전,서세종,281,3,2,0,0,7,293,143,1,0,1,0,5,150,
20220909,153,579,서대전,남세종,780,3,2,0,0,29,814,444,3,3,0,0,22,472,
20220909,153,599,서대전,양촌,737,1,1,0,0,17,756,202,0,0,0,0,12,214,
20220909,154,109,안영,계룡,222,1,1,1,1,11,237,110,4,4,1,0,10,129,
20220909,154,114,안영,남대전,688,0,8,0,0,38,734,610,5,11,0,0,38,664,
20220909,154,115,안영,대전,225,1,2,0,0,12,240,196,0,5,0,0,14,215,
20220909,154,116,안영,옥천,442,2,0,1,0,18,463,290,3,0,0,0,15,308,
20220909,154,119,안영,판암,529,4,4,0,0,26,563,624,2,4,0,0,28,658,
20220909,154,151,안영,북대전,175,0,4,3,6,14,202,142,0,0,2,1,7,152,
20220909,154,152,안영,유성,686,6,6,1,0,37,736,914,4,10,1,2,29,960,
20220909,154,153,안영,서대전,929,15,12,0,1,34,991,1568,15,19,1,1,66,1670,
20220909,154,155,안영,논산,214,0,1,0,0,10,225,186,0,0,0,0,7,193,
20220909,154,156,안영,익산,96,2,0,0,0,4,102,104,12,0,0,0,2,118,
20220909,154,164,안영,무주,352,1,0,0,0,15,368,205,1,0,0,0,9,215,
20220909,154,200,안영,금산,321,1,1,0,0,10,333,339,2,3,0,0,16,360,
20220909,154,204,안영,추부,402,3,1,1,0,11,418,248,4,2,1,0,16,271,
20220909,154,578,안영,서세종,166,2,1,0,0,5,174,95,0,2,1,0,4,102,
20220909,154,579,안영,남세종,538,7,2,1,0,23,571,507,3,2,1,0,24,537,
20220909,155,109,논산,계룡,136,4,3,0,1,6,150,219,2,3,10,2,11,247,
20220909,155,115,논산,대전,109,1,3,0,0,6,119,165,2,2,1,0,5,175,
20220909,155,119,논산,판암,213,2,3,0,0,7,225,245,0,2,0,0,8,255,
20220909,155,151,논산,북대전,121,2,1,0,7,4,135,160,0,0,2,7,4,173,
20220909,155,152,논산,유성,440,6,12,0,2,17,477,602,10,11,6,4,19,652,
20220909,155,153,논산,서대전,604,6,16,1,0,17,644,774,4,11,1,1,28,819,
20220909,155,154,논산,안영,186,0,0,0,0,7,193,214,0,1,0,0,10,225,
20220909,155,156,논산,익산,577,9,2,0,8,12,608,93,11,5,2,3,7,121,
20220909,155,158,논산,전주,805,3,10,2,3,29,852,104,0,4,0,1,1,110,
20220909,155,167,논산,광주,2330,5,11,13,2,41,2402,158,1,3,2,4,2,170,
20220909,156,151,익산,북대전,110,0,0,2,15,4,131,96,0,0,1,8,4,109,
20220909,156,152,익산,유성,388,8,10,2,1,10,419,359,2,5,2,0,14,382,
20220909,156,153,익산,서대전,342,13,0,2,0,10,367,315,12,0,2,2,11,342,
20220909,156,154,익산,안영,104,12,0,0,0,2,118,96,2,0,0,0,4,102,
20220909,156,155,익산,논산,93,11,5,2,3,7,121,577,9,2,0,8,12,608,
20220909,156,158,익산,전주,127,4,1,0,1,1,134,133,8,0,2,2,2,147,
20220909,156,167,익산,광주,201,4,6,7,1,6,225,140,5,8,4,3,6,166,
20220909,156,545,익산,소양,132,0,1,1,1,2,137,147,6,9,1,1,2,166,
20220909,156,556,익산,동순천,275,3,2,3,3,4,290,109,2,0,0,4,1,116,
20220909,156,579,익산,남세종,107,1,0,0,0,6,114,103,2,1,0,1,2,109,
20220909,156,590,익산,동전주,135,4,1,0,0,6,146,128,8,1,0,0,5,142,
20220909,157,167,삼례,광주,139,2,0,2,1,6,150,181,4,2,1,0,3,191,
20220909,157,545,삼례,소양,109,0,0,1,0,3,113,125,0,2,0,1,1,129,
20220909,158,101,전주,서울,27,0,77,0,0,0,104,157,0,240,0,0,1,398,
20220909,158,151,전주,북대전,105,2,0,2,1,7,117,122,1,1,0,1,9,134,
20220909,158,152,전주,유성,376,1,56,2,2,13,450,560,1,46,4,0,29,640,
20220909,158,153,전주,서대전,385,2,4,1,1,19,412,365,2,4,2,1,16,390,
20220909,158,155,전주,논산,104,0,4,0,1,1,110,805,3,10,2,3,29,852,
20220909,158,156,전주,익산,133,8,0,2,2,2,147,127,4,1,0,1,1,134,
20220909,158,159,전주,서전주,430,6,3,4,0,7,450,198,4,3,1,0,9,215,
20220909,158,160,전주,김제,418,4,1,3,0,12,438,320,1,2,2,1,6,332,
20220909,158,161,전주,금산사,104,5,0,0,0,2,111,177,6,2,1,1,4,191,
20220909,158,162,전주,태인,291,1,3,1,6,9,311,235,3,1,0,6,5,250,
20220909,158,163,전주,정읍,512,3,2,1,3,13,534,483,3,4,4,4,8,506,
20220909,158,167,전주,광주,799,16,36,7,1,23,882,990,8,66,12,4,25,1105,
20220909,159,152,서전주,유성,196,4,0,0,0,6,206,260,1,1,1,0,5,268,
20220909,159,153,서전주,서대전,151,4,1,0,1,5,162,144,5,0,0,0,6,155,
20220909,159,158,서전주,전주,198,4,3,1,0,9,215,430,6,3,4,0,7,450,
20220909,159,160,서전주,김제,689,5,9,6,3,13,725,223,6,1,0,4,7,241,
20220909,159,161,서전주,금산사,149,3,0,0,2,6,160,130,3,0,0,0,2,135,
20220909,159,162,서전주,태인,529,3,7,6,2,11,558,240,4,4,7,2,5,262,
20220909,159,163,서전주,정읍,981,6,12,1,3,22,1025,720,6,7,3,4,14,754,
20220909,159,166,서전주,장성,299,2,0,0,4,2,307,101,4,2,1,4,2,114,
20220909,159,167,서전주,광주,2824,18,32,17,7,60,2958,1438,30,19,11,8,41,1547,
20220909,159,530,서전주,내장산,442,3,4,0,0,6,455,129,0,2,1,0,4,136,
20220909,159,569,서전주,북광주,250,2,4,5,3,2,266,218,2,2,1,1,7,231,
20220909,160,158,김제,전주,320,1,2,2,1,6,332,418,4,1,3,0,12,438,
20220909,160,159,김제,서전주,223,6,1,0,4,7,241,689,5,9,6,3,13,725,
20220909,160,163,김제,정읍,784,1,19,0,1,13,818,351,0,20,0,0,10,381,
20220909,160,167,김제,광주,913,15,12,4,2,28,974,678,3,13,2,2,25,723,
20220909,161,158,금산사,전주,177,6,2,1,1,4,191,104,5,0,0,0,2,111,
20220909,161,159,금산사,서전주,130,3,0,0,0,2,135,149,3,0,0,2,6,160,
20220909,161,167,금산사,광주,374,8,2,3,1,10,398,200,7,0,3,1,9,220,
20220909,162,158,태인,전주,235,3,1,0,6,5,250,291,1,3,1,6,9,311,
20220909,162,159,태인,서전주,240,4,4,7,2,5,262,529,3,7,6,2,11,558,
20220909,162,163,태인,정읍,216,1,5,1,3,2,228,121,0,2,0,3,3,129,
20220909,162,167,태인,광주,2384,4,13,7,6,54,2468,370,0,7,4,1,11,393,
20220909,163,152,정읍,유성,112,0,2,2,0,5,121,278,3,1,1,1,9,293,
20220909,163,153,정읍,서대전,109,0,3,0,0,4,116,223,0,0,0,0,4,227,
20220909,163,158,정읍,전주,483,3,4,4,4,8,506,512,3,2,1,3,13,534,
20220909,163,159,정읍,서전주,720,6,7,3,4,14,754,981,6,12,1,3,22,1025,
20220909,163,160,정읍,김제,351,0,20,0,0,10,381,784,1,19,0,1,13,818,
20220909,163,162,정읍,태인,121,0,2,0,3,3,129,216,1,5,1,3,2,228,
20220909,163,167,정읍,광주,675,13,17,5,1,24,735,1119,14,25,15,0,36,1209,
20220909,163,530,정읍,내장산,251,2,6,2,0,5,266,95,0,0,1,0,4,100,
20220909,164,114,무주,남대전,282,0,1,0,0,15,298,425,3,0,0,0,22,450,
20220909,164,115,무주,대전,223,0,16,0,0,17,256,401,1,14,0,0,21,437,
20220909,164,119,무주,판암,156,0,1,0,0,6,163,412,1,0,0,0,12,425,
20220909,164,152,무주,유성,119,1,0,0,0,6,126,391,0,2,0,0,11,404,
20220909,164,153,무주,서대전,202,0,0,0,0,5,207,472,1,4,0,0,15,492,
20220909,164,154,무주,안영,205,1,0,0,0,9,215,352,1,0,0,0,15,368,
20220909,164,169,무주,장수,184,1,0,0,0,4,189,101,1,0,0,0,5,107,
20220909,164,200,무주,금산,170,0,0,0,0,4,174,276,3,1,0,5,14,299,
20220909,165,167,백양사,광주,2369,9,38,8,1,35,2460,727,1,2,7,2,22,761,
20220909,165,569,백양사,북광주,279,0,0,2,0,4,285,144,0,1,0,0,2,147,
20220909,166,159,장성,서전주,101,4,2,1,4,2,114,299,2,0,0,4,2,307,
20220909,166,167,장성,광주,2229,33,50,6,3,69,2390,3034,56,42,2,1,87,3222,
20220909,167,112,광주,남청주,98,1,2,6,3,3,113,237,1,0,2,3,5,248,
20220909,167,119,광주,판암,98,0,1,0,0,2,101,173,3,0,0,0,2,178,
20220909,167,152,광주,유성,392,3,40,1,0,8,444,1250,0,36,1,0,39,1326,
20220909,167,153,광주,서대전,261,3,2,0,0,13,279,582,1,9,1,0,13,606,
20220909,167,155,광주,논산,158,1,3,2,4,2,170,2330,5,11,13,2,41,2402,
20220909,167,156,광주,익산,140,5,8,4,3,6,166,201,4,6,7,1,6,225,
20220909,167,157,광주,삼례,181,4,2,1,0,3,191,139,2,0,2,1,6,150,
20220909,167,158,광주,전주,990,8,66,12,4,25,1105,799,16,36,7,1,23,882,
20220909,167,159,광주,서전주,1438,30,19,11,8,41,1547,2824,18,32,17,7,60,2958,
20220909,167,160,광주,김제,678,3,13,2,2,25,723,913,15,12,4,2,28,974,
20220909,167,161,광주,금산사,200,7,0,3,1,9,220,374,8,2,3,1,10,398,
20220909,167,162,광주,태인,370,0,7,4,1,11,393,2384,4,13,7,6,54,2468,
20220909,167,163,광주,정읍,1119,14,25,15,0,36,1209,675,13,17,5,1,24,735,
20220909,167,165,광주,백양사,727,1,2,7,2,22,761,2369,9,38,8,1,35,2460,
20220909,167,166,광주,장성,3034,56,42,2,1,87,3222,2229,33,50,6,3,69,2390,
20220909,167,190,광주,동서울,182,1,2,0,0,5,190,1214,1,4,0,0,14,1233,
20220909,167,196,광주,진천,137,1,3,0,0,3,144,136,0,3,1,0,6,146,
20220909,167,198,광주,서청주,101,2,1,1,1,6,112,295,1,1,5,0,7,309,
20220909,167,199,광주,오창,104,0,1,0,0,3,108,196,0,3,4,2,3,208,
20220909,167,228,광주,동군산,850,9,3,1,4,20,887,576,6,2,1,6,16,607,
20220909,167,253,광주,서서울,873,1,9,1,0,12,896,1154,2,2,0,0,21,1179,
20220909,167,297,광주,동충주,114,2,1,1,0,1,119,101,0,1,0,0,4,106,
20220909,167,501,광주,서김제,139,0,0,4,0,3,146,155,1,0,1,0,4,161,
20220909,167,502,광주,부안,594,7,3,3,0,12,619,407,2,2,1,0,12,424,
20220909,167,503,광주,줄포,592,2,0,0,1,11,606,323,3,2,0,1,6,335,
20220909,167,504,광주,선운산,372,1,0,0,6,8,387,250,4,0,1,5,7,267,
20220909,167,505,광주,고창,594,6,1,2,1,21,625,424,5,1,2,1,13,446,
20220909,167,530,광주,내장산,755,7,4,6,2,18,792,619,10,3,2,0,17,651,
20220909,167,567,광주,남고창,1593,13,17,0,0,51,1674,1301,8,25,2,1,38,1375,
20220909,167,568,광주,장성물류,112,22,1,0,0,5,140,86,31,1,3,1,4,126,
20220909,167,579,광주,남세종,180,0,6,0,0,5,191,676,0,1,1,0,10,688,
20220909,168,169,덕유산,장수,240,0,0,0,1,8,249,169,1,0,0,0,4,174,
20220909,169,164,장수,무주,101,1,0,0,0,5,107,184,1,0,0,0,4,189,
20220909,169,168,장수,덕유산,169,1,0,0,0,4,174,240,0,0,0,1,8,249,
20220909,169,544,장수,완주,323,2,2,2,0,12,341,571,0,2,0,0,16,589,
20220909,169,545,장수,소양,592,3,0,0,0,21,616,1133,2,1,0,0,24,1160,
20220909,169,546,장수,진안,130,3,0,0,0,2,135,120,3,0,0,0,5,128,
20220909,170,224,서상,함양,275,3,6,0,0,16,300,214,2,3,0,0,8,227,
20220909,171,101,마성,서울,2660,11,99,33,0,97,2900,2878,25,106,41,2,103,3155,
20220909,171,102,마성,동수원,518,3,15,1,0,31,568,595,1,12,1,0,22,631,
20220909,171,103,마성,수원신갈,305,0,1,0,0,15,321,459,1,2,0,1,18,481,
20220909,171,171,마성,마성,96,1,0,0,0,4,101,96,1,0,0,0,4,101,
20220909,171,173,마성,양지,178,2,1,3,1,7,192,721,17,5,4,5,25,777,
20220909,171,175,마성,덕평,92,2,5,0,0,2,101,105,5,6,0,0,2,118,
20220909,171,176,마성,이천,100,0,3,1,0,3,107,158,1,2,3,4,7,175,
20220909,171,212,마성,북수원,497,3,1,0,0,25,526,799,9,3,0,0,27,838,
20220909,171,214,마성,동군포,226,0,0,0,0,11,237,184,2,0,0,0,9,195,
20220909,171,215,마성,군포,147,1,0,0,0,7,155,219,4,0,0,0,10,233,
20220909,171,253,마성,서서울,821,2,1,1,1,33,859,870,2,2,3,2,33,912,
20220909,171,254,마성,군자,560,2,1,1,1,32,597,855,5,5,5,2,43,915,
20220909,171,255,마성,서안산,159,2,2,1,0,6,170,244,4,2,1,1,15,267,
20220909,171,528,마성,기흥동탄,174,0,0,0,0,2,176,129,0,2,0,0,8,139,
20220909,172,101,용인,서울,2372,54,52,25,3,110,2616,2307,35,43,13,1,108,2507,
20220909,172,102,용인,동수원,524,10,4,2,0,31,571,612,4,2,4,1,23,646,
20220909,172,103,용인,수원신갈,170,4,1,1,1,5,182,235,5,4,3,0,10,257,
20220909,172,173,용인,양지,1811,39,24,14,1,77,1966,977,41,29,19,2,55,1123,
20220909,172,175,용인,덕평,735,10,12,4,1,24,786,141,10,11,8,2,14,186,
20220909,172,176,용인,이천,508,4,9,1,1,17,540,137,5,8,6,1,11,168,
20220909,172,177,용인,여주,244,3,6,8,2,5,268,108,2,3,4,2,3,122,
20220909,172,212,용인,북수원,584,11,7,1,1,22,626,693,8,3,1,2,22,729,
20220909,172,214,용인,동군포,177,0,0,1,0,10,188,125,2,1,3,1,6,138,
20220909,172,215,용인,군포,188,3,0,1,0,14,206,200,1,5,0,0,12,218,
20220909,172,253,용인,서서울,785,5,3,5,3,49,850,725,10,1,5,4,24,769,
20220909,172,254,용인,군자,507,2,3,8,3,25,548,724,6,6,8,3,38,785,
20220909,172,255,용인,서안산,164,3,3,0,4,8,182,239,4,2,3,0,11,259,
20220909,173,101,양지,서울,2891,183,95,27,20,81,3297,2716,75,92,20,10,88,3001,
20220909,173,102,양지,동수원,1125,21,14,1,2,47,1210,635,9,16,4,9,33,706,
20220909,173,103,양지,수원신갈,270,17,24,13,2,15,341,260,23,24,6,1,6,320,
20220909,173,171,양지,마성,721,17,5,4,5,25,777,178,2,1,3,1,7,192,
20220909,173,172,양지,용인,977,41,29,19,2,55,1123,1811,39,24,14,1,77,1966,
20220909,173,174,양지,춘천,205,4,2,6,1,11,229,122,3,2,2,0,2,131,
20220909,173,175,양지,덕평,644,9,8,8,1,22,692,78,4,6,10,3,6,107,
20220909,173,176,양지,이천,437,10,6,4,8,13,478,187,17,10,4,28,11,257,
20220909,173,177,양지,여주,253,6,14,12,3,6,294,159,8,32,27,5,11,242,
20220909,173,178,양지,문막,382,9,10,0,3,5,409,177,6,2,4,3,12,204,
20220909,173,179,양지,홍천,287,1,0,2,0,9,299,104,1,0,3,0,4,112,
20220909,173,189,양지,강릉,283,5,4,3,2,15,312,109,3,2,3,2,6,125,
20220909,173,190,양지,동서울,256,17,8,6,0,10,297,233,8,4,9,1,12,267,
20220909,173,212,양지,북수원,968,23,9,1,4,23,1028,1003,20,14,11,4,38,1090,
20220909,173,214,양지,동군포,273,7,6,8,0,13,307,210,5,2,4,0,6,227,
20220909,173,215,양지,군포,222,7,7,2,4,7,249,148,3,2,0,1,6,160,
20220909,173,253,양지,서서울,941,34,8,17,9,48,1057,1092,13,11,12,5,45,1178,
20220909,173,254,양지,군자,695,20,17,38,21,35,826,903,10,15,32,23,39,1022,
20220909,173,255,양지,서안산,181,12,9,27,5,11,245,193,7,8,14,3,15,240,
20220909,173,500,양지,남여주,94,3,9,3,6,7,122,125,7,11,13,7,6,169,
20220909,174,173,춘천,양지,122,3,2,2,0,2,131,205,4,2,6,1,11,229,
20220909,174,174,춘천,춘천,151,0,0,0,0,7,158,151,0,0,0,0,7,158,
20220909,174,177,춘천,여주,366,0,6,5,1,16,394,309,0,6,7,1,12,335,
20220909,174,178,춘천,문막,259,29,4,0,1,13,306,207,33,5,0,1,9,255,
20220909,174,179,춘천,홍천,3459,15,36,8,2,215,3735,3126,20,31,5,2,171,3355,
20220909,174,189,춘천,강릉,403,0,5,1,0,21,430,214,0,6,0,0,9,229,
20220909,174,211,춘천,풍기,159,0,0,0,0,9,168,97,0,0,0,0,4,101,
20220909,174,216,춘천,횡성,2030,33,5,9,3,92,2172,1025,29,7,7,0,49,1117,
20220909,174,217,춘천,북원주,967,19,26,6,3,52,1073,545,11,6,4,1,39,606,
20220909,174,218,춘천,남원주,1188,7,21,4,1,47,1268,1611,5,43,4,0,80,1743,
20220909,174,240,춘천,제천,647,2,3,0,0,27,679,398,2,2,0,0,20,422,
20220909,174,284,춘천,남양양,204,1,0,0,0,13,218,95,0,0,1,0,7,103,
20220909,174,510,춘천,양양,507,2,7,0,0,17,533,236,0,5,0,0,6,247,
20220909,174,554,춘천,동홍천,1528,10,1,4,0,87,1630,921,6,1,1,1,56,986,
20220909,174,580,춘천,북강릉,441,1,8,0,0,20,470,218,0,8,0,0,11,237,
20220909,174,583,춘천,동해,213,0,0,0,0,10,223,124,0,0,0,1,5,130,
20220909,174,701,춘천,북양양,284,0,3,1,0,14,302,211,0,0,0,0,10,221,
20220909,174,702,춘천,속초,340,0,0,0,0,17,357,209,2,7,0,1,7,226,
20220909,174,765,춘천,내촌,145,0,0,0,0,11,156,105,1,0,0,1,6,113,
20220909,174,766,춘천,인제,213,1,0,0,0,10,224,160,1,0,0,0,7,168,
20220909,175,101,덕평,서울,401,76,64,10,2,12,565,535,28,62,6,1,7,639,
20220909,175,102,덕평,동수원,164,8,13,1,0,9,195,242,12,13,2,1,8,278,
20220909,175,171,덕평,마성,105,5,6,0,0,2,118,92,2,5,0,0,2,101,
20220909,175,172,덕평,용인,141,10,11,8,2,14,186,735,10,12,4,1,24,786,
20220909,175,173,덕평,양지,78,4,6,10,3,6,107,644,9,8,8,1,22,692,
20220909,175,176,덕평,이천,156,7,4,4,0,4,175,99,4,2,3,2,10,120,
20220909,175,190,덕평,동서울,262,40,10,15,4,16,347,1334,21,6,15,2,45,1423,
20220909,175,212,덕평,북수원,120,6,3,3,0,8,140,243,14,5,3,1,6,272,
20220909,175,253,덕평,서서울,134,10,6,2,0,8,160,262,7,5,6,0,13,293,
20220909,175,254,덕평,군자,108,11,6,4,1,8,138,246,15,15,16,5,13,310,
20220909,176,101,이천,서울,218,8,34,5,1,6,272,661,1,67,3,1,15,748,
20220909,176,102,이천,동수원,310,9,14,1,0,14,348,390,2,22,0,1,20,435,
20220909,176,103,이천,수원신갈,158,4,9,1,1,7,180,201,2,11,1,1,5,221,
20220909,176,171,이천,마성,158,1,2,3,4,7,175,100,0,3,1,0,3,107,
20220909,176,172,이천,용인,137,5,8,6,1,11,168,508,4,9,1,1,17,540,
20220909,176,173,이천,양지,187,17,10,4,28,11,257,437,10,6,4,8,13,478,
20220909,176,175,이천,덕평,99,4,2,3,2,10,120,156,7,4,4,0,4,175,
20220909,176,177,이천,여주,376,4,13,7,2,19,421,212,5,10,13,4,17,261,
20220909,176,178,이천,문막,440,4,5,0,1,15,465,96,4,6,1,1,6,114,
20220909,176,190,이천,동서울,1221,23,55,9,6,62,1376,2147,16,29,15,3,80,2290,
20220909,176,192,이천,곤지암,89,1,9,1,0,5,105,412,3,4,1,1,12,433,
20220909,176,198,이천,서청주,39,99,15,3,0,0,156,51,99,16,0,1,5,172,
20220909,176,212,이천,북수원,192,0,3,3,0,7,205,421,2,5,1,2,7,438,
20220909,176,253,이천,서서울,253,3,0,2,2,10,270,430,0,0,2,4,14,450,
20220909,176,254,이천,군자,244,2,7,8,8,11,280,460,1,12,8,17,22,520,
20220909,176,500,이천,남여주,149,3,3,2,1,9,167,173,1,7,3,1,9,194,
20220909,176,560,이천,감곡,294,2,3,0,0,9,308,110,1,1,0,0,2,114,
20220909,177,101,여주,서울,235,0,33,1,5,4,278,260,2,26,1,0,6,295,
20220909,177,102,여주,동수원,197,3,22,8,2,5,237,166,0,7,1,0,6,180,
20220909,177,103,여주,수원신갈,96,0,14,6,2,1,119,112,3,9,4,0,7,135,
20220909,177,172,여주,용인,108,2,3,4,2,3,122,244,3,6,8,2,5,268,
20220909,177,173,여주,양지,159,8,32,27,5,11,242,253,6,14,12,3,6,294,
20220909,177,174,여주,춘천,309,0,6,7,1,12,335,366,0,6,5,1,16,394,
20220909,177,176,여주,이천,212,5,10,13,4,17,261,376,4,13,7,2,19,421,
20220909,177,178,여주,문막,412,8,14,8,3,17,462,272,3,8,2,4,17,306,
20220909,177,179,여주,홍천,252,0,5,2,1,7,267,206,1,8,0,2,8,225,
20220909,177,180,여주,원주,199,1,8,2,0,7,217,101,1,7,7,2,9,127,
20220909,177,189,여주,강릉,137,0,9,5,1,3,155,175,0,8,5,0,7,195,
20220909,177,190,여주,동서울,607,4,33,22,5,19,690,785,4,20,13,3,20,845,
20220909,177,212,여주,북수원,146,0,5,2,0,5,158,213,0,2,3,0,5,223,
20220909,177,218,여주,남원주,221,1,5,3,0,5,235,222,3,13,6,0,7,251,
20220909,177,240,여주,제천,113,1,7,6,1,3,131,100,2,8,4,0,5,119,
20220909,177,253,여주,서서울,153,0,0,5,4,8,170,171,0,1,1,0,2,175,
20220909,177,254,여주,군자,158,0,3,7,4,6,178,249,0,1,3,1,10,264,
20220909,177,517,여주,양평,98,1,1,3,5,7,115,548,1,1,4,0,9,563,
20220909,178,101,문막,서울,110,0,50,0,1,4,165,221,0,123,0,0,7,351,
20220909,178,102,문막,동수원,165,1,16,0,0,8,190,195,1,15,0,0,6,217,
20220909,178,173,문막,양지,177,6,2,4,3,12,204,382,9,10,0,3,5,409,
20220909,178,174,문막,춘천,207,33,5,0,1,9,255,259,29,4,0,1,13,306,
20220909,178,176,문막,이천,96,4,6,1,1,6,114,440,4,5,0,1,15,465,
20220909,178,177,문막,여주,272,3,8,2,4,17,306,412,8,14,8,3,17,462,
20220909,178,179,문막,홍천,185,8,4,0,0,10,207,120,7,1,0,0,9,137,
20220909,178,180,문막,원주,408,17,7,5,4,16,457,198,28,7,5,1,14,253,
20220909,178,181,문막,새말,202,4,1,0,1,10,218,109,5,3,1,1,4,123,
20220909,178,189,문막,강릉,288,1,3,3,2,10,307,99,1,6,1,0,5,112,
20220909,178,190,문막,동서울,266,7,14,4,0,11,302,568,4,10,1,0,9,592,
20220909,178,212,문막,북수원,118,1,13,0,0,4,136,231,1,12,0,0,8,252,
20220909,178,216,문막,횡성,428,13,5,4,3,22,475,135,5,1,1,0,10,152,
20220909,178,218,문막,남원주,249,5,0,0,0,11,265,103,3,0,0,1,5,112,
20220909,178,240,문막,제천,516,11,4,1,6,12,550,189,13,3,1,3,5,214,
20220909,178,253,문막,서서울,115,2,0,0,0,3,120,189,0,0,0,1,11,201,
20220909,178,254,문막,군자,163,1,16,1,2,12,195,305,1,19,0,1,13,339,
20220909,179,173,홍천,양지,104,1,0,3,0,4,112,287,1,0,2,0,9,299,
20220909,179,174,홍천,춘천,3126,20,31,5,2,171,3355,3459,15,36,8,2,215,3735,
20220909,179,177,홍천,여주,206,1,8,0,2,8,225,252,0,5,2,1,7,267,
20220909,179,178,홍천,문막,120,7,1,0,0,9,137,185,8,4,0,0,10,207,
20220909,179,216,홍천,횡성,304,6,2,3,0,8,323,192,6,3,1,0,9,211,
20220909,179,217,홍천,북원주,256,7,2,2,1,7,275,175,3,1,3,0,5,187,
20220909,179,218,홍천,남원주,488,2,0,2,1,25,518,1047,3,4,2,2,37,1095,
20220909,179,240,홍천,제천,111,0,0,0,0,6,117,182,2,1,0,0,11,196,
20220909,180,177,원주,여주,101,1,7,7,2,9,127,199,1,8,2,0,7,217,
20220909,180,178,원주,문막,198,28,7,5,1,14,253,408,17,7,5,4,16,457,
20220909,180,181,원주,새말,451,13,4,1,1,28,498,431,10,15,0,2,21,479,
20220909,180,182,원주,둔내,475,7,9,1,2,10,504,441,5,9,1,1,24,481,
20220909,180,185,원주,평창,135,4,7,1,0,6,153,142,2,9,0,3,5,161,
20220909,180,187,원주,진부,242,0,1,0,0,6,249,96,1,2,0,0,7,106,
20220909,180,189,원주,강릉,927,12,20,5,2,31,997,581,16,23,3,1,24,648,
20220909,180,580,원주,북강릉,328,3,1,1,0,10,343,153,4,1,1,0,0,159,
20220909,180,583,원주,동해,225,0,0,1,2,7,235,124,3,3,0,2,4,136,
20220909,181,178,새말,문막,109,5,3,1,1,4,123,202,4,1,0,1,10,218,
20220909,181,180,새말,원주,431,10,15,0,2,21,479,451,13,4,1,1,28,498,
20220909,181,182,새말,둔내,700,14,20,0,0,17,751,175,2,1,0,0,7,185,
20220909,181,184,새말,대관령,398,1,3,0,0,5,407,98,1,1,0,0,3,103,
20220909,181,189,새말,강릉,850,4,26,0,0,25,905,224,4,4,0,0,12,244,
20220909,182,180,둔내,원주,441,5,9,1,1,24,481,475,7,9,1,2,10,504,
20220909,182,181,둔내,새말,175,2,1,0,0,7,185,700,14,20,0,0,17,751,
20220909,183,184,면온,대관령,138,0,0,0,0,5,143,166,3,0,0,0,4,173,
20220909,183,189,면온,강릉,163,2,8,0,0,0,173,127,2,0,0,0,2,131,
20220909,184,181,대관령,새말,98,1,1,0,0,3,103,398,1,3,0,0,5,407,
20220909,184,183,대관령,면온,166,3,0,0,0,4,173,138,0,0,0,0,5,143,
20220909,184,185,대관령,평창,313,2,1,0,0,5,321,489,2,1,0,0,12,504,
20220909,184,187,대관령,진부,189,1,20,0,0,12,222,186,3,24,0,0,2,215,
20220909,184,189,대관령,강릉,1478,19,41,2,3,69,1612,1613,17,39,0,4,88,1761,
20220909,184,580,대관령,북강릉,440,4,4,0,0,12,460,399,5,4,0,0,9,417,
20220909,184,585,대관령,하조대,127,1,0,0,0,1,129,137,1,0,0,0,4,142,
20220909,185,180,평창,원주,142,2,9,0,3,5,161,135,4,7,1,0,6,153,
20220909,185,184,평창,대관령,489,2,1,0,0,12,504,313,2,1,0,0,5,321,
20220909,185,187,평창,진부,311,0,23,0,0,5,339,177,1,20,0,0,5,203,
20220909,185,189,평창,강릉,1022,7,27,0,4,30,1090,658,1,9,1,2,25,696,
20220909,185,580,평창,북강릉,357,1,0,0,0,9,367,189,1,1,0,0,4,195,
20220909,186,189,속사,강릉,236,1,2,0,0,6,245,96,2,2,0,0,3,103,
20220909,187,180,진부,원주,96,1,2,0,0,7,106,242,0,1,0,0,6,249,
20220909,187,184,진부,대관령,186,3,24,0,0,2,215,189,1,20,0,0,12,222,
20220909,187,185,진부,평창,177,1,20,0,0,5,203,311,0,23,0,0,5,339,
20220909,187,189,진부,강릉,591,10,6,2,0,27,636,635,7,6,1,0,39,688,
20220909,187,580,진부,북강릉,193,1,0,2,0,3,199,133,3,1,0,0,5,142,
20220909,188,128,서충주,금왕꽃동네,155,1,2,2,2,15,177,227,1,0,0,3,13,244,
20220909,188,542,서충주,서안성,99,1,1,2,2,8,113,145,0,2,1,1,8,157,
20220909,188,543,서충주,남안성,358,2,8,8,8,14,398,287,0,3,4,4,11,309,
20220909,189,102,강릉,동수원,103,0,12,1,0,10,126,199,0,8,0,0,7,214,
20220909,189,173,강릉,양지,109,3,2,3,2,6,125,283,5,4,3,2,15,312,
20220909,189,174,강릉,춘천,214,0,6,0,0,9,229,403,0,5,1,0,21,430,
20220909,189,177,강릉,여주,175,0,8,5,0,7,195,137,0,9,5,1,3,155,
20220909,189,178,강릉,문막,99,1,6,1,0,5,112,288,1,3,3,2,10,307,
20220909,189,180,강릉,원주,581,16,23,3,1,24,648,927,12,20,5,2,31,997,
20220909,189,181,강릉,새말,224,4,4,0,0,12,244,850,4,26,0,0,25,905,
20220909,189,183,강릉,면온,127,2,0,0,0,2,131,163,2,8,0,0,0,173,
20220909,189,184,강릉,대관령,1613,17,39,0,4,88,1761,1478,19,41,2,3,69,1612,
20220909,189,185,강릉,평창,658,1,9,1,2,25,696,1022,7,27,0,4,30,1090,
20220909,189,186,강릉,속사,96,2,2,0,0,3,103,236,1,2,0,0,6,245,
20220909,189,187,강릉,진부,635,7,6,1,0,39,688,591,10,6,2,0,27,636,
20220909,189,218,강릉,남원주,222,0,6,2,0,9,239,255,1,1,2,0,13,272,
20220909,189,284,강릉,남양양,208,4,1,1,0,13,227,200,4,0,1,0,11,216,
20220909,189,510,강릉,양양,187,3,1,1,1,10,203,139,2,3,0,1,9,154,
20220909,189,580,강릉,북강릉,314,7,1,0,0,10,332,235,3,0,1,0,3,242,
20220909,189,581,강릉,옥계,217,2,0,0,0,7,226,209,3,0,1,5,11,229,
20220909,189,582,강릉,망상,568,5,68,0,2,19,662,454,1,46,0,2,21,524,
20220909,189,583,강릉,동해,838,12,2,3,9,46,910,749,12,24,0,13,45,843,
20220909,189,585,강릉,하조대,545,3,13,0,1,29,591,524,4,12,0,2,24,566,
20220909,189,701,강릉,북양양,331,8,0,0,0,20,359,281,7,1,0,1,17,307,
20220909,189,702,강릉,속초,507,11,6,0,1,25,550,419,11,4,0,2,26,462,
20220909,189,703,강릉,삼척,664,4,4,0,0,29,701,411,11,9,0,1,24,456,
20220909,189,704,강릉,근덕,636,8,9,0,0,28,681,679,8,11,0,2,20,720,
20220909,190,112,동서울,남청주,553,1,1,1,0,17,573,406,0,0,1,4,12,423,
20220909,190,113,동서울,신탄진,1064,1,0,1,1,23,1090,945,3,0,2,1,42,993,
20220909,190,115,동서울,대전,817,0,2,0,0,30,849,732,0,5,0,0,28,765,
20220909,190,116,동서울,옥천,327,0,0,0,0,8,335,96,0,0,2,1,2,101,
20220909,190,119,동서울,판암,133,1,0,0,0,4,138,140,0,0,0,0,7,147,
20220909,190,123,동서울,구미,136,0,3,0,1,4,144,202,0,12,5,1,7,227,
20220909,190,127,동서울,서대구,633,0,4,3,0,12,652,406,2,9,1,0,12,430,
20220909,190,128,동서울,금왕꽃동네,251,1,2,4,0,5,263,455,4,3,7,0,19,488,
20220909,190,129,동서울,북대구,638,2,1,2,0,12,655,518,2,0,2,2,11,535,
20220909,190,136,동서울,음성,1202,0,1,4,1,37,1245,520,1,2,1,1,20,545,
20220909,190,151,동서울,북대전,338,1,0,0,0,13,352,626,3,3,0,0,15,647,
20220909,190,152,동서울,유성,394,1,0,1,0,12,408,510,3,2,0,0,16,531,
20220909,190,153,동서울,서대전,203,0,0,0,0,6,209,297,0,0,0,0,11,308,
20220909,190,167,동서울,광주,1214,1,4,0,0,14,1233,182,1,2,0,0,5,190,
20220909,190,173,동서울,양지,233,8,4,9,1,12,267,256,17,8,6,0,10,297,
20220909,190,175,동서울,덕평,1334,21,6,15,2,45,1423,262,40,10,15,4,16,347,
20220909,190,176,동서울,이천,2147,16,29,15,3,80,2290,1221,23,55,9,6,62,1376,
20220909,190,177,동서울,여주,785,4,20,13,3,20,845,607,4,33,22,5,19,690,
20220909,190,178,동서울,문막,568,4,10,1,0,9,592,266,7,14,4,0,11,302,
20220909,190,191,동서울,경기광주,7402,120,186,34,8,378,8128,7075,131,188,21,7,338,7760,
20220909,190,192,동서울,곤지암,2678,92,43,26,9,109,2957,2542,114,40,37,6,152,2891,
20220909,190,193,동서울,일죽,1832,5,26,18,16,77,1974,2326,19,48,46,10,88,2537,
20220909,190,194,동서울,서이천,5354,217,190,71,15,180,6027,2828,177,137,52,13,132,3339,
20220909,190,195,동서울,대소,673,7,19,6,1,24,730,600,10,38,4,2,38,692,
20220909,190,196,동서울,진천,726,3,2,1,0,19,751,468,4,1,5,3,21,502,
20220909,190,197,동서울,증평,1089,3,5,4,3,33,1137,946,2,10,7,5,40,1010,
20220909,190,198,동서울,서청주,963,2,4,5,1,33,1008,1417,3,8,5,4,47,1484,
20220909,190,199,동서울,오창,1333,2,3,4,8,37,1387,1191,0,3,2,8,52,1256,
20220909,190,225,동서울,서진주,307,0,1,0,0,7,315,101,0,1,0,0,1,103,
20220909,190,233,동서울,현풍,158,1,2,1,3,2,167,89,0,3,2,1,5,100,
20220909,190,236,동서울,영산,114,0,0,2,0,2,118,149,0,0,2,0,4,155,
20220909,190,239,동서울,칠원,607,0,4,4,1,12,628,596,0,9,1,0,20,626,
20220909,190,291,동서울,사천,318,0,0,0,0,8,326,119,0,1,1,0,4,125,
20220909,190,500,동서울,남여주,182,2,6,1,1,9,201,338,3,0,1,0,16,358,
20220909,190,516,동서울,통영,304,0,8,0,0,17,329,260,0,8,0,0,8,276,
20220909,190,555,동서울,북진천,1478,11,2,3,1,41,1536,412,14,1,2,1,7,437,
20220909,190,560,동서울,감곡,1264,1,4,9,3,40,1321,668,7,3,5,3,17,703,
20220909,190,561,동서울,북충주,796,2,32,2,0,24,856,489,6,34,4,1,16,550,
20220909,190,562,동서울,충주,650,0,3,0,2,23,678,484,2,3,0,1,21,511,
20220909,190,563,동서울,괴산,557,0,0,0,1,14,572,101,1,2,0,0,2,106,
20220909,190,565,동서울,문경새재,803,0,5,7,3,16,834,151,0,1,1,1,9,163,
20220909,190,566,동서울,점촌함창,445,0,10,3,0,11,469,304,0,29,1,0,15,349,
20220909,190,570,동서울,북상주,411,2,0,2,0,9,424,234,3,8,5,0,5,255,
20220909,190,705,동서울,남이천,1424,15,13,19,2,28,1501,1019,37,12,9,9,27,1113,
20220909,190,736,동서울,삼성,330,3,0,0,0,14,347,258,3,0,0,0,12,273,
20220909,191,190,경기광주,동서울,7075,131,188,21,7,338,7760,7402,120,186,34,8,378,8128,
20220909,191,192,경기광주,곤지암,713,7,8,3,0,20,751,320,7,3,0,0,13,343,
20220909,191,193,경기광주,일죽,111,0,0,0,0,6,117,157,1,1,1,0,10,170,
20220909,191,194,경기광주,서이천,2050,19,7,2,1,54,2133,206,4,1,2,0,10,223,
20220909,192,176,곤지암,이천,412,3,4,1,1,12,433,89,1,9,1,0,5,105,
20220909,192,190,곤지암,동서울,2542,114,40,37,6,152,2891,2678,92,43,26,9,109,2957,
20220909,192,191,곤지암,경기광주,320,7,3,0,0,13,343,713,7,8,3,0,20,751,
20220909,192,193,곤지암,일죽,312,5,7,2,2,15,343,526,9,13,3,4,22,577,
20220909,192,194,곤지암,서이천,3863,117,73,37,5,115,4210,913,42,43,20,11,38,1067,
20220909,192,195,곤지암,대소,137,4,0,1,0,6,148,118,3,1,1,0,6,129,
20220909,192,197,곤지암,증평,141,1,2,0,1,5,150,152,0,0,2,0,6,160,
20220909,192,198,곤지암,서청주,118,0,0,1,0,3,122,201,0,2,1,0,12,216,
20220909,192,199,곤지암,오창,176,1,1,0,0,5,183,189,0,1,1,2,12,205,
20220909,192,560,곤지암,감곡,196,2,1,0,0,5,204,126,1,0,0,0,2,129,
20220909,192,705,곤지암,남이천,307,7,5,1,1,10,331,359,8,5,3,2,10,387,
20220909,193,101,일죽,서울,279,1,5,6,1,10,302,234,0,14,1,0,8,257,
20220909,193,190,일죽,동서울,2326,19,48,46,10,88,2537,1832,5,26,18,16,77,1974,
20220909,193,191,일죽,경기광주,157,1,1,1,0,10,170,111,0,0,0,0,6,117,
20220909,193,192,일죽,곤지암,526,9,13,3,4,22,577,312,5,7,2,2,15,343,
20220909,193,212,일죽,북수원,150,0,5,0,0,5,160,96,0,5,0,0,6,107,
20220909,193,253,일죽,서서울,206,2,4,14,1,12,239,154,0,0,1,3,6,164,
20220909,193,254,일죽,군자,164,3,5,9,5,9,195,116,0,5,6,0,9,136,
20220909,193,705,일죽,남이천,206,3,9,3,6,10,237,687,3,8,8,2,19,727,
20220909,194,190,서이천,동서울,2828,177,137,52,13,132,3339,5354,217,190,71,15,180,6027,
20220909,194,191,서이천,경기광주,206,4,1,2,0,10,223,2050,19,7,2,1,54,2133,
20220909,194,192,서이천,곤지암,913,42,43,20,11,38,1067,3863,117,73,37,5,115,4210,
20220909,195,101,대소,서울,98,1,22,2,1,7,131,125,2,31,2,2,7,169,
20220909,195,190,대소,동서울,600,10,38,4,2,38,692,673,7,19,6,1,24,730,
20220909,195,192,대소,곤지암,118,3,1,1,0,6,129,137,4,0,1,0,6,148,
20220909,195,198,대소,서청주,118,0,1,0,0,5,124,145,2,4,0,0,12,163,
20220909,195,543,대소,남안성,210,15,5,6,2,4,242,122,6,0,4,2,4,138,
20220909,196,112,진천,남청주,549,11,4,3,5,17,589,132,5,0,8,7,6,158,
20220909,196,113,진천,신탄진,340,3,2,5,7,10,367,296,10,5,10,5,12,338,
20220909,196,115,진천,대전,105,4,6,1,0,8,124,218,10,12,0,0,14,254,
20220909,196,167,진천,광주,136,0,3,1,0,6,146,137,1,3,0,0,3,144,
20220909,196,190,진천,동서울,468,4,1,5,3,21,502,726,3,2,1,0,19,751,
20220909,196,197,진천,증평,387,5,4,6,3,12,417,288,4,5,7,1,11,316,
20220909,196,198,진천,서청주,860,6,36,10,5,32,949,770,8,36,11,5,30,860,
20220909,196,199,진천,오창,920,13,25,8,3,30,999,447,9,18,2,5,14,495,
20220909,197,101,증평,서울,137,0,11,0,1,3,152,215,0,5,0,3,8,231,
20220909,197,112,증평,남청주,304,2,0,1,6,9,322,153,6,1,1,3,4,168,
20220909,197,113,증평,신탄진,262,0,1,2,13,9,287,382,4,1,4,16,14,421,
20220909,197,115,증평,대전,131,0,5,0,0,7,143,351,0,9,1,0,13,374,
20220909,197,190,증평,동서울,946,2,10,7,5,40,1010,1089,3,5,4,3,33,1137,
20220909,197,192,증평,곤지암,152,0,0,2,0,6,160,141,1,2,0,1,5,150,
20220909,197,196,증평,진천,288,4,5,7,1,11,316,387,5,4,6,3,12,417,
20220909,197,198,증평,서청주,467,6,5,4,1,13,496,569,2,1,1,0,35,608,
20220909,197,199,증평,오창,178,3,2,0,0,9,192,163,1,0,2,1,11,178,
20220909,198,101,서청주,서울,100,0,1,0,0,3,104,104,0,0,0,0,1,105,
20220909,198,112,서청주,남청주,427,10,2,1,5,22,467,113,13,0,2,2,6,136,
20220909,198,113,서청주,신탄진,890,6,4,5,4,33,942,639,4,4,7,9,27,690,
20220909,198,115,서청주,대전,378,4,0,0,0,20,402,552,5,2,2,1,32,594,
20220909,198,116,서청주,옥천,190,0,1,1,0,14,206,133,0,0,1,0,6,140,
20220909,198,151,서청주,북대전,233,2,0,1,0,12,248,273,4,0,1,0,9,287,
20220909,198,152,서청주,유성,184,1,1,0,0,8,194,253,1,2,3,1,8,268,
20220909,198,153,서청주,서대전,106,0,1,0,0,5,112,155,1,0,0,0,10,166,
20220909,198,167,서청주,광주,295,1,1,5,0,7,309,101,2,1,1,1,6,112,
20220909,198,176,서청주,이천,51,99,16,0,1,5,172,39,99,15,3,0,0,156,
20220909,198,190,서청주,동서울,1417,3,8,5,4,47,1484,963,2,4,5,1,33,1008,
20220909,198,192,서청주,곤지암,201,0,2,1,0,12,216,118,0,0,1,0,3,122,
20220909,198,195,서청주,대소,145,2,4,0,0,12,163,118,0,1,0,0,5,124,
20220909,198,196,서청주,진천,770,8,36,11,5,30,860,860,6,36,10,5,32,949,
20220909,198,197,서청주,증평,569,2,1,1,0,35,608,467,6,5,4,1,13,496,
20220909,198,199,서청주,오창,508,1,12,6,2,11,540,317,3,2,4,0,14,340,
20220909,198,297,서청주,동충주,445,0,7,1,4,17,474,185,1,5,0,0,2,193,
20220909,198,533,서청주,보은,124,3,0,1,0,6,134,116,2,1,0,0,7,126,
20220909,199,101,오창,서울,143,0,1,1,0,3,148,184,1,0,0,0,5,190,
20220909,199,112,오창,남청주,451,1,2,4,4,12,474,139,6,1,8,4,5,163,
20220909,199,113,오창,신탄진,597,1,1,3,14,25,641,580,5,1,4,26,16,632,
20220909,199,115,오창,대전,304,1,4,0,0,12,321,405,0,11,0,0,22,438,
20220909,199,151,오창,북대전,107,1,1,1,1,6,117,242,1,1,3,0,10,257,
20220909,199,152,오창,유성,118,1,9,0,0,5,133,203,2,9,1,0,6,221,
20220909,199,167,오창,광주,196,0,3,4,2,3,208,104,0,1,0,0,3,108,
20220909,199,190,오창,동서울,1191,0,3,2,8,52,1256,1333,2,3,4,8,37,1387,
20220909,199,192,오창,곤지암,189,0,1,1,2,12,205,176,1,1,0,0,5,183,
20220909,199,196,오창,진천,447,9,18,2,5,14,495,920,13,25,8,3,30,999,
20220909,199,197,오창,증평,163,1,0,2,1,11,178,178,3,2,0,0,9,192,
20220909,199,198,오창,서청주,317,3,2,4,0,14,340,508,1,12,6,2,11,540,
20220909,199,297,오창,동충주,329,0,1,3,1,6,340,252,1,0,0,1,5,259,
20220909,200,114,금산,남대전,275,2,4,0,0,8,289,298,2,3,1,1,19,324,
20220909,200,115,금산,대전,344,0,3,1,0,17,365,284,0,4,0,0,16,304,
20220909,200,119,금산,판암,239,0,3,0,0,9,251,403,0,2,0,0,11,416,
20220909,200,152,금산,유성,178,2,1,0,0,5,186,269,0,1,0,0,11,281,
20220909,200,153,금산,서대전,327,1,4,0,0,14,346,469,1,6,1,0,22,499,
20220909,200,154,금산,안영,339,2,3,0,0,16,360,321,1,1,0,0,10,333,
20220909,200,164,금산,무주,276,3,1,0,5,14,299,170,0,0,0,0,4,174,
20220909,200,204,금산,추부,104,0,1,0,0,6,111,220,0,2,0,1,8,231,
20220909,201,123,칠곡,구미,181,0,1,0,0,11,193,131,1,1,0,0,5,138,
20220909,201,127,칠곡,서대구,921,5,4,0,0,36,966,2710,9,13,1,3,116,2852,
20220909,201,131,칠곡,경산,172,5,0,0,1,8,186,204,9,3,0,1,10,227,
20220909,201,202,칠곡,다부,176,3,0,0,0,5,184,249,7,1,0,0,7,264,
20220909,201,203,칠곡,가산,822,3,3,1,1,29,859,1098,9,16,8,2,35,1168,
20220909,201,205,칠곡,군위,330,3,2,0,0,14,349,417,2,2,0,0,19,440,
20220909,201,206,칠곡,의성,503,1,3,0,0,22,529,435,0,8,1,0,13,457,
20220909,201,207,칠곡,남안동,302,4,0,0,0,8,314,306,7,0,1,1,4,319,
20220909,201,208,칠곡,서안동,194,0,1,1,0,10,206,167,2,20,1,0,6,196,
20220909,201,210,칠곡,영주,215,1,1,0,0,5,222,145,0,14,0,1,7,167,
20220909,201,231,칠곡,화원옥포,579,7,0,1,0,34,621,698,8,0,0,1,35,742,
20220909,201,232,칠곡,달성,109,0,2,1,0,8,120,148,2,2,1,0,12,165,
20220909,201,233,칠곡,현풍,362,1,7,0,4,16,390,421,2,6,0,4,24,457,
20220909,201,239,칠곡,칠원,207,1,0,0,0,9,217,380,2,2,1,2,12,399,
20220909,201,241,칠곡,동고령,271,2,4,0,0,11,288,181,1,1,0,0,6,189,
20220909,201,242,칠곡,고령,230,1,0,0,1,5,237,190,1,0,1,1,10,203,
20220909,201,527,칠곡,포항,220,2,1,0,2,9,234,170,1,0,0,4,10,185,
20220909,201,621,칠곡,동대구,152,2,0,0,0,8,162,149,2,1,0,0,8,160,
20220909,201,730,칠곡,유천,734,2,0,0,0,38,774,912,3,0,0,0,29,944,
20220909,201,731,칠곡,북현풍,186,0,0,0,0,5,191,229,0,0,0,0,3,232,
20220909,202,127,다부,서대구,474,4,1,3,2,9,493,305,0,1,3,2,8,319,
20220909,202,201,다부,칠곡,249,7,1,0,0,7,264,176,3,0,0,0,5,184,
20220909,202,205,다부,군위,269,4,2,2,0,11,288,131,2,0,0,0,7,140,
20220909,202,206,다부,의성,321,2,2,0,2,10,337,128,2,1,0,2,4,137,
20220909,202,207,다부,남안동,243,10,0,0,0,6,259,146,4,0,2,1,8,161,
20220909,202,210,다부,영주,255,3,3,3,1,6,271,99,3,1,2,0,2,107,
20220909,202,775,다부,동명동호,524,3,2,1,2,25,557,311,5,1,1,4,8,330,
20220909,203,127,가산,서대구,2660,14,19,6,4,84,2787,1707,11,18,0,1,63,1800,
20220909,203,129,가산,북대구,936,1,2,1,0,14,954,568,2,1,0,0,17,588,
20220909,203,201,가산,칠곡,1098,9,16,8,2,35,1168,822,3,3,1,1,29,859,
20220909,203,205,가산,군위,613,3,4,0,1,16,637,195,5,3,0,0,5,208,
20220909,203,206,가산,의성,719,5,4,2,1,16,747,194,3,2,0,1,6,206,
20220909,203,207,가산,남안동,928,4,3,1,0,25,961,320,5,4,0,2,14,345,
20220909,203,208,가산,서안동,439,6,7,0,2,11,465,129,4,4,0,1,6,144,
20220909,203,210,가산,영주,712,1,2,2,7,33,757,178,3,1,2,5,14,203,
20220909,203,231,가산,화원옥포,231,1,4,1,0,5,242,119,0,0,1,0,3,123,
20220909,203,239,가산,칠원,298,4,0,0,0,10,312,101,0,0,1,0,2,104,
20220909,203,730,가산,유천,487,1,2,0,0,11,501,220,0,0,0,0,10,230,
20220909,203,749,가산,영덕,460,3,1,1,1,15,481,165,1,0,2,2,13,183,
20220909,203,775,가산,동명동호,3430,12,19,28,17,94,3600,1331,11,12,3,2,36,1395,
20220909,204,115,추부,대전,430,2,0,0,0,31,463,410,5,1,1,0,25,442,
20220909,204,119,추부,판암,187,2,1,0,0,8,198,422,1,2,0,0,23,448,
20220909,204,151,추부,북대전,94,1,0,0,0,5,100,103,0,1,0,0,8,112,
20220909,204,152,추부,유성,229,0,1,0,0,14,244,376,2,0,0,1,19,398,
20220909,204,153,추부,서대전,356,1,0,0,0,17,374,625,1,2,0,0,31,659,
20220909,204,154,추부,안영,248,4,2,1,0,16,271,402,3,1,1,0,11,418,
20220909,204,200,추부,금산,220,0,2,0,1,8,231,104,0,1,0,0,6,111,
20220909,204,579,추부,남세종,108,2,0,0,0,4,114,219,2,0,0,0,9,230,
20220909,205,127,군위,서대구,734,3,3,0,1,25,766,664,3,1,0,0,24,692,
20220909,205,129,군위,북대구,227,0,0,0,0,5,232,241,0,1,0,0,5,247,
20220909,205,201,군위,칠곡,417,2,2,0,0,19,440,330,3,2,0,0,14,349,
20220909,205,202,군위,다부,131,2,0,0,0,7,140,269,4,2,2,0,11,288,
20220909,205,203,군위,가산,195,5,3,0,0,5,208,613,3,4,0,1,16,637,
20220909,205,730,군위,유천,127,1,0,0,0,1,129,101,1,1,0,0,3,106,
20220909,205,775,군위,동명동호,836,1,1,0,1,29,868,593,1,2,2,1,24,623,
20220909,206,127,의성,서대구,666,4,2,0,0,23,695,1113,2,7,0,0,42,1164,
20220909,206,129,의성,북대구,257,0,0,0,0,14,271,419,1,1,0,0,10,431,
20220909,206,201,의성,칠곡,435,0,8,1,0,13,457,503,1,3,0,0,22,529,
20220909,206,202,의성,다부,128,2,1,0,2,4,137,321,2,2,0,2,10,337,
20220909,206,203,의성,가산,194,3,2,0,1,6,206,719,5,4,2,1,16,747,
20220909,206,207,의성,남안동,306,1,2,1,0,6,316,136,2,1,0,0,7,146,
20220909,206,730,의성,유천,106,0,0,0,0,3,109,171,0,0,0,0,9,180,
20220909,206,775,의성,동명동호,750,1,5,3,0,19,778,785,1,1,0,1,25,813,
20220909,207,127,남안동,서대구,568,4,2,1,1,17,593,769,3,1,3,0,32,808,
20220909,207,129,남안동,북대구,321,1,0,0,1,14,337,408,1,1,1,1,11,423,
20220909,207,201,남안동,칠곡,306,7,0,1,1,4,319,302,4,0,0,0,8,314,
20220909,207,202,남안동,다부,146,4,0,2,1,8,161,243,10,0,0,0,6,259,
20220909,207,203,남안동,가산,320,5,4,0,2,14,345,928,4,3,1,0,25,961,
20220909,207,206,남안동,의성,136,2,1,0,0,7,146,306,1,2,1,0,6,316,
20220909,207,208,남안동,서안동,213,1,1,1,0,3,219,220,1,1,1,1,8,232,
20220909,207,536,남안동,남상주,125,1,2,5,0,4,137,161,0,2,6,0,5,174,
20220909,207,712,남안동,동상주,297,3,3,2,1,10,316,648,1,2,0,4,21,676,
20220909,207,713,남안동,서의성,179,1,3,1,0,10,194,148,1,2,2,0,7,160,
20220909,207,730,남안동,유천,110,0,0,0,0,4,114,100,0,0,0,0,2,102,
20220909,207,775,남안동,동명동호,755,6,3,2,3,17,786,760,7,2,0,1,35,805,
20220909,208,127,서안동,서대구,352,2,0,0,2,9,365,433,1,8,0,0,17,459,
20220909,208,129,서안동,북대구,190,1,43,0,0,7,241,236,0,36,0,0,7,279,
20220909,208,201,서안동,칠곡,167,2,20,1,0,6,196,194,0,1,1,0,10,206,
20220909,208,203,서안동,가산,129,4,4,0,1,6,144,439,6,7,0,2,11,465,
20220909,208,207,서안동,남안동,220,1,1,1,1,8,232,213,1,1,1,0,3,219,
20220909,208,209,서안동,예천,174,0,2,0,0,9,185,170,0,1,0,0,5,176,
20220909,208,210,서안동,영주,220,2,8,0,4,9,243,227,1,8,1,0,7,244,
20220909,208,521,서안동,단양,100,0,0,1,0,4,105,557,2,1,0,0,17,577,
20220909,208,523,서안동,남제천,115,0,1,0,0,8,124,273,0,1,0,0,10,284,
20220909,208,714,서안동,북의성,113,1,2,2,0,4,122,245,2,3,0,2,8,260,
20220909,208,775,서안동,동명동호,529,3,3,0,4,10,549,412,0,2,0,3,8,425,
20220909,209,208,예천,서안동,170,0,1,0,0,5,176,174,0,2,0,0,9,185,
20220909,209,210,예천,영주,106,3,1,0,0,3,113,112,1,0,0,1,2,116,
20220909,210,127,영주,서대구,345,2,4,2,1,11,365,514,1,6,0,0,25,546,
20220909,210,129,영주,북대구,172,1,17,0,0,4,194,314,0,14,0,0,12,340,
20220909,210,201,영주,칠곡,145,0,14,0,1,7,167,215,1,1,0,0,5,222,
20220909,210,202,영주,다부,99,3,1,2,0,2,107,255,3,3,3,1,6,271,
20220909,210,203,영주,가산,178,3,1,2,5,14,203,712,1,2,2,7,33,757,
20220909,210,208,영주,서안동,227,1,8,1,0,7,244,220,2,8,0,4,9,243,
20220909,210,209,영주,예천,112,1,0,0,1,2,116,106,3,1,0,0,3,113,
20220909,210,239,영주,칠원,105,0,0,0,1,4,110,236,0,0,1,0,13,250,
20220909,210,521,영주,단양,116,1,1,0,0,5,123,211,2,0,0,3,9,225,
20220909,210,533,영주,보은,95,0,0,0,1,5,101,114,0,0,0,0,2,116,
20220909,210,775,영주,동명동호,433,2,1,0,2,17,455,584,0,1,0,2,16,603,
20220909,211,174,풍기,춘천,97,0,0,0,0,4,101,159,0,0,0,0,9,168,
20220909,211,218,풍기,남원주,173,2,7,0,0,10,192,553,1,5,0,0,16,575,
20220909,211,240,풍기,제천,90,0,6,0,1,5,102,620,3,6,2,4,12,647,
20220909,211,297,풍기,동충주,139,0,1,1,3,6,150,1113,1,4,0,5,24,1147,
20220909,211,521,풍기,단양,589,4,0,0,0,27,620,1579,5,11,1,2,47,1645,
20220909,211,522,풍기,북단양,192,4,0,0,0,7,203,519,3,6,0,3,7,538,
20220909,211,523,풍기,남제천,318,3,0,0,3,14,338,587,0,2,0,0,15,604,
20220909,211,543,풍기,남안성,114,0,1,2,2,4,123,257,1,0,0,2,8,268,
20220909,212,101,북수원,서울,105,2,3,0,0,2,112,99,0,0,0,0,3,102,
20220909,212,102,북수원,동수원,3267,16,134,4,0,122,3543,2886,6,130,1,0,108,3131,
20220909,212,103,북수원,수원신갈,1663,39,20,10,3,73,1808,781,29,13,9,1,37,870,
20220909,212,105,북수원,기흥,778,6,3,1,2,36,826,579,5,3,2,2,31,622,
20220909,212,106,북수원,오산,211,4,5,4,1,15,240,132,10,5,2,0,19,168,
20220909,212,107,북수원,안성,172,1,2,0,0,6,181,195,1,3,0,0,5,204,
20220909,212,108,북수원,천안,272,0,0,0,0,7,279,231,0,0,1,0,8,240,
20220909,212,111,북수원,청주,101,0,8,0,1,6,116,110,0,6,0,0,4,120,
20220909,212,171,북수원,마성,799,9,3,0,0,27,838,497,3,1,0,0,25,526,
20220909,212,172,북수원,용인,693,8,3,1,2,22,729,584,11,7,1,1,22,626,
20220909,212,173,북수원,양지,1003,20,14,11,4,38,1090,968,23,9,1,4,23,1028,
20220909,212,175,북수원,덕평,243,14,5,3,1,6,272,120,6,3,3,0,8,140,
20220909,212,176,북수원,이천,421,2,5,1,2,7,438,192,0,3,3,0,7,205,
20220909,212,177,북수원,여주,213,0,2,3,0,5,223,146,0,5,2,0,5,158,
20220909,212,178,북수원,문막,231,1,12,0,0,8,252,118,1,13,0,0,4,136,
20220909,212,193,북수원,일죽,96,0,5,0,0,6,107,150,0,5,0,0,5,160,
20220909,212,214,북수원,동군포,610,8,3,1,3,27,652,360,3,0,2,1,9,375,
20220909,212,215,북수원,군포,148,1,0,0,0,6,155,240,2,1,0,0,15,258,
20220909,212,253,북수원,서서울,2173,14,9,5,1,92,2294,1282,5,7,2,2,53,1351,
20220909,212,254,북수원,군자,1831,17,13,5,3,89,1958,1893,20,20,9,6,90,2038,
20220909,212,255,북수원,서안산,405,5,2,3,1,21,437,463,8,3,3,2,31,510,
20220909,212,256,북수원,안산,117,0,0,0,0,4,121,93,1,0,0,0,6,100,
20220909,212,528,북수원,기흥동탄,341,0,1,3,2,12,359,273,1,3,0,0,11,288,
20220909,212,560,북수원,감곡,208,0,5,0,0,11,224,150,0,5,0,0,1,156,
20220909,212,561,북수원,북충주,100,0,2,1,0,4,107,93,0,3,2,0,8,106,
20220909,213,102,부곡,동수원,560,11,4,5,0,31,611,573,8,4,0,0,28,613,
20220909,213,103,부곡,수원신갈,179,17,5,2,1,13,217,146,21,1,1,5,15,189,
20220909,213,253,부곡,서서울,1229,57,15,9,6,47,1363,1369,39,13,15,8,72,1516,
20220909,213,254,부곡,군자,849,17,1,2,5,41,915,1235,17,3,7,13,53,1328,
20220909,213,255,부곡,서안산,246,3,4,1,3,8,265,309,9,2,3,4,16,343,
20220909,214,102,동군포,동수원,1136,16,0,5,0,46,1203,1468,19,1,1,0,52,1541,
20220909,214,103,동군포,수원신갈,526,16,9,6,4,18,579,545,27,6,6,0,25,609,
20220909,214,105,동군포,기흥,159,1,1,5,0,8,174,163,4,0,7,2,6,182,
20220909,214,171,동군포,마성,184,2,0,0,0,9,195,226,0,0,0,0,11,237,
20220909,214,172,동군포,용인,125,2,1,3,1,6,138,177,0,0,1,0,10,188,
20220909,214,173,동군포,양지,210,5,2,4,0,6,227,273,7,6,8,0,13,307,
20220909,214,212,동군포,북수원,360,3,0,2,1,9,375,610,8,3,1,3,27,652,
20220909,214,528,동군포,기흥동탄,91,3,1,0,0,7,102,112,1,0,0,0,3,116,
20220909,215,102,군포,동수원,1369,4,4,0,1,84,1462,1022,5,1,2,0,54,1084,
20220909,215,103,군포,수원신갈,475,9,6,1,2,23,516,298,14,7,0,0,11,330,
20220909,215,171,군포,마성,219,4,0,0,0,10,233,147,1,0,0,0,7,155,
20220909,215,172,군포,용인,200,1,5,0,0,12,218,188,3,0,1,0,14,206,
20220909,215,173,군포,양지,148,3,2,0,1,6,160,222,7,7,2,4,7,249,
20220909,215,212,군포,북수원,240,2,1,0,0,15,258,148,1,0,0,0,6,155,
20220909,215,253,군포,서서울,2935,14,16,7,8,147,3127,6110,42,52,18,17,256,6495,
20220909,215,254,군포,군자,2033,14,13,2,11,99,2172,4491,40,17,13,22,162,4745,
20220909,215,255,군포,서안산,565,4,4,0,0,36,609,828,19,1,6,3,63,920,
20220909,215,256,군포,안산,139,1,0,0,0,3,143,166,4,0,0,1,7,178,
20220909,216,174,횡성,춘천,1025,29,7,7,0,49,1117,2030,33,5,9,3,92,2172,
20220909,216,178,횡성,문막,135,5,1,1,0,10,152,428,13,5,4,3,22,475,
20220909,216,179,횡성,홍천,192,6,3,1,0,9,211,304,6,2,3,0,8,323,
20220909,216,218,횡성,남원주,168,2,1,0,0,12,183,428,0,3,0,1,21,453,
20220909,217,174,북원주,춘천,545,11,6,4,1,39,606,967,19,26,6,3,52,1073,
20220909,217,179,북원주,홍천,175,3,1,3,0,5,187,256,7,2,2,1,7,275,
20220909,218,102,남원주,동수원,124,0,0,0,0,12,136,121,0,0,0,1,6,128,
20220909,218,174,남원주,춘천,1611,5,43,4,0,80,1743,1188,7,21,4,1,47,1268,
20220909,218,177,남원주,여주,222,3,13,6,0,7,251,221,1,5,3,0,5,235,
20220909,218,178,남원주,문막,103,3,0,0,1,5,112,249,5,0,0,0,11,265,
20220909,218,179,남원주,홍천,1047,3,4,2,2,37,1095,488,2,0,2,1,25,518,
20220909,218,189,남원주,강릉,255,1,1,2,0,13,272,222,0,6,2,0,9,239,
20220909,218,211,남원주,풍기,553,1,5,0,0,16,575,173,2,7,0,0,10,192,
20220909,218,216,남원주,횡성,428,0,3,0,1,21,453,168,2,1,0,0,12,183,
20220909,218,219,남원주,신림,884,4,2,1,4,40,935,389,2,0,2,2,19,414,
20220909,218,240,남원주,제천,2436,19,16,2,1,96,2570,1659,24,24,3,7,84,1801,
20220909,218,522,남원주,북단양,264,1,2,1,0,14,282,125,2,1,2,0,3,133,
20220909,219,218,신림,남원주,389,2,0,2,2,19,414,884,4,2,1,4,40,935,
20220909,219,240,신림,제천,1002,12,9,0,1,29,1053,568,8,2,0,1,14,593,
20220909,221,145,생초,산인,127,1,0,0,1,7,136,544,0,0,0,0,17,561,
20220909,222,291,산청,사천,93,0,0,6,1,4,104,122,0,0,5,1,5,133,
20220909,223,145,단성,산인,269,1,4,0,1,9,284,1019,0,2,0,0,27,1048,
20220909,223,225,단성,서진주,155,2,0,1,0,5,163,314,0,0,0,0,13,327,
20220909,223,291,단성,사천,377,3,1,1,0,13,395,457,2,2,1,0,12,474,
20220909,223,292,단성,진주,120,4,1,0,1,5,131,200,2,0,0,0,4,206,
20220909,223,516,단성,통영,150,0,0,0,0,6,156,407,0,2,1,0,15,425,
20220909,224,145,함양,산인,136,2,6,1,1,6,152,524,1,4,1,0,17,547,
20220909,224,170,함양,서상,214,2,3,0,0,8,227,275,3,6,0,0,16,300,
20220909,224,225,함양,서진주,182,1,0,0,0,8,191,221,1,1,0,2,9,234,
20220909,224,247,함양,남원,149,1,3,0,1,7,161,130,2,0,1,1,6,140,
20220909,224,280,함양,거창,205,3,31,1,0,4,244,209,4,23,0,0,11,247,
20220909,224,519,함양,남대구,133,2,0,0,0,10,145,217,2,0,0,0,14,233,
20220909,225,101,서진주,서울,136,0,34,0,0,1,171,409,0,10,0,0,10,429,
20220909,225,145,서진주,산인,387,4,0,1,0,12,404,713,8,2,2,2,22,749,
20220909,225,190,서진주,동서울,101,0,1,0,0,1,103,307,0,1,0,0,7,315,
20220909,225,223,서진주,단성,314,0,0,0,0,13,327,155,2,0,1,0,5,163,
20220909,225,224,서진주,함양,221,1,1,0,2,9,234,182,1,0,0,0,8,191,
20220909,225,244,서진주,서부산,100,0,0,0,0,7,107,112,0,0,0,0,2,114,
20220909,225,272,서진주,광양,175,3,1,3,4,2,188,152,5,0,0,3,3,163,
20220909,225,277,서진주,하동,110,1,0,1,11,6,129,109,1,0,0,12,9,131,
20220909,225,278,서진주,진교,297,0,1,1,0,9,308,255,1,1,0,1,16,274,
20220909,225,279,서진주,곤양,98,0,0,0,0,2,100,134,0,1,0,0,4,139,
20220909,225,291,서진주,사천,1078,12,5,2,5,58,1160,953,6,9,2,7,63,1040,
20220909,225,513,서진주,고성,216,2,0,0,0,14,232,176,5,0,1,1,16,199,
20220909,225,515,서진주,북통영,230,0,1,0,1,14,246,260,0,1,0,1,14,276,
20220909,225,516,서진주,통영,600,1,1,1,1,47,651,768,8,2,1,0,31,810,
20220909,225,544,서진주,완주,104,0,0,0,0,3,107,108,0,0,0,2,2,112,
20220909,227,253,군산,서서울,540,0,4,0,4,17,565,888,1,0,0,2,19,910,
20220909,227,257,군산,홍성,125,0,1,4,1,6,137,219,1,2,1,1,12,236,
20220909,227,259,군산,대천,297,0,13,4,1,9,324,310,1,6,0,1,6,324,
20220909,227,260,군산,춘장대,131,1,0,1,0,4,137,107,1,0,1,2,2,113,
20220909,227,299,군산,해미,105,0,2,1,0,2,110,182,1,1,1,0,6,191,
20220909,227,511,군산,무창포,306,2,2,5,1,4,320,482,1,3,3,2,9,500,
20220909,227,578,군산,서세종,339,2,1,2,2,12,358,336,2,5,0,0,15,358,
20220909,227,592,군산,서부여,177,2,3,1,0,0,183,99,0,1,0,0,3,103,
20220909,227,593,군산,부여,179,0,3,0,0,6,188,163,0,0,1,1,4,169,
20220909,227,595,군산,서공주,96,0,3,0,0,2,101,538,0,8,3,0,10,559,
20220909,227,613,군산,남풍세,128,1,4,1,6,2,142,381,2,3,0,1,11,398,
20220909,228,167,동군산,광주,576,6,2,1,6,16,607,850,9,3,1,4,20,887,
20220909,228,234,동군산,서천,178,1,1,0,0,6,186,215,2,2,0,1,3,223,
20220909,228,253,동군산,서서울,283,2,1,1,1,14,302,611,0,0,0,1,25,637,
20220909,228,257,동군산,홍성,249,0,5,2,3,6,265,112,1,9,1,5,3,131,
20220909,228,258,동군산,광천,159,1,7,4,2,5,178,310,0,3,0,2,9,324,
20220909,228,259,동군산,대천,594,8,8,1,2,14,627,278,3,0,0,0,9,290,
20220909,228,298,동군산,서산,91,1,0,0,7,4,103,167,0,0,0,12,4,183,
20220909,228,299,동군산,해미,179,1,1,2,2,1,186,131,0,1,1,6,4,143,
20220909,228,502,동군산,부안,296,3,3,2,0,9,313,192,2,3,0,2,12,211,
20220909,228,504,동군산,선운산,163,1,1,0,0,3,168,175,0,7,2,3,7,194,
20220909,228,505,동군산,고창,160,1,2,0,1,6,170,196,3,5,0,0,8,212,
20220909,228,506,동군산,영광,180,0,4,2,0,6,192,134,0,5,9,0,1,149,
20220909,228,509,동군산,목포,600,2,2,4,6,10,624,454,4,5,8,11,20,502,
20220909,228,511,동군산,무창포,645,9,43,2,9,22,730,285,7,16,0,1,12,321,
20220909,229,101,북천안,서울,755,13,12,6,3,31,820,901,15,83,10,1,31,1041,
20220909,229,103,북천안,수원신갈,108,1,0,1,0,5,115,141,2,3,3,0,2,151,
20220909,229,106,북천안,오산,132,1,2,6,1,4,146,326,1,2,1,1,11,342,
20220909,229,107,북천안,안성,255,0,1,0,3,15,274,341,5,1,0,2,14,363,
20220909,229,108,북천안,천안,2206,25,41,9,7,96,2384,1597,24,45,8,5,68,1747,
20220909,229,110,북천안,목천,277,2,3,9,1,9,301,143,5,2,7,4,6,167,
20220909,229,111,북천안,청주,236,2,4,4,0,10,256,148,8,2,5,1,6,170,
20220909,229,115,북천안,대전,97,0,3,0,0,2,102,91,1,6,0,0,3,101,
20220909,229,541,북천안,송탄,78,7,4,10,0,6,105,267,5,3,4,1,7,287,
20220909,229,601,북천안,남천안,906,2,5,9,1,32,955,119,2,2,5,2,5,135,
20220909,230,123,팔공산,구미,203,0,1,0,0,13,217,232,0,0,0,0,11,243,
20220909,230,125,팔공산,남구미,173,1,4,0,0,13,191,224,3,3,1,0,15,246,
20220909,230,127,팔공산,서대구,682,3,4,5,1,29,724,1015,7,3,8,0,41,1074,
20220909,230,129,팔공산,북대구,303,3,1,2,0,17,326,245,3,0,0,0,16,264,
20220909,230,131,팔공산,경산,648,11,5,4,2,41,711,825,28,12,5,0,61,931,
20220909,230,132,팔공산,영천,419,4,2,0,0,16,441,327,1,2,0,2,11,343,
20220909,230,133,팔공산,건천,137,0,1,0,0,5,143,123,0,0,0,0,3,126,
20220909,230,135,팔공산,경주,396,2,1,1,0,20,420,324,1,4,1,0,15,345,
20220909,230,231,팔공산,화원옥포,189,1,2,0,0,10,202,177,0,0,1,0,13,191,
20220909,230,233,팔공산,현풍,104,0,1,0,0,4,109,127,0,1,0,0,8,136,
20220909,230,524,팔공산,청통와촌,1311,14,11,2,1,57,1396,946,20,12,2,0,36,1016,
20220909,230,525,팔공산,북영천,1695,3,1,1,0,58,1758,917,3,1,1,0,36,958,
20220909,230,526,팔공산,서포항,468,0,1,0,0,18,487,121,1,0,1,0,3,126,
20220909,230,527,팔공산,포항,2412,9,7,1,5,102,2536,1683,7,5,3,2,58,1758,
20220909,230,621,팔공산,동대구,224,3,8,3,0,9,247,158,2,3,4,0,5,172,
20220909,230,641,팔공산,울산,124,1,1,1,6,4,137,198,1,1,0,3,1,204,
20220909,230,725,팔공산,임고,305,0,0,0,0,6,311,138,0,0,0,0,3,141,
20220909,230,730,팔공산,유천,300,0,0,0,0,12,312,242,0,0,0,0,7,249,
20220909,230,772,팔공산,북달성,119,2,1,0,0,3,125,131,0,3,0,0,7,141,
20220909,231,123,화원옥포,구미,103,1,0,1,0,0,105,102,1,0,0,1,2,106,
20220909,231,129,화원옥포,북대구,254,1,3,0,2,7,267,314,0,4,5,0,13,336,
20220909,231,201,화원옥포,칠곡,698,8,0,0,1,35,742,579,7,0,1,0,34,621,
20220909,231,203,화원옥포,가산,119,0,0,1,0,3,123,231,1,4,1,0,5,242,
20220909,231,230,화원옥포,팔공산,177,0,0,1,0,13,191,189,1,2,0,0,10,202,
20220909,231,232,화원옥포,달성,98,0,5,0,0,4,107,111,2,5,0,1,3,122,
20220909,231,233,화원옥포,현풍,461,6,3,0,3,19,492,412,4,2,1,2,17,438,
20220909,231,235,화원옥포,창녕,121,0,2,0,0,6,129,91,2,1,0,0,6,100,
20220909,231,239,화원옥포,칠원,263,6,1,1,0,5,276,329,2,4,1,1,20,357,
20220909,231,241,화원옥포,동고령,520,2,1,1,0,17,541,364,2,0,0,0,15,381,
20220909,231,242,화원옥포,고령,534,3,1,0,1,16,555,378,1,1,1,2,15,398,
20220909,231,243,화원옥포,해인사,265,0,0,0,1,13,279,209,0,0,0,0,14,223,
20220909,231,274,화원옥포,가조,134,0,0,1,0,1,136,103,0,0,0,0,3,106,
20220909,231,280,화원옥포,거창,285,1,4,0,0,16,306,168,2,3,0,1,9,183,
20220909,231,519,화원옥포,남대구,4866,18,28,5,2,287,5206,5491,16,35,7,2,331,5882,
20220909,231,527,화원옥포,포항,122,0,1,1,2,9,135,223,0,4,1,0,5,233,
20220909,231,538,화원옥포,성주,176,3,1,0,0,8,188,114,0,1,0,0,4,119,
20220909,231,621,화원옥포,동대구,125,1,3,2,0,6,137,161,1,0,0,0,9,171,
20220909,232,201,달성,칠곡,148,2,2,1,0,12,165,109,0,2,1,0,8,120,
20220909,232,231,달성,화원옥포,111,2,5,0,1,3,122,98,0,5,0,0,4,107,
20220909,232,519,달성,남대구,1641,14,36,0,1,109,1801,1665,11,18,0,2,88,1784,
20220909,233,129,현풍,북대구,171,3,4,0,2,7,187,196,1,4,1,0,11,213,
20220909,233,190,현풍,동서울,89,0,3,2,1,5,100,158,1,2,1,3,2,167,
20220909,233,201,현풍,칠곡,421,2,6,0,4,24,457,362,1,7,0,4,16,390,
20220909,233,230,현풍,팔공산,127,0,1,0,0,8,136,104,0,1,0,0,4,109,
20220909,233,231,현풍,화원옥포,412,4,2,1,2,17,438,461,6,3,0,3,19,492,
20220909,233,236,현풍,영산,100,1,0,0,2,9,112,269,6,5,4,10,5,299,
20220909,233,239,현풍,칠원,504,4,7,2,3,19,539,531,9,17,3,11,23,594,
20220909,233,241,현풍,동고령,212,3,1,0,0,9,225,120,2,1,1,1,5,130,
20220909,233,242,현풍,고령,95,3,3,0,0,2,103,97,1,1,0,0,3,102,
20220909,233,280,현풍,거창,138,2,2,3,0,9,154,135,1,2,3,0,6,147,
20220909,233,519,현풍,남대구,3630,29,44,14,15,201,3933,3864,19,39,18,16,204,4160,
20220909,233,527,현풍,포항,120,0,2,1,2,6,131,103,0,3,0,7,5,118,
20220909,233,537,현풍,남김천,247,1,3,4,2,9,266,253,2,4,10,7,11,287,
20220909,233,538,현풍,성주,281,2,2,3,2,10,300,212,3,0,3,3,11,232,
20220909,233,539,현풍,남성주,207,1,3,8,3,7,229,188,1,0,4,2,5,200,
20220909,233,621,현풍,동대구,99,1,1,0,3,6,110,106,0,0,2,3,4,115,
20220909,234,228,서천,동군산,215,2,2,0,1,3,223,178,1,1,0,0,6,186,
20220909,234,253,서천,서서울,733,1,2,0,8,39,783,1172,1,1,1,6,24,1205,
20220909,234,257,서천,홍성,182,1,2,1,2,4,192,271,1,3,1,6,6,288,
20220909,234,258,서천,광천,170,0,6,2,2,6,186,1571,2,6,6,7,34,1626,
20220909,234,259,서천,대천,425,1,2,1,1,16,446,440,6,8,4,0,19,477,
20220909,234,260,서천,춘장대,118,1,0,0,0,3,122,163,0,1,2,0,5,171,
20220909,234,299,서천,해미,121,0,1,1,3,2,128,190,0,0,0,1,5,196,
20220909,234,511,서천,무창포,426,5,12,3,8,15,469,657,10,25,7,13,14,726,
20220909,235,150,창녕,북부산,188,0,2,0,0,9,199,154,1,0,0,0,3,158,
20220909,235,231,창녕,화원옥포,91,2,1,0,0,6,100,121,0,2,0,0,6,129,
20220909,235,236,창녕,영산,97,0,1,1,1,5,105,331,1,2,1,1,10,346,
20220909,235,239,창녕,칠원,468,2,3,0,1,16,490,845,3,7,1,2,38,896,
20220909,235,244,창녕,서부산,209,1,2,2,0,8,222,177,0,2,0,1,11,191,
20220909,235,519,창녕,남대구,579,1,25,0,1,17,623,842,1,19,0,1,27,890,
20220909,236,190,영산,동서울,149,0,0,2,0,4,155,114,0,0,2,0,2,118,
20220909,236,233,영산,현풍,269,6,5,4,10,5,299,100,1,0,0,2,9,112,
20220909,236,235,영산,창녕,331,1,2,1,1,10,346,97,0,1,1,1,5,105,
20220909,236,239,영산,칠원,468,3,4,3,5,19,502,456,3,3,1,3,10,476,
20220909,236,519,영산,남대구,611,4,11,3,0,16,645,360,1,2,1,1,11,376,
20220909,237,150,남지,북부산,126,0,0,0,1,3,130,115,0,0,1,0,5,121,
20220909,237,239,남지,칠원,816,7,33,0,3,60,919,1173,10,38,3,3,75,1302,
20220909,237,244,남지,서부산,160,1,20,0,1,6,188,138,0,5,2,3,6,154,
20220909,237,519,남지,남대구,148,3,8,12,1,4,176,136,3,4,9,2,6,160,
20220909,238,150,칠서,북부산,175,5,8,9,1,5,203,103,2,3,3,0,8,119,
20220909,238,239,칠서,칠원,843,10,16,20,7,50,946,933,14,17,16,7,40,1027,
20220909,238,244,칠서,서부산,227,7,22,11,2,15,284,108,5,8,3,1,4,129,
20220909,238,519,칠서,남대구,105,1,3,0,1,5,115,105,0,2,0,1,4,112,
20220909,239,101,칠원,서울,256,1,126,1,0,3,387,394,0,212,1,0,12,619,
20220909,239,115,칠원,대전,169,0,12,0,0,5,186,247,0,13,0,0,5,265,
20220909,239,123,칠원,구미,179,0,2,3,0,3,187,229,1,1,1,0,7,239,
20220909,239,125,칠원,남구미,132,0,6,0,1,8,147,237,2,8,0,0,12,259,
20220909,239,190,칠원,동서울,596,0,9,1,0,20,626,607,0,4,4,1,12,628,
20220909,239,201,칠원,칠곡,380,2,2,1,2,12,399,207,1,0,0,0,9,217,
20220909,239,203,칠원,가산,101,0,0,1,0,2,104,298,4,0,0,0,10,312,
20220909,239,210,칠원,영주,236,0,0,1,0,13,250,105,0,0,0,1,4,110,
20220909,239,231,칠원,화원옥포,329,2,4,1,1,20,357,263,6,1,1,0,5,276,
20220909,239,233,칠원,현풍,531,9,17,3,11,23,594,504,4,7,2,3,19,539,
20220909,239,235,칠원,창녕,845,3,7,1,2,38,896,468,2,3,0,1,16,490,
20220909,239,236,칠원,영산,456,3,3,1,3,10,476,468,3,4,3,5,19,502,
20220909,239,237,칠원,남지,1173,10,38,3,3,75,1302,816,7,33,0,3,60,919,
20220909,239,238,칠원,칠서,933,14,17,16,7,40,1027,843,10,16,20,7,50,946,
20220909,239,253,칠원,서서울,212,1,2,0,3,5,223,154,0,2,2,2,3,163,
20220909,239,254,칠원,군자,120,0,6,8,3,9,146,119,0,5,3,9,4,140,
20220909,239,280,칠원,거창,625,6,1,1,1,24,658,212,2,4,1,0,14,233,
20220909,239,519,칠원,남대구,2087,9,62,6,7,78,2249,1810,11,68,12,8,82,1991,
20220909,239,537,칠원,남김천,438,2,1,4,12,17,474,246,2,3,7,6,12,276,
20220909,239,570,칠원,북상주,164,0,0,0,0,6,170,387,0,0,4,4,10,405,
20220909,240,102,제천,동수원,136,0,10,0,2,4,152,248,0,9,0,0,15,272,
20220909,240,174,제천,춘천,398,2,2,0,0,20,422,647,2,3,0,0,27,679,
20220909,240,177,제천,여주,100,2,8,4,0,5,119,113,1,7,6,1,3,131,
20220909,240,178,제천,문막,189,13,3,1,3,5,214,516,11,4,1,6,12,550,
20220909,240,179,제천,홍천,182,2,1,0,0,11,196,111,0,0,0,0,6,117,
20220909,240,211,제천,풍기,620,3,6,2,4,12,647,90,0,6,0,1,5,102,
20220909,240,218,제천,남원주,1659,24,24,3,7,84,1801,2436,19,16,2,1,96,2570,
20220909,240,219,제천,신림,568,8,2,0,1,14,593,1002,12,9,0,1,29,1053,
20220909,240,254,제천,군자,102,0,3,0,1,2,108,531,2,1,1,3,19,557,
20220909,240,523,제천,남제천,375,0,0,1,1,12,389,141,2,0,0,0,8,151,
20220909,241,129,동고령,북대구,101,2,10,0,0,5,118,187,1,3,0,0,6,197,
20220909,241,201,동고령,칠곡,181,1,1,0,0,6,189,271,2,4,0,0,11,288,
20220909,241,231,동고령,화원옥포,364,2,0,0,0,15,381,520,2,1,1,0,17,541,
20220909,241,233,동고령,현풍,120,2,1,1,1,5,130,212,3,1,0,0,9,225,
20220909,241,519,동고령,남대구,2766,16,35,6,2,142,2967,3631,15,38,5,0,170,3859,
20220909,242,129,고령,북대구,112,1,3,0,4,5,125,165,1,1,0,4,4,175,
20220909,242,201,고령,칠곡,190,1,0,1,1,10,203,230,1,0,0,1,5,237,
20220909,242,231,고령,화원옥포,378,1,1,1,2,15,398,534,3,1,0,1,16,555,
20220909,242,233,고령,현풍,97,1,1,0,0,3,102,95,3,3,0,0,2,103,
20220909,242,243,고령,해인사,595,2,2,0,0,42,641,561,5,0,0,0,46,612,
20220909,242,274,고령,가조,265,1,4,2,1,7,280,123,3,3,1,1,5,136,
20220909,242,280,고령,거창,455,7,21,2,0,21,506,154,2,15,0,0,12,183,
20220909,242,519,고령,남대구,2122,11,34,2,10,100,2279,2844,10,18,3,11,114,3000,
20220909,242,527,고령,포항,135,0,0,0,4,3,142,244,0,0,2,5,9,260,
20220909,242,537,고령,남김천,106,0,0,1,1,3,111,120,0,0,0,0,3,123,
20220909,243,231,해인사,화원옥포,209,0,0,0,0,14,223,265,0,0,0,1,13,279,
20220909,243,242,해인사,고령,561,5,0,0,0,46,612,595,2,2,0,0,42,641,
20220909,243,280,해인사,거창,159,2,1,0,0,10,172,118,1,0,0,0,11,130,
20220909,243,519,해인사,남대구,867,1,2,0,2,23,895,1135,1,1,1,0,38,1176,
20220909,244,142,서부산,군북,657,1,0,3,4,25,690,394,2,3,4,6,17,426,
20220909,244,144,서부산,함안,148,2,1,0,3,6,160,154,1,0,1,2,8,166,
20220909,244,146,서부산,동창원,2843,9,19,7,14,90,2982,1346,9,7,1,8,56,1427,
20220909,244,147,서부산,진례,1412,36,15,11,10,56,1540,940,23,11,17,13,49,1053,
20220909,244,225,서부산,서진주,112,0,0,0,0,2,114,100,0,0,0,0,7,107,
20220909,244,235,서부산,창녕,177,0,2,0,1,11,191,209,1,2,2,0,8,222,
20220909,244,237,서부산,남지,138,0,5,2,3,6,154,160,1,20,0,1,6,188,
20220909,244,238,서부산,칠서,108,5,8,3,1,4,129,227,7,22,11,2,15,284,
20220909,244,245,서부산,장유,14048,63,237,20,35,847,15250,12292,48,233,14,46,804,13437,
20220909,244,261,서부산,동광주,294,1,15,1,1,8,320,285,1,14,0,2,8,310,
20220909,244,272,서부산,광양,979,4,10,3,2,32,1030,460,2,13,2,6,9,492,
20220909,244,275,서부산,옥곡,157,1,10,2,28,4,202,285,2,11,0,34,12,344,
20220909,244,277,서부산,하동,331,0,3,0,7,16,357,177,0,1,2,6,7,193,
20220909,244,278,서부산,진교,471,0,7,0,0,16,494,174,0,8,1,0,9,192,
20220909,244,280,서부산,거창,188,1,3,0,0,7,199,126,1,2,0,0,6,135,
20220909,244,289,서부산,마산,6099,18,265,7,19,181,6589,3614,13,248,3,7,146,4031,
20220909,244,291,서부산,사천,838,2,6,1,3,30,880,516,3,13,2,2,34,570,
20220909,244,292,서부산,진주,323,2,18,1,5,14,363,378,3,19,4,3,16,423,
20220909,244,293,서부산,문산,280,0,2,1,1,15,299,266,1,1,0,1,15,284,
20220909,244,294,서부산,북창원,295,0,1,0,0,13,309,430,2,1,1,1,22,457,
20220909,244,295,서부산,진성,184,1,0,0,0,4,189,153,0,1,0,1,2,157,
20220909,244,544,서부산,완주,118,3,19,3,21,1,165,194,3,11,0,15,9,232,
20220909,245,135,장유,경주,682,1,5,0,3,32,723,398,0,7,2,5,23,435,
20220909,245,138,장유,양산,149,13,0,4,3,8,177,190,15,2,2,2,9,220,
20220909,245,139,장유,서울산,169,0,1,0,1,10,181,203,0,0,1,0,7,211,
20220909,245,142,장유,군북,142,0,1,1,0,5,149,101,2,1,1,0,2,107,
20220909,245,146,장유,동창원,1463,3,7,5,1,70,1549,821,6,2,0,0,59,888,
20220909,245,147,장유,진례,996,12,17,3,1,62,1091,823,8,13,4,0,68,916,
20220909,245,149,장유,동김해,435,19,9,4,1,31,499,626,15,6,7,2,49,705,
20220909,245,150,장유,북부산,3217,16,63,1,7,174,3478,4214,7,57,4,12,231,4525,
20220909,245,244,장유,서부산,12292,48,233,14,46,804,13437,14048,63,237,20,35,847,15250,
20220909,245,245,장유,장유,298,1,1,0,0,26,326,298,1,1,0,0,26,326,
20220909,245,250,장유,남양산,603,23,27,2,2,34,691,507,18,25,0,3,24,577,
20220909,245,251,장유,물금,421,26,2,1,6,20,476,600,32,2,3,1,35,673,
20220909,245,289,장유,마산,1689,11,24,10,1,61,1796,1169,13,25,21,2,57,1287,
20220909,245,291,장유,사천,138,0,0,0,0,4,142,114,0,0,0,0,7,121,
20220909,245,294,장유,북창원,146,0,0,0,0,15,161,229,3,0,0,1,19,252,
20220909,245,529,장유,노포,205,1,2,0,1,5,214,345,1,1,0,1,13,361,
20220909,245,641,장유,울산,478,3,15,3,4,21,524,831,2,14,1,2,39,889,
20220909,247,224,남원,함양,130,2,0,1,1,6,140,149,1,3,0,1,7,161,
20220909,247,248,남원,순창,249,7,2,0,1,8,267,291,6,1,0,0,14,312,
20220909,247,261,남원,동광주,572,7,17,1,0,17,614,909,5,19,2,0,28,963,
20220909,247,264,남원,동남원,532,2,7,0,0,16,557,572,2,5,0,1,18,598,
20220909,247,269,남원,지리산,1138,7,5,2,0,39,1191,854,8,4,1,1,31,899,
20220909,247,569,남원,북광주,180,3,3,1,1,4,192,384,3,1,2,1,19,410,
20220909,248,247,순창,남원,291,6,1,0,0,14,312,249,7,2,0,1,8,267,
20220909,248,261,순창,동광주,3337,13,16,5,2,83,3456,2178,5,11,2,1,68,2265,
20220909,248,569,순창,북광주,541,3,4,0,7,24,579,873,1,10,2,5,34,925,
20220909,249,261,담양,동광주,3593,14,89,3,1,111,3811,3274,16,83,4,2,95,3474,
20220909,249,271,담양,순천,179,1,4,2,0,3,189,242,0,3,1,0,2,248,
20220909,249,569,담양,북광주,372,5,1,3,1,7,389,556,4,2,4,0,17,583,
20220909,250,135,남양산,경주,680,4,16,0,1,17,718,399,4,10,2,0,13,428,
20220909,250,137,남양산,통도사,284,7,11,0,1,19,322,305,10,11,0,1,21,348,
20220909,250,138,남양산,양산,356,10,1,0,2,19,388,191,9,6,1,0,7,214,
20220909,250,139,남양산,서울산,591,6,4,1,0,35,637,540,11,5,2,0,29,587,
20220909,250,140,남양산,부산,7269,65,146,7,3,367,7857,7226,69,147,8,8,383,7841,
20220909,250,146,남양산,동창원,321,5,3,1,0,10,340,144,3,3,1,0,4,155,
20220909,250,148,남양산,서김해,620,10,8,4,1,42,685,852,8,9,8,4,44,925,
20220909,250,149,남양산,동김해,736,9,37,5,0,40,827,895,13,44,1,0,58,1011,
20220909,250,245,남양산,장유,507,18,25,0,3,24,577,603,23,27,2,2,34,691,
20220909,250,252,남양산,대동,2599,41,35,10,11,153,2849,3482,47,36,19,35,189,3808,
20220909,250,286,남양산,통도사휴게소,359,3,0,0,0,20,382,320,3,0,0,0,14,337,
20220909,250,289,남양산,마산,787,11,23,3,1,35,860,487,13,23,1,0,15,539,
20220909,250,529,남양산,노포,319,7,4,2,0,22,354,266,1,5,0,0,24,296,
20220909,250,641,남양산,울산,526,15,25,0,2,27,595,535,22,23,4,2,24,610,
20220909,250,752,남양산,기장철마,250,1,8,0,0,14,273,321,4,2,0,0,21,348,
20220909,250,755,남양산,광재,267,0,1,0,1,16,285,329,6,0,0,2,20,357,
20220909,250,757,남양산,진영,211,3,0,2,0,10,226,152,5,1,2,1,7,168,
20220909,251,139,물금,서울산,142,7,1,1,1,10,162,121,0,1,1,0,4,127,
20220909,251,140,물금,부산,774,50,9,7,6,47,893,472,61,8,6,13,26,586,
20220909,251,146,물금,동창원,329,5,2,0,0,14,350,130,6,1,0,0,3,140,
20220909,251,148,물금,서김해,699,27,10,7,6,36,785,699,15,7,5,4,32,762,
20220909,251,149,물금,동김해,807,15,2,6,2,59,891,719,26,4,9,1,50,809,
20220909,251,245,물금,장유,600,32,2,3,1,35,673,421,26,2,1,6,20,476,
20220909,251,252,물금,대동,2594,116,14,13,108,145,2990,2866,118,7,8,172,151,3322,
20220909,251,289,물금,마산,819,14,0,5,3,24,865,364,17,3,0,1,14,399,
20220909,251,641,물금,울산,107,14,4,4,2,6,137,143,15,1,4,1,3,167,
20220909,251,755,물금,광재,301,9,5,0,0,19,334,321,6,1,0,0,14,342,
20220909,251,757,물금,진영,240,9,2,2,0,7,260,153,9,1,2,0,5,170,
20220909,252,132,대동,영천,302,1,0,8,6,8,325,111,1,0,1,1,6,120,
20220909,252,133,대동,건천,450,0,2,0,4,11,467,246,2,0,2,6,5,261,
20220909,252,135,대동,경주,2711,7,37,4,15,111,2885,1653,7,41,7,22,67,1797,
20220909,252,137,대동,통도사,403,7,6,2,10,17,445,440,12,8,6,7,22,495,
20220909,252,138,대동,양산,1816,78,19,24,29,87,2053,1830,95,16,28,30,79,2078,
20220909,252,139,대동,서울산,1011,9,9,2,8,55,1094,1020,9,8,0,5,42,1084,
20220909,252,140,대동,부산,1047,9,9,9,23,58,1155,960,13,10,10,9,52,1054,
20220909,252,250,대동,남양산,3482,47,36,19,35,189,3808,2599,41,35,10,11,153,2849,
20220909,252,251,대동,물금,2866,118,7,8,172,151,3322,2594,116,14,13,108,145,2990,
20220909,252,286,대동,통도사휴게소,619,6,2,0,0,16,643,589,1,0,0,0,13,603,
20220909,252,529,대동,노포,336,0,17,0,1,22,376,1212,8,13,4,7,58,1302,
20220909,252,641,대동,울산,1565,8,27,2,12,80,1694,2188,13,29,1,8,123,2362,
20220909,252,643,대동,청량,91,1,1,9,7,11,120,200,0,1,3,22,23,249,
20220909,252,707,대동,남포항,368,1,2,1,13,22,407,110,0,0,0,18,8,136,
20220909,252,722,대동,활천,250,4,1,5,9,6,275,137,3,2,7,4,4,157,
20220909,252,752,대동,기장철마,1671,14,8,6,27,97,1823,2162,10,9,4,7,132,2324,
20220909,252,753,대동,금정,1595,15,19,17,41,80,1767,871,10,9,10,11,41,952,
20220909,252,755,대동,광재,1707,12,8,6,9,85,1827,1453,13,11,6,5,76,1564,
20220909,252,756,대동,한림,554,4,2,3,1,31,595,590,8,4,9,6,32,649,
20220909,252,757,대동,진영,587,7,4,0,2,39,639,604,5,3,0,3,38,653,
20220909,253,102,서서울,동수원,5096,26,21,7,1,216,5367,5586,20,23,3,4,217,5853,
20220909,253,103,서서울,수원신갈,2466,30,26,26,5,99,2652,2040,53,46,30,8,94,2271,
20220909,253,105,서서울,기흥,811,5,2,2,2,38,860,725,3,2,16,0,37,783,
20220909,253,106,서서울,오산,288,13,8,4,2,9,324,253,30,7,3,1,8,302,
20220909,253,107,서서울,안성,222,2,0,0,0,11,235,297,2,3,0,0,21,323,
20220909,253,108,서서울,천안,610,1,2,0,0,19,632,462,2,1,1,0,18,484,
20220909,253,111,서서울,청주,170,0,2,3,0,4,179,226,0,2,2,1,11,242,
20220909,253,113,서서울,신탄진,180,0,0,0,2,6,188,173,0,0,0,0,7,180,
20220909,253,115,서서울,대전,200,0,0,0,0,4,204,178,0,0,0,1,5,184,
20220909,253,127,서서울,서대구,188,0,2,0,0,4,194,117,1,1,0,0,6,125,
20220909,253,129,서서울,북대구,187,0,0,2,0,3,192,150,0,1,0,0,6,157,
20220909,253,136,서서울,음성,503,0,0,0,1,10,514,119,0,0,1,0,6,126,
20220909,253,167,서서울,광주,1154,2,2,0,0,21,1179,873,1,9,1,0,12,896,
20220909,253,171,서서울,마성,870,2,2,3,2,33,912,821,2,1,1,1,33,859,
20220909,253,172,서서울,용인,725,10,1,5,4,24,769,785,5,3,5,3,49,850,
20220909,253,173,서서울,양지,1092,13,11,12,5,45,1178,941,34,8,17,9,48,1057,
20220909,253,175,서서울,덕평,262,7,5,6,0,13,293,134,10,6,2,0,8,160,
20220909,253,176,서서울,이천,430,0,0,2,4,14,450,253,3,0,2,2,10,270,
20220909,253,177,서서울,여주,171,0,1,1,0,2,175,153,0,0,5,4,8,170,
20220909,253,178,서서울,문막,189,0,0,0,1,11,201,115,2,0,0,0,3,120,
20220909,253,193,서서울,일죽,154,0,0,1,3,6,164,206,2,4,14,1,12,239,
20220909,253,212,서서울,북수원,1282,5,7,2,2,53,1351,2173,14,9,5,1,92,2294,
20220909,253,213,서서울,부곡,1369,39,13,15,8,72,1516,1229,57,15,9,6,47,1363,
20220909,253,215,서서울,군포,6110,42,52,18,17,256,6495,2935,14,16,7,8,147,3127,
20220909,253,227,서서울,군산,888,1,0,0,2,19,910,540,0,4,0,4,17,565,
20220909,253,228,서서울,동군산,611,0,0,0,1,25,637,283,2,1,1,1,14,302,
20220909,253,234,서서울,서천,1172,1,1,1,6,24,1205,733,1,2,0,8,39,783,
20220909,253,239,서서울,칠원,154,0,2,2,2,3,163,212,1,2,0,3,5,223,
20220909,253,254,서서울,군자,228,5,2,0,2,15,252,697,2,3,0,1,38,741,
20220909,253,255,서서울,서안산,8607,78,45,61,61,413,9265,9176,83,37,44,57,462,9859,
20220909,253,256,서서울,안산,8127,43,25,11,10,485,8701,5603,24,20,3,5,335,5990,
20220909,253,257,서서울,홍성,1125,1,1,1,2,28,1158,799,1,3,1,0,36,840,
20220909,253,258,서서울,광천,755,0,2,2,0,25,784,719,1,3,1,3,22,749,
20220909,253,259,서서울,대천,1005,1,5,2,0,32,1045,800,2,12,0,0,34,848,
20220909,253,260,서서울,춘장대,348,0,0,0,0,8,356,208,1,1,0,1,16,227,
20220909,253,281,서서울,매송,4319,10,6,2,5,204,4546,3382,13,3,3,2,195,3598,
20220909,253,282,서서울,비봉,6647,37,29,13,51,268,7045,4154,61,46,26,33,245,4565,
20220909,253,283,서서울,발안,6482,32,16,17,13,252,6812,4309,52,16,20,19,229,4645,
20220909,253,285,서서울,서평택,1349,3,12,10,22,53,1449,1016,7,12,24,75,68,1202,
20220909,253,287,서서울,송악,1352,3,2,5,28,51,1441,2074,4,8,6,54,96,2242,
20220909,253,288,서서울,당진,1739,1,15,2,5,67,1829,1891,2,27,2,1,82,2005,
20220909,253,298,서서울,서산,2963,4,3,8,0,104,3082,3128,13,7,6,1,128,3283,
20220909,253,299,서서울,해미,408,0,0,1,0,12,421,331,0,0,4,1,13,349,
20220909,253,502,서서울,부안,719,0,0,0,0,24,743,250,2,1,1,1,5,260,
20220909,253,506,서서울,영광,627,0,0,0,0,16,643,151,0,0,0,0,4,155,
20220909,253,509,서서울,목포,2560,1,1,2,0,40,2604,848,0,18,3,1,14,884,
20220909,253,511,서서울,무창포,335,1,1,0,0,12,349,206,0,3,0,0,5,214,
20220909,253,520,서서울,평택,3751,7,9,13,15,113,3908,1879,17,14,15,20,62,2007,
20220909,253,528,서서울,기흥동탄,501,1,4,6,3,12,527,542,7,8,0,5,22,584,
20220909,253,540,서서울,청북,2184,8,2,10,9,64,2277,677,12,4,4,12,42,751,
20220909,253,541,서서울,송탄,90,3,2,4,1,4,104,172,2,3,1,2,8,188,
20220909,253,543,서서울,남안성,226,5,4,3,1,8,247,282,7,0,4,3,12,308,
20220909,253,555,서서울,북진천,299,0,2,2,3,8,314,172,1,0,2,4,8,187,
20220909,253,560,서서울,감곡,366,0,0,1,1,9,377,210,2,0,0,0,6,218,
20220909,253,561,서서울,북충주,159,1,0,0,0,8,168,183,0,0,3,0,6,192,
20220909,253,562,서서울,충주,161,0,1,0,2,8,172,155,0,0,0,1,11,167,
20220909,253,566,서서울,점촌함창,139,0,0,0,0,5,144,104,1,0,1,0,5,111,
20220909,253,569,서서울,북광주,98,5,0,0,0,3,106,125,3,0,0,0,1,129,
20220909,253,572,서서울,고덕,605,0,0,0,0,23,628,601,3,1,0,2,21,628,
20220909,253,573,서서울,예산수덕사,728,1,1,0,1,17,748,742,1,3,0,1,37,784,
20220909,253,574,서서울,신양,367,1,1,0,0,5,374,204,2,1,0,0,5,212,
20220909,253,741,서서울,평택고덕,723,3,1,0,1,37,765,713,6,1,3,2,53,778,
20220909,254,102,군자,동수원,4833,34,50,10,7,230,5164,4056,20,34,4,6,166,4286,
20220909,254,103,군자,수원신갈,2228,32,30,60,26,112,2488,1716,46,28,23,24,83,1920,
20220909,254,105,군자,기흥,785,8,3,9,4,24,833,596,7,2,12,2,28,647,
20220909,254,106,군자,오산,282,8,11,14,0,18,333,193,16,10,11,1,12,243,
20220909,254,107,군자,안성,122,1,1,1,0,6,131,98,2,0,2,0,4,106,
20220909,254,108,군자,천안,250,1,8,0,1,12,272,181,3,2,1,1,13,201,
20220909,254,111,군자,청주,115,2,12,0,0,5,134,99,0,1,0,1,3,104,
20220909,254,171,군자,마성,855,5,5,5,2,43,915,560,2,1,1,1,32,597,
20220909,254,172,군자,용인,724,6,6,8,3,38,785,507,2,3,8,3,25,548,
20220909,254,173,군자,양지,903,10,15,32,23,39,1022,695,20,17,38,21,35,826,
20220909,254,175,군자,덕평,246,15,15,16,5,13,310,108,11,6,4,1,8,138,
20220909,254,176,군자,이천,460,1,12,8,17,22,520,244,2,7,8,8,11,280,
20220909,254,177,군자,여주,249,0,1,3,1,10,264,158,0,3,7,4,6,178,
20220909,254,178,군자,문막,305,1,19,0,1,13,339,163,1,16,1,2,12,195,
20220909,254,193,군자,일죽,116,0,5,6,0,9,136,164,3,5,9,5,9,195,
20220909,254,212,군자,북수원,1893,20,20,9,6,90,2038,1831,17,13,5,3,89,1958,
20220909,254,213,군자,부곡,1235,17,3,7,13,53,1328,849,17,1,2,5,41,915,
20220909,254,215,군자,군포,4491,40,17,13,22,162,4745,2033,14,13,2,11,99,2172,
20220909,254,239,군자,칠원,119,0,5,3,9,4,140,120,0,6,8,3,9,146,
20220909,254,240,군자,제천,531,2,1,1,3,19,557,102,0,3,0,1,2,108,
20220909,254,253,군자,서서울,697,2,3,0,1,38,741,228,5,2,0,2,15,252,
20220909,254,255,군자,서안산,9001,105,35,43,58,481,9723,7964,113,33,34,36,439,8619,
20220909,254,256,군자,안산,5060,41,94,12,17,286,5510,5130,39,80,12,17,371,5649,
20220909,254,281,군자,매송,1023,6,4,2,3,46,1084,737,3,4,2,2,33,781,
20220909,254,282,군자,비봉,1355,19,10,13,13,73,1483,823,20,4,10,6,30,893,
20220909,254,283,군자,발안,1380,8,8,4,5,62,1467,998,4,8,3,6,50,1069,
20220909,254,285,군자,서평택,129,0,1,0,5,5,140,85,2,0,1,6,8,102,
20220909,254,287,군자,송악,148,2,1,0,3,5,159,235,1,1,0,8,6,251,
20220909,254,288,군자,당진,156,2,2,0,0,4,164,195,0,6,0,0,8,209,
20220909,254,298,군자,서산,320,0,3,0,3,14,340,279,2,10,1,3,16,311,
20220909,254,520,군자,평택,627,3,4,3,2,20,659,412,4,2,3,1,17,439,
20220909,254,528,군자,기흥동탄,460,6,7,3,6,21,503,444,1,6,3,0,21,475,
20220909,254,560,군자,감곡,365,3,3,0,4,10,385,197,0,0,3,2,11,213,
20220909,254,561,군자,북충주,158,0,4,0,0,9,171,121,0,13,0,0,8,142,
20220909,254,562,군자,충주,137,0,1,1,0,8,147,103,0,1,0,2,5,111,
20220909,254,741,군자,평택고덕,129,0,0,0,0,8,137,128,1,0,0,0,6,135,
20220909,255,102,서안산,동수원,1192,22,3,6,3,54,1280,871,20,3,3,2,42,941,
20220909,255,103,서안산,수원신갈,589,39,11,14,6,27,686,377,24,11,7,11,16,446,
20220909,255,105,서안산,기흥,167,8,1,5,2,6,189,108,4,3,8,1,6,130,
20220909,255,171,서안산,마성,244,4,2,1,1,15,267,159,2,2,1,0,6,170,
20220909,255,172,서안산,용인,239,4,2,3,0,11,259,164,3,3,0,4,8,182,
20220909,255,173,서안산,양지,193,7,8,14,3,15,240,181,12,9,27,5,11,245,
20220909,255,212,서안산,북수원,463,8,3,3,2,31,510,405,5,2,3,1,21,437,
20220909,255,213,서안산,부곡,309,9,2,3,4,16,343,246,3,4,1,3,8,265,
20220909,255,215,서안산,군포,828,19,1,6,3,63,920,565,4,4,0,0,36,609,
20220909,255,253,서안산,서서울,9176,83,37,44,57,462,9859,8607,78,45,61,61,413,9265,
20220909,255,254,서안산,군자,7964,113,33,34,36,439,8619,9001,105,35,43,58,481,9723,
20220909,255,256,서안산,안산,440,4,8,3,3,29,487,583,9,6,3,1,43,645,
20220909,255,282,서안산,비봉,192,2,0,1,0,8,203,96,2,4,1,0,8,111,
20220909,255,283,서안산,발안,272,2,0,0,1,16,291,178,4,2,2,0,13,199,
20220909,256,102,안산,동수원,414,3,1,0,0,20,438,405,4,0,0,0,21,430,
20220909,256,103,안산,수원신갈,184,2,4,0,0,10,200,156,5,3,0,0,6,170,
20220909,256,212,안산,북수원,93,1,0,0,0,6,100,117,0,0,0,0,4,121,
20220909,256,215,안산,군포,166,4,0,0,1,7,178,139,1,0,0,0,3,143,
20220909,256,253,안산,서서울,5603,24,20,3,5,335,5990,8127,43,25,11,10,485,8701,
20220909,256,254,안산,군자,5130,39,80,12,17,371,5649,5060,41,94,12,17,286,5510,
20220909,256,255,안산,서안산,583,9,6,3,1,43,645,440,4,8,3,3,29,487,
20220909,257,227,홍성,군산,219,1,2,1,1,12,236,125,0,1,4,1,6,137,
20220909,257,228,홍성,동군산,112,1,9,1,5,3,131,249,0,5,2,3,6,265,
20220909,257,234,홍성,서천,271,1,3,1,6,6,288,182,1,2,1,2,4,192,
20220909,257,253,홍성,서서울,799,1,3,1,0,36,840,1125,1,1,1,2,28,1158,
20220909,257,258,홍성,광천,245,2,5,1,2,9,264,154,2,1,2,1,1,161,
20220909,257,259,홍성,대천,246,5,7,1,0,10,269,251,9,8,3,0,11,282,
20220909,257,282,홍성,비봉,115,1,1,0,0,2,119,148,0,1,0,0,4,153,
20220909,257,288,홍성,당진,164,2,0,0,1,3,170,1253,2,6,0,0,26,1287,
20220909,257,298,홍성,서산,184,1,4,1,9,7,206,447,3,1,4,8,15,478,
20220909,257,299,홍성,해미,98,2,0,1,0,2,103,293,3,2,0,1,8,307,
20220909,257,520,홍성,평택,232,1,3,0,0,8,244,328,2,0,0,0,17,347,
20220909,258,228,광천,동군산,310,0,3,0,2,9,324,159,1,7,4,2,5,178,
20220909,258,234,광천,서천,1571,2,6,6,7,34,1626,170,0,6,2,2,6,186,
20220909,258,253,광천,서서울,719,1,3,1,3,22,749,755,0,2,2,0,25,784,
20220909,258,257,광천,홍성,154,2,1,2,1,1,161,245,2,5,1,2,9,264,
20220909,258,259,광천,대천,1184,10,10,3,0,30,1237,541,8,3,2,1,19,574,
20220909,258,298,광천,서산,119,3,0,3,4,5,134,200,3,1,3,4,5,216,
20220909,258,299,광천,해미,128,0,0,0,0,3,131,173,0,0,2,0,6,181,
20220909,258,520,광천,평택,143,0,2,0,1,4,150,171,0,3,0,0,5,179,
20220909,259,227,대천,군산,310,1,6,0,1,6,324,297,0,13,4,1,9,324,
20220909,259,228,대천,동군산,278,3,0,0,0,9,290,594,8,8,1,2,14,627,
20220909,259,234,대천,서천,440,6,8,4,0,19,477,425,1,2,1,1,16,446,
20220909,259,253,대천,서서울,800,2,12,0,0,34,848,1005,1,5,2,0,32,1045,
20220909,259,257,대천,홍성,251,9,8,3,0,11,282,246,5,7,1,0,10,269,
20220909,259,258,대천,광천,541,8,3,2,1,19,574,1184,10,10,3,0,30,1237,
20220909,259,260,대천,춘장대,102,1,1,1,1,3,109,122,1,1,1,0,3,128,
20220909,259,288,대천,당진,124,1,5,0,2,4,136,603,2,5,0,0,13,623,
20220909,259,298,대천,서산,167,1,2,3,3,8,184,294,1,4,3,4,14,320,
20220909,259,299,대천,해미,178,4,7,1,1,3,194,123,4,3,0,0,5,135,
20220909,259,520,대천,평택,230,0,14,2,0,13,259,261,1,13,2,0,14,291,
20220909,260,227,춘장대,군산,107,1,0,1,2,2,113,131,1,0,1,0,4,137,
20220909,260,234,춘장대,서천,163,0,1,2,0,5,171,118,1,0,0,0,3,122,
20220909,260,253,춘장대,서서울,208,1,1,0,1,16,227,348,0,0,0,0,8,356,
20220909,260,259,춘장대,대천,122,1,1,1,0,3,128,102,1,1,1,1,3,109,
20220909,260,511,춘장대,무창포,170,2,6,1,1,10,190,167,2,2,1,0,5,177,
20220909,261,135,동광주,경주,243,0,4,0,0,4,251,143,0,4,0,0,0,147,
20220909,261,145,동광주,산인,456,3,52,5,0,15,531,835,1,60,3,1,31,931,
20220909,261,150,동광주,북부산,238,1,0,0,1,7,247,185,1,0,0,0,6,192,
20220909,261,244,동광주,서부산,285,1,14,0,2,8,310,294,1,15,1,1,8,320,
20220909,261,247,동광주,남원,909,5,19,2,0,28,963,572,7,17,1,0,17,614,
20220909,261,248,동광주,순창,2178,5,11,2,1,68,2265,3337,13,16,5,2,83,3456,
20220909,261,249,동광주,담양,3274,16,83,4,2,95,3474,3593,14,89,3,1,111,3811,
20220909,261,262,동광주,창평,2243,45,9,7,2,67,2373,1986,31,6,10,2,73,2108,
20220909,261,263,동광주,옥과,3464,5,44,4,3,109,3629,2656,6,42,1,5,80,2790,
20220909,261,264,동광주,동남원,273,1,0,0,0,14,288,248,2,3,0,0,3,256,
20220909,261,265,동광주,곡성,2331,5,18,0,4,65,2423,1448,3,18,3,3,50,1525,
20220909,261,266,동광주,석곡,906,5,1,0,0,33,945,501,1,1,1,1,23,528,
20220909,261,267,동광주,주암송광사,497,2,1,0,0,11,511,227,2,1,1,0,4,235,
20220909,261,268,동광주,승주,237,0,0,0,1,6,244,133,0,0,0,1,4,138,
20220909,261,269,동광주,지리산,204,0,1,0,0,7,212,126,2,0,0,0,4,132,
20220909,261,270,동광주,서순천,1264,9,46,1,1,42,1363,989,6,49,0,2,33,1079,
20220909,261,271,동광주,순천,4718,44,71,7,18,133,4991,4248,51,75,3,33,99,4509,
20220909,261,272,동광주,광양,504,3,30,0,3,14,554,285,2,18,1,9,11,326,
20220909,261,273,동광주,동광양,467,6,2,1,8,30,514,649,7,12,1,2,14,685,
20220909,261,275,동광주,옥곡,202,2,0,0,1,5,210,169,5,0,1,0,3,178,
20220909,261,280,동광주,거창,121,4,10,1,1,3,140,116,4,10,0,1,5,136,
20220909,261,516,동광주,통영,340,1,2,0,0,7,350,296,0,5,1,0,9,311,
20220909,261,519,동광주,남대구,540,3,51,3,0,16,613,607,1,57,14,0,15,694,
20220909,261,527,동광주,포항,198,0,7,0,0,5,210,243,0,7,1,0,8,259,
20220909,261,558,동광주,구례화엄사,893,6,0,0,0,17,916,398,5,1,0,0,10,414,
20220909,261,559,동광주,서남원,186,0,2,0,0,7,195,154,3,1,1,0,11,170,
20220909,261,586,동광주,북남원,167,1,1,0,0,5,174,171,0,0,1,0,3,175,
20220909,261,587,동광주,오수,139,0,0,1,0,3,143,149,1,0,0,0,2,152,
20220909,261,588,동광주,임실,149,1,0,2,0,5,157,170,2,2,0,0,5,179,
20220909,262,261,창평,동광주,1986,31,6,10,2,73,2108,2243,45,9,7,2,67,2373,
20220909,262,263,창평,옥과,237,6,1,0,1,5,250,237,2,0,0,0,7,246,
20220909,262,265,창평,곡성,152,0,0,1,1,4,158,104,0,0,1,0,3,108,
20220909,262,271,창평,순천,163,4,2,0,0,0,169,255,1,0,2,1,5,264,
20220909,263,261,옥과,동광주,2656,6,42,1,5,80,2790,3464,5,44,4,3,109,3629,
20220909,263,262,옥과,창평,237,2,0,0,0,7,246,237,6,1,0,1,5,250,
20220909,263,265,옥과,곡성,139,2,0,0,1,5,147,105,3,0,0,1,8,117,
20220909,263,270,옥과,서순천,125,3,0,1,0,4,133,95,3,0,0,0,6,104,
20220909,263,271,옥과,순천,380,3,0,0,1,9,393,296,3,0,0,0,4,303,
20220909,263,569,옥과,북광주,702,1,3,2,0,19,727,1384,2,2,0,1,44,1433,
20220909,264,247,동남원,남원,572,2,5,0,1,18,598,532,2,7,0,0,16,557,
20220909,264,261,동남원,동광주,248,2,3,0,0,3,256,273,1,0,0,0,14,288,
20220909,265,261,곡성,동광주,1448,3,18,3,3,50,1525,2331,5,18,0,4,65,2423,
20220909,265,262,곡성,창평,104,0,0,1,0,3,108,152,0,0,1,1,4,158,
20220909,265,263,곡성,옥과,105,3,0,0,1,8,117,139,2,0,0,1,5,147,
20220909,265,266,곡성,석곡,292,2,0,1,0,11,306,107,1,0,0,0,5,113,
20220909,265,267,곡성,주암송광사,1095,1,3,1,2,25,1127,207,0,7,1,2,4,221,
20220909,265,270,곡성,서순천,143,0,1,0,0,4,148,121,1,0,0,0,3,125,
20220909,265,271,곡성,순천,261,2,0,0,0,5,268,228,3,1,0,0,6,238,
20220909,265,569,곡성,북광주,329,2,0,1,4,10,346,840,0,0,1,3,22,866,
20220909,266,261,석곡,동광주,501,1,1,1,1,23,528,906,5,1,0,0,33,945,
20220909,266,265,석곡,곡성,107,1,0,0,0,5,113,292,2,0,1,0,11,306,
20220909,266,271,석곡,순천,143,0,0,1,1,8,153,190,1,0,0,2,8,201,
20220909,266,569,석곡,북광주,152,0,0,1,1,3,157,381,2,0,1,0,11,395,
20220909,267,261,주암송광사,동광주,227,2,1,1,0,4,235,497,2,1,0,0,11,511,
20220909,267,265,주암송광사,곡성,207,0,7,1,2,4,221,1095,1,3,1,2,25,1127,
20220909,267,270,주암송광사,서순천,547,5,3,0,1,18,574,661,3,6,0,0,21,691,
20220909,267,271,주암송광사,순천,1011,6,7,7,10,29,1070,1249,9,5,9,10,43,1325,
20220909,267,272,주암송광사,광양,104,1,0,0,1,6,112,101,0,0,0,0,2,103,
20220909,267,273,주암송광사,동광양,139,0,0,0,1,3,143,254,1,0,1,0,11,267,
20220909,268,261,승주,동광주,133,0,0,0,1,4,138,237,0,0,0,1,6,244,
20220909,268,270,승주,서순천,265,1,2,0,0,10,278,348,1,2,0,0,5,356,
20220909,268,271,승주,순천,596,3,1,1,0,22,623,769,1,1,0,0,29,800,
20220909,269,247,지리산,남원,854,8,4,1,1,31,899,1138,7,5,2,0,39,1191,
20220909,269,261,지리산,동광주,126,2,0,0,0,4,132,204,0,1,0,0,7,212,
20220909,269,589,지리산,상관,93,1,1,3,0,4,102,106,1,3,1,0,3,114,
20220909,270,261,서순천,동광주,989,6,49,0,2,33,1079,1264,9,46,1,1,42,1363,
20220909,270,263,서순천,옥과,95,3,0,0,0,6,104,125,3,0,1,0,4,133,
20220909,270,265,서순천,곡성,121,1,0,0,0,3,125,143,0,1,0,0,4,148,
20220909,270,267,서순천,주암송광사,661,3,6,0,0,21,691,547,5,3,0,1,18,574,
20220909,270,268,서순천,승주,348,1,2,0,0,5,356,265,1,2,0,0,10,278,
20220909,270,271,서순천,순천,174,3,0,0,4,3,184,166,3,1,1,2,8,181,
20220909,270,273,서순천,동광양,107,0,0,0,1,1,109,132,0,0,0,0,6,138,
20220909,270,569,서순천,북광주,192,11,1,1,1,2,208,427,8,5,1,4,13,458,
20220909,271,145,순천,산인,173,0,2,0,0,4,179,234,0,2,0,1,6,243,
20220909,271,249,순천,담양,242,0,3,1,0,2,248,179,1,4,2,0,3,189,
20220909,271,261,순천,동광주,4248,51,75,3,33,99,4509,4718,44,71,7,18,133,4991,
20220909,271,262,순천,창평,255,1,0,2,1,5,264,163,4,2,0,0,0,169,
20220909,271,263,순천,옥과,296,3,0,0,0,4,303,380,3,0,0,1,9,393,
20220909,271,265,순천,곡성,228,3,1,0,0,6,238,261,2,0,0,0,5,268,
20220909,271,266,순천,석곡,190,1,0,0,2,8,201,143,0,0,1,1,8,153,
20220909,271,267,순천,주암송광사,1249,9,5,9,10,43,1325,1011,6,7,7,10,29,1070,
20220909,271,268,순천,승주,769,1,1,0,0,29,800,596,3,1,1,0,22,623,
20220909,271,270,순천,서순천,166,3,1,1,2,8,181,174,3,0,0,4,3,184,
20220909,271,273,순천,동광양,300,5,3,0,2,16,326,317,0,0,0,0,11,328,
20220909,271,275,순천,옥곡,242,1,1,0,1,8,253,160,0,1,0,0,7,168,
20220909,271,276,순천,진월,120,2,0,0,2,5,129,125,0,2,0,3,6,136,
20220909,271,277,순천,하동,159,2,0,0,0,3,164,122,1,0,0,0,4,127,
20220909,271,557,순천,황전,667,5,0,0,0,19,691,389,2,1,0,0,11,403,
20220909,271,558,순천,구례화엄사,173,2,1,0,0,1,177,186,3,1,0,0,1,191,
20220909,271,569,순천,북광주,842,32,18,1,34,18,945,1716,42,14,1,13,41,1827,
20220909,271,589,순천,상관,279,0,0,0,6,8,293,414,0,2,0,5,12,433,
20220909,272,145,광양,산인,778,4,22,5,2,35,846,2879,2,31,5,2,59,2978,
20220909,272,150,광양,북부산,348,0,1,0,1,9,359,677,0,0,0,0,15,692,
20220909,272,225,광양,서진주,152,5,0,0,3,3,163,175,3,1,3,4,2,188,
20220909,272,244,광양,서부산,460,2,13,2,6,9,492,979,4,10,3,2,32,1030,
20220909,272,261,광양,동광주,285,2,18,1,9,11,326,504,3,30,0,3,14,554,
20220909,272,267,광양,주암송광사,101,0,0,0,0,2,103,104,1,0,0,1,6,112,
20220909,272,273,광양,동광양,111,3,5,0,0,4,123,157,1,5,0,0,5,168,
20220909,272,275,광양,옥곡,237,0,3,0,0,7,247,227,2,0,0,2,9,240,
20220909,272,276,광양,진월,289,1,3,1,125,9,428,260,2,2,0,129,7,400,
20220909,272,277,광양,하동,454,1,3,1,3,16,478,434,2,3,0,0,15,454,
20220909,272,279,광양,곤양,189,1,5,1,1,5,202,363,4,3,1,3,8,382,
20220909,272,291,광양,사천,222,6,2,0,5,10,245,330,12,1,1,1,15,360,
20220909,272,292,광양,진주,221,2,0,0,4,6,233,308,4,5,0,4,10,331,
20220909,272,294,광양,북창원,115,0,1,0,2,6,124,497,2,1,3,1,14,518,
20220909,272,295,광양,진성,90,0,5,1,1,5,102,272,2,3,5,3,10,295,
20220909,272,515,광양,북통영,94,0,4,0,1,3,102,111,2,5,0,0,3,121,
20220909,272,516,광양,통영,353,1,6,1,0,8,369,664,0,8,1,0,28,701,
20220909,272,519,광양,남대구,111,0,3,0,0,6,120,198,0,6,0,0,4,208,
20220909,272,557,광양,황전,138,0,0,0,1,7,146,116,0,1,0,0,5,122,
20220909,272,589,광양,상관,83,0,0,0,44,4,131,217,1,1,2,57,4,282,
20220909,273,261,동광양,동광주,649,7,12,1,2,14,685,467,6,2,1,8,30,514,
20220909,273,267,동광양,주암송광사,254,1,0,1,0,11,267,139,0,0,0,1,3,143,
20220909,273,270,동광양,서순천,132,0,0,0,0,6,138,107,0,0,0,1,1,109,
20220909,273,271,동광양,순천,317,0,0,0,0,11,328,300,5,3,0,2,16,326,
20220909,273,272,동광양,광양,157,1,5,0,0,5,168,111,3,5,0,0,4,123,
20220909,273,557,동광양,황전,219,0,0,0,0,10,229,132,0,2,0,0,9,143,
20220909,273,569,동광양,북광주,127,5,0,2,4,4,142,151,4,0,1,10,2,168,
20220909,273,589,동광양,상관,213,0,0,1,12,5,231,127,0,0,5,41,7,180,
20220909,274,231,가조,화원옥포,103,0,0,0,0,3,106,134,0,0,1,0,1,136,
20220909,274,242,가조,고령,123,3,3,1,1,5,136,265,1,4,2,1,7,280,
20220909,274,280,가조,거창,463,7,11,0,0,27,508,487,7,8,1,0,27,530,
20220909,274,519,가조,남대구,350,1,0,0,0,7,358,500,2,0,0,0,18,520,
20220909,275,145,옥곡,산인,460,3,28,3,15,11,520,548,1,23,5,37,10,624,
20220909,275,150,옥곡,북부산,194,0,0,0,8,4,206,99,0,0,1,4,4,108,
20220909,275,244,옥곡,서부산,285,2,11,0,34,12,344,157,1,10,2,28,4,202,
20220909,275,261,옥곡,동광주,169,5,0,1,0,3,178,202,2,0,0,1,5,210,
20220909,275,271,옥곡,순천,160,0,1,0,0,7,168,242,1,1,0,1,8,253,
20220909,275,272,옥곡,광양,227,2,0,0,2,9,240,237,0,3,0,0,7,247,
20220909,275,277,옥곡,하동,345,3,1,0,5,12,366,250,0,0,0,4,12,266,
20220909,275,279,옥곡,곤양,153,4,1,2,6,6,172,134,3,2,2,4,8,153,
20220909,275,291,옥곡,사천,169,12,2,0,8,8,199,110,12,0,2,5,7,136,
20220909,275,292,옥곡,진주,192,2,3,2,17,5,221,110,1,0,1,13,3,128,
20220909,275,516,옥곡,통영,208,0,6,1,3,14,232,160,0,0,0,4,8,172,
20220909,276,271,진월,순천,125,0,2,0,3,6,136,120,2,0,0,2,5,129,
20220909,276,272,진월,광양,260,2,2,0,129,7,400,289,1,3,1,125,9,428,
20220909,277,145,하동,산인,396,3,1,3,7,15,425,1299,3,1,3,0,41,1347,
20220909,277,150,하동,북부산,133,0,0,0,2,6,141,262,0,0,0,1,11,274,
20220909,277,225,하동,서진주,109,1,0,0,12,9,131,110,1,0,1,11,6,129,
20220909,277,244,하동,서부산,177,0,1,2,6,7,193,331,0,3,0,7,16,357,
20220909,277,271,하동,순천,122,1,0,0,0,4,127,159,2,0,0,0,3,164,
20220909,277,272,하동,광양,434,2,3,0,0,15,454,454,1,3,1,3,16,478,
20220909,277,275,하동,옥곡,250,0,0,0,4,12,266,345,3,1,0,5,12,366,
20220909,277,278,하동,진교,169,2,13,0,0,5,189,179,6,12,0,2,4,203,
20220909,277,279,하동,곤양,135,0,4,1,3,7,150,215,0,6,1,5,8,235,
20220909,277,291,하동,사천,222,4,0,0,3,10,239,255,6,1,1,3,5,271,
20220909,277,292,하동,진주,305,2,1,0,15,9,332,354,1,0,0,15,16,386,
20220909,277,516,하동,통영,118,0,0,0,1,9,128,217,0,0,0,1,12,230,
20220909,278,145,진교,산인,421,3,19,0,0,11,454,1985,3,15,1,0,51,2055,
20220909,278,150,진교,북부산,122,0,1,0,0,6,129,318,0,0,0,0,12,330,
20220909,278,225,진교,서진주,255,1,1,0,1,16,274,297,0,1,1,0,9,308,
20220909,278,244,진교,서부산,174,0,8,1,0,9,192,471,0,7,0,0,16,494,
20220909,278,277,진교,하동,179,6,12,0,2,4,203,169,2,13,0,0,5,189,
20220909,278,291,진교,사천,327,5,3,0,1,18,354,461,3,1,0,0,21,486,
20220909,278,292,진교,진주,705,1,30,1,1,27,765,831,2,23,1,1,34,892,
20220909,279,145,곤양,산인,143,0,8,0,0,3,154,420,1,8,0,0,10,439,
20220909,279,225,곤양,서진주,134,0,1,0,0,4,139,98,0,0,0,0,2,100,
20220909,279,272,곤양,광양,363,4,3,1,3,8,382,189,1,5,1,1,5,202,
20220909,279,275,곤양,옥곡,134,3,2,2,4,8,153,153,4,1,2,6,6,172,
20220909,279,277,곤양,하동,215,0,6,1,5,8,235,135,0,4,1,3,7,150,
20220909,279,291,곤양,사천,256,2,0,2,1,20,281,203,3,2,1,0,10,219,
20220909,279,292,곤양,진주,483,2,13,1,0,17,516,426,2,10,0,0,19,457,
20220909,280,150,거창,북부산,98,3,3,0,0,5,109,171,0,2,0,0,3,176,
20220909,280,224,거창,함양,209,4,23,0,0,11,247,205,3,31,1,0,4,244,
20220909,280,231,거창,화원옥포,168,2,3,0,1,9,183,285,1,4,0,0,16,306,
20220909,280,233,거창,현풍,135,1,2,3,0,6,147,138,2,2,3,0,9,154,
20220909,280,239,거창,칠원,212,2,4,1,0,14,233,625,6,1,1,1,24,658,
20220909,280,242,거창,고령,154,2,15,0,0,12,183,455,7,21,2,0,21,506,
20220909,280,243,거창,해인사,118,1,0,0,0,11,130,159,2,1,0,0,10,172,
20220909,280,244,거창,서부산,126,1,2,0,0,6,135,188,1,3,0,0,7,199,
20220909,280,261,거창,동광주,116,4,10,0,1,5,136,121,4,10,1,1,3,140,
20220909,280,274,거창,가조,487,7,8,1,0,27,530,463,7,11,0,0,27,508,
20220909,280,519,거창,남대구,870,8,35,2,1,39,955,1466,11,32,2,2,69,1582,
20220909,281,102,매송,동수원,325,2,0,0,0,16,343,294,0,0,0,0,5,299,
20220909,281,253,매송,서서울,3382,13,3,3,2,195,3598,4319,10,6,2,5,204,4546,
20220909,281,254,매송,군자,737,3,4,2,2,33,781,1023,6,4,2,3,46,1084,
20220909,281,282,매송,비봉,442,7,3,1,2,14,469,234,9,4,4,1,12,264,
20220909,281,283,매송,발안,463,5,3,0,3,21,495,348,10,1,0,2,20,381,
20220909,281,285,매송,서평택,137,1,2,0,0,2,142,101,6,3,1,0,5,116,
20220909,281,287,매송,송악,100,0,9,0,3,10,122,221,2,11,0,9,9,252,
20220909,281,288,매송,당진,113,0,1,1,0,5,120,139,0,0,1,0,10,150,
20220909,281,298,매송,서산,192,1,0,0,1,7,201,215,0,0,0,0,5,220,
20220909,281,520,매송,평택,313,1,0,1,1,19,335,152,1,2,1,1,9,166,
20220909,282,253,비봉,서서울,4154,61,46,26,33,245,4565,6647,37,29,13,51,268,7045,
20220909,282,254,비봉,군자,823,20,4,10,6,30,893,1355,19,10,13,13,73,1483,
20220909,282,255,비봉,서안산,96,2,4,1,0,8,111,192,2,0,1,0,8,203,
20220909,282,257,비봉,홍성,148,0,1,0,0,4,153,115,1,1,0,0,2,119,
20220909,282,281,비봉,매송,234,9,4,4,1,12,264,442,7,3,1,2,14,469,
20220909,282,283,비봉,발안,1190,2,1,2,7,45,1247,123,1,1,2,4,2,133,
20220909,282,287,비봉,송악,166,1,6,0,2,6,181,315,2,6,0,9,14,346,
20220909,282,288,비봉,당진,157,0,1,1,0,7,166,237,0,1,0,0,9,247,
20220909,282,298,비봉,서산,358,1,0,0,1,14,374,362,0,0,1,6,10,379,
20220909,283,253,발안,서서울,4309,52,16,20,19,229,4645,6482,32,16,17,13,252,6812,
20220909,283,254,발안,군자,998,4,8,3,6,50,1069,1380,8,8,4,5,62,1467,
20220909,283,255,발안,서안산,178,4,2,2,0,13,199,272,2,0,0,1,16,291,
20220909,283,281,발안,매송,348,10,1,0,2,20,381,463,5,3,0,3,21,495,
20220909,283,282,발안,비봉,123,1,1,2,4,2,133,1190,2,1,2,7,45,1247,
20220909,283,285,발안,서평택,141,7,1,2,0,11,162,111,1,4,2,0,10,128,
20220909,283,287,발안,송악,170,1,0,0,3,6,180,200,1,0,2,6,13,222,
20220909,283,288,발안,당진,174,2,0,0,0,1,177,110,0,1,0,1,2,114,
20220909,283,298,발안,서산,364,0,0,0,0,15,379,149,1,0,1,0,8,159,
20220909,284,174,남양양,춘천,95,0,0,1,0,7,103,204,1,0,0,0,13,218,
20220909,284,189,남양양,강릉,200,4,0,1,0,11,216,208,4,1,1,0,13,227,
20220909,284,510,남양양,양양,192,3,0,0,0,7,202,119,2,0,0,0,4,125,
20220909,284,585,남양양,하조대,328,4,4,1,1,15,353,357,3,2,0,0,18,380,
20220909,284,701,남양양,북양양,236,5,0,1,0,10,252,227,0,0,0,1,5,233,
20220909,284,702,남양양,속초,320,4,1,0,0,16,341,331,5,0,2,0,12,350,
20220909,285,253,서평택,서서울,1016,7,12,24,75,68,1202,1349,3,12,10,22,53,1449,
20220909,285,254,서평택,군자,85,2,0,1,6,8,102,129,0,1,0,5,5,140,
20220909,285,281,서평택,매송,101,6,3,1,0,5,116,137,1,2,0,0,2,142,
20220909,285,283,서평택,발안,111,1,4,2,0,10,128,141,7,1,2,0,11,162,
20220909,285,287,서평택,송악,1001,8,9,3,114,48,1183,377,10,12,2,141,17,559,
20220909,285,288,서평택,당진,1076,9,6,6,6,39,1142,139,1,2,2,5,7,156,
20220909,285,298,서평택,서산,2628,2,9,4,14,94,2751,202,2,9,4,4,2,223,
20220909,285,520,서평택,평택,153,5,5,5,17,13,198,251,2,1,2,14,10,280,
20220909,286,138,통도사휴게소,양산,368,5,1,0,0,14,388,273,7,0,0,0,22,302,
20220909,286,140,통도사휴게소,부산,1322,4,4,0,0,44,1374,1378,2,2,0,0,44,1426,
20220909,286,250,통도사휴게소,남양산,320,3,0,0,0,14,337,359,3,0,0,0,20,382,
20220909,286,252,통도사휴게소,대동,589,1,0,0,0,13,603,619,6,2,0,0,16,643,
20220909,286,529,통도사휴게소,노포,142,0,24,0,0,3,169,114,0,24,0,0,5,143,
20220909,287,253,송악,서서울,2074,4,8,6,54,96,2242,1352,3,2,5,28,51,1441,
20220909,287,254,송악,군자,235,1,1,0,8,6,251,148,2,1,0,3,5,159,
20220909,287,281,송악,매송,221,2,11,0,9,9,252,100,0,9,0,3,10,122,
20220909,287,282,송악,비봉,315,2,6,0,9,14,346,166,1,6,0,2,6,181,
20220909,287,283,송악,발안,200,1,0,2,6,13,222,170,1,0,0,3,6,180,
20220909,287,285,송악,서평택,377,10,12,2,141,17,559,1001,8,9,3,114,48,1183,
20220909,287,288,송악,당진,458,1,5,1,1,25,491,501,9,10,3,4,21,548,
20220909,287,298,송악,서산,644,2,5,0,9,19,679,216,6,0,1,3,7,233,
20220909,287,520,송악,평택,454,2,3,1,32,25,517,297,3,1,0,16,12,329,
20220909,287,540,송악,청북,71,4,6,7,21,2,111,204,0,4,2,11,5,226,
20220909,287,732,송악,행담도,219,4,4,0,2,19,248,195,2,4,0,2,17,220,
20220909,288,253,당진,서서울,1891,2,27,2,1,82,2005,1739,1,15,2,5,67,1829,
20220909,288,254,당진,군자,195,0,6,0,0,8,209,156,2,2,0,0,4,164,
20220909,288,257,당진,홍성,1253,2,6,0,0,26,1287,164,2,0,0,1,3,170,
20220909,288,259,당진,대천,603,2,5,0,0,13,623,124,1,5,0,2,4,136,
20220909,288,281,당진,매송,139,0,0,1,0,10,150,113,0,1,1,0,5,120,
20220909,288,282,당진,비봉,237,0,1,0,0,9,247,157,0,1,1,0,7,166,
20220909,288,283,당진,발안,110,0,1,0,1,2,114,174,2,0,0,0,1,177,
20220909,288,285,당진,서평택,139,1,2,2,5,7,156,1076,9,6,6,6,39,1142,
20220909,288,287,당진,송악,501,9,10,3,4,21,548,458,1,5,1,1,25,491,
20220909,288,298,당진,서산,2499,12,17,6,7,75,2616,392,4,2,5,3,13,419,
20220909,288,520,당진,평택,310,4,32,0,3,15,364,261,1,20,0,0,15,297,
20220909,288,732,당진,행담도,113,1,1,0,0,3,118,92,4,1,0,0,3,100,
20220909,289,135,마산,경주,377,0,4,0,0,12,393,248,2,6,2,3,8,269,
20220909,289,138,마산,양산,115,7,2,0,2,6,132,170,9,3,3,0,5,190,
20220909,289,139,마산,서울산,113,1,1,1,0,3,119,227,0,0,0,1,9,237,
20220909,289,140,마산,부산,751,6,5,1,0,19,782,1653,5,2,2,3,29,1694,
20220909,289,146,마산,동창원,1956,19,10,4,3,138,2130,2564,17,14,2,12,162,2771,
20220909,289,147,마산,진례,506,19,12,12,2,30,581,422,22,18,10,0,33,505,
20220909,289,148,마산,서김해,1215,5,39,2,2,63,1326,1601,8,37,3,0,64,1713,
20220909,289,149,마산,동김해,640,9,10,10,4,33,706,888,7,9,9,2,41,956,
20220909,289,150,마산,북부산,3202,11,53,0,6,125,3397,5223,8,50,0,2,145,5428,
20220909,289,244,마산,서부산,3614,13,248,3,7,146,4031,6099,18,265,7,19,181,6589,
20220909,289,245,마산,장유,1169,13,25,21,2,57,1287,1689,11,24,10,1,61,1796,
20220909,289,250,마산,남양산,487,13,23,1,0,15,539,787,11,23,3,1,35,860,
20220909,289,251,마산,물금,364,17,3,0,1,14,399,819,14,0,5,3,24,865,
20220909,289,641,마산,울산,346,1,22,1,2,14,386,1238,3,18,6,2,36,1303,
20220909,289,752,마산,기장철마,248,1,2,0,3,10,264,526,2,1,1,1,26,557,
20220909,289,753,마산,금정,271,1,9,0,1,8,290,388,0,6,0,1,10,405,
20220909,289,755,마산,광재,258,8,11,9,0,9,295,333,13,8,7,1,10,372,
20220909,289,757,마산,진영,404,6,9,2,8,26,455,649,13,7,2,3,26,700,
20220909,290,291,축동,사천,138,0,0,1,2,6,147,234,2,1,0,0,6,243,
20220909,290,292,축동,진주,224,1,0,1,0,15,241,221,1,2,1,0,15,240,
20220909,291,101,사천,서울,100,0,13,0,0,1,114,295,3,22,0,0,2,322,
20220909,291,140,사천,부산,109,3,0,0,0,3,115,136,1,0,0,0,2,139,
20220909,291,142,사천,군북,136,8,1,2,0,4,151,144,5,0,2,0,6,157,
20220909,291,144,사천,함안,124,3,2,0,3,6,138,351,3,2,2,3,9,370,
20220909,291,145,사천,산인,1721,31,33,4,2,63,1854,4277,27,37,3,3,121,4468,
20220909,291,148,사천,서김해,102,1,1,1,1,10,116,150,0,1,0,0,6,157,
20220909,291,150,사천,북부산,472,3,0,0,0,12,487,589,1,0,0,0,30,620,
20220909,291,190,사천,동서울,119,0,1,1,0,4,125,318,0,0,0,0,8,326,
20220909,291,222,사천,산청,122,0,0,5,1,5,133,93,0,0,6,1,4,104,
20220909,291,223,사천,단성,457,2,2,1,0,12,474,377,3,1,1,0,13,395,
20220909,291,225,사천,서진주,953,6,9,2,7,63,1040,1078,12,5,2,5,58,1160,
20220909,291,244,사천,서부산,516,3,13,2,2,34,570,838,2,6,1,3,30,880,
20220909,291,245,사천,장유,114,0,0,0,0,7,121,138,0,0,0,0,4,142,
20220909,291,272,사천,광양,330,12,1,1,1,15,360,222,6,2,0,5,10,245,
20220909,291,275,사천,옥곡,110,12,0,2,5,7,136,169,12,2,0,8,8,199,
20220909,291,277,사천,하동,255,6,1,1,3,5,271,222,4,0,0,3,10,239,
20220909,291,278,사천,진교,461,3,1,0,0,21,486,327,5,3,0,1,18,354,
20220909,291,279,사천,곤양,203,3,2,1,0,10,219,256,2,0,2,1,20,281,
20220909,291,290,사천,축동,234,2,1,0,0,6,243,138,0,0,1,2,6,147,
20220909,291,292,사천,진주,2168,19,19,3,1,116,2326,3246,36,20,7,5,175,3489,
20220909,291,293,사천,문산,459,3,3,0,1,27,493,832,7,3,1,3,51,897,
20220909,291,294,사천,북창원,202,2,2,0,1,12,219,715,3,1,1,3,32,755,
20220909,291,295,사천,진성,117,0,3,1,2,4,127,286,1,2,0,2,8,299,
20220909,291,515,사천,북통영,117,8,1,0,0,9,135,148,11,0,0,0,11,170,
20220909,291,516,사천,통영,442,29,5,0,1,29,506,557,15,8,1,0,32,613,
20220909,291,519,사천,남대구,249,1,6,1,0,8,265,351,2,7,1,0,13,374,
20220909,292,101,진주,서울,64,0,64,0,0,2,130,115,0,100,0,0,3,218,
20220909,292,142,진주,군북,135,1,2,0,0,13,151,143,2,2,0,0,13,160,
20220909,292,144,진주,함안,169,2,0,0,0,10,181,276,6,0,0,2,5,289,
20220909,292,145,진주,산인,1492,11,137,3,5,73,1721,2229,16,130,3,9,87,2474,
20220909,292,150,진주,북부산,328,2,8,1,2,11,352,241,0,8,0,0,7,256,
20220909,292,223,진주,단성,200,2,0,0,0,4,206,120,4,1,0,1,5,131,
20220909,292,244,진주,서부산,378,3,19,4,3,16,423,323,2,18,1,5,14,363,
20220909,292,272,진주,광양,308,4,5,0,4,10,331,221,2,0,0,4,6,233,
20220909,292,275,진주,옥곡,110,1,0,1,13,3,128,192,2,3,2,17,5,221,
20220909,292,277,진주,하동,354,1,0,0,15,16,386,305,2,1,0,15,9,332,
20220909,292,278,진주,진교,831,2,23,1,1,34,892,705,1,30,1,1,27,765,
20220909,292,279,진주,곤양,426,2,10,0,0,19,457,483,2,13,1,0,17,516,
20220909,292,290,진주,축동,221,1,2,1,0,15,240,224,1,0,1,0,15,241,
20220909,292,291,진주,사천,3246,36,20,7,5,175,3489,2168,19,19,3,1,116,2326,
20220909,292,293,진주,문산,100,0,0,0,0,5,105,92,1,1,0,2,7,103,
20220909,292,294,진주,북창원,172,1,1,0,0,7,181,351,3,1,0,6,20,381,
20220909,292,295,진주,진성,165,2,0,0,3,6,176,98,1,2,0,2,4,107,
20220909,292,296,진주,지수,194,2,0,0,0,9,205,159,1,0,0,0,8,168,
20220909,292,513,진주,고성,416,4,21,0,2,23,466,391,5,21,1,2,23,443,
20220909,292,515,진주,북통영,398,2,3,1,0,20,424,423,4,7,1,0,16,451,
20220909,292,516,진주,통영,843,8,14,0,0,49,914,1122,14,13,1,0,67,1217,
20220909,293,142,문산,군북,158,2,0,0,0,9,169,147,3,0,0,0,11,161,
20220909,293,144,문산,함안,156,0,0,0,0,9,165,222,2,2,1,0,9,236,
20220909,293,145,문산,산인,1156,10,9,5,0,42,1222,1724,12,14,4,3,67,1824,
20220909,293,150,문산,북부산,222,1,0,0,0,10,233,211,1,0,1,0,14,227,
20220909,293,244,문산,서부산,266,1,1,0,1,15,284,280,0,2,1,1,15,299,
20220909,293,291,문산,사천,832,7,3,1,3,51,897,459,3,3,0,1,27,493,
20220909,293,292,문산,진주,92,1,1,0,2,7,103,100,0,0,0,0,5,105,
20220909,293,294,문산,북창원,141,1,1,0,0,4,147,306,3,1,0,0,7,317,
20220909,293,296,문산,지수,172,1,0,0,0,9,182,166,0,1,0,0,10,177,
20220909,293,516,문산,통영,160,0,0,0,0,5,165,105,1,1,0,0,4,111,
20220909,294,142,북창원,군북,684,2,1,1,0,19,707,191,3,0,0,1,7,202,
20220909,294,144,북창원,함안,251,5,1,1,0,17,275,172,1,2,1,0,7,183,
20220909,294,146,북창원,동창원,157,2,0,0,0,9,168,85,5,0,2,1,8,101,
20220909,294,148,북창원,서김해,150,2,0,0,1,9,162,110,0,1,0,0,12,123,
20220909,294,150,북창원,북부산,336,0,1,0,0,15,352,201,0,0,0,0,14,215,
20220909,294,244,북창원,서부산,430,2,1,1,1,22,457,295,0,1,0,0,13,309,
20220909,294,245,북창원,장유,229,3,0,0,1,19,252,146,0,0,0,0,15,161,
20220909,294,272,북창원,광양,497,2,1,3,1,14,518,115,0,1,0,2,6,124,
20220909,294,291,북창원,사천,715,3,1,1,3,32,755,202,2,2,0,1,12,219,
20220909,294,292,북창원,진주,351,3,1,0,6,20,381,172,1,1,0,0,7,181,
20220909,294,293,북창원,문산,306,3,1,0,0,7,317,141,1,1,0,0,4,147,
20220909,295,144,진성,함안,127,0,6,1,0,9,143,238,1,6,1,0,11,257,
20220909,295,145,진성,산인,784,7,5,4,1,22,823,1639,8,3,2,2,54,1708,
20220909,295,150,진성,북부산,144,1,0,0,0,6,151,189,0,0,0,0,9,198,
20220909,295,244,진성,서부산,153,0,1,0,1,2,157,184,1,0,0,0,4,189,
20220909,295,272,진성,광양,272,2,3,5,3,10,295,90,0,5,1,1,5,102,
20220909,295,291,진성,사천,286,1,2,0,2,8,299,117,0,3,1,2,4,127,
20220909,295,292,진성,진주,98,1,2,0,2,4,107,165,2,0,0,3,6,176,
20220909,295,296,진성,지수,103,0,1,0,0,3,107,113,1,0,0,0,3,117,
20220909,296,145,지수,산인,127,4,0,1,0,4,136,329,7,1,0,0,14,351,
20220909,296,292,지수,진주,159,1,0,0,0,8,168,194,2,0,0,0,9,205,
20220909,296,293,지수,문산,166,0,1,0,0,10,177,172,1,0,0,0,9,182,
20220909,296,295,지수,진성,113,1,0,0,0,3,117,103,0,1,0,0,3,107,
20220909,297,113,동충주,신탄진,108,0,0,0,3,1,112,196,0,0,2,2,3,203,
20220909,297,128,동충주,금왕꽃동네,719,3,12,2,6,27,769,1590,1,5,3,11,39,1649,
20220909,297,136,동충주,음성,361,2,2,1,3,17,386,803,4,8,7,6,24,852,
20220909,297,167,동충주,광주,101,0,1,0,0,4,106,114,2,1,1,0,1,119,
20220909,297,198,동충주,서청주,185,1,5,0,0,2,193,445,0,7,1,4,17,474,
20220909,297,199,동충주,오창,252,1,0,0,1,5,259,329,0,1,3,1,6,340,
20220909,297,211,동충주,풍기,1113,1,4,0,5,24,1147,139,0,1,1,3,6,150,
20220909,297,522,동충주,북단양,433,4,2,0,8,11,458,224,1,0,0,11,6,242,
20220909,297,523,동충주,남제천,583,7,3,1,3,17,614,297,4,2,1,4,13,321,
20220909,297,542,동충주,서안성,110,2,2,2,4,4,124,232,2,0,4,7,3,248,
20220909,297,543,동충주,남안성,583,2,4,7,26,26,648,486,2,2,1,21,20,532,
20220909,297,555,동충주,북진천,352,0,2,2,4,11,371,247,0,1,0,6,7,261,
20220909,297,561,동충주,북충주,117,2,1,2,2,7,131,133,2,0,1,1,5,142,
20220909,298,115,서산,대전,175,1,20,0,0,10,206,264,0,22,0,0,12,298,
20220909,298,151,서산,북대전,187,1,1,1,7,12,209,203,0,1,0,5,9,218,
20220909,298,152,서산,유성,277,2,0,1,4,9,293,388,2,1,0,0,13,404,
20220909,298,228,서산,동군산,167,0,0,0,12,4,183,91,1,0,0,7,4,103,
20220909,298,253,서산,서서울,3128,13,7,6,1,128,3283,2963,4,3,8,0,104,3082,
20220909,298,254,서산,군자,279,2,10,1,3,16,311,320,0,3,0,3,14,340,
20220909,298,257,서산,홍성,447,3,1,4,8,15,478,184,1,4,1,9,7,206,
20220909,298,258,서산,광천,200,3,1,3,4,5,216,119,3,0,3,4,5,134,
20220909,298,259,서산,대천,294,1,4,3,4,14,320,167,1,2,3,3,8,184,
20220909,298,281,서산,매송,215,0,0,0,0,5,220,192,1,0,0,1,7,201,
20220909,298,282,서산,비봉,362,0,0,1,6,10,379,358,1,0,0,1,14,374,
20220909,298,283,서산,발안,149,1,0,1,0,8,159,364,0,0,0,0,15,379,
20220909,298,285,서산,서평택,202,2,9,4,4,2,223,2628,2,9,4,14,94,2751,
20220909,298,287,서산,송악,216,6,0,1,3,7,233,644,2,5,0,9,19,679,
20220909,298,288,서산,당진,392,4,2,5,3,13,419,2499,12,17,6,7,75,2616,
20220909,298,299,서산,해미,529,7,3,0,9,23,571,223,3,3,3,34,11,277,
20220909,298,520,서산,평택,623,7,59,0,1,20,710,805,7,26,1,0,37,876,
20220909,298,571,서산,면천,242,4,4,1,1,6,258,699,2,13,0,1,19,734,
20220909,298,573,서산,예산수덕사,146,2,1,0,26,7,182,94,1,0,1,2,4,102,
20220909,298,577,서산,공주,188,4,0,0,1,10,203,278,0,1,0,1,9,289,
20220909,298,578,서산,서세종,380,4,2,0,5,14,405,527,4,0,1,0,16,548,
20220909,298,579,서산,남세종,304,1,2,1,1,10,319,357,3,0,0,0,15,375,
20220909,299,227,해미,군산,182,1,1,1,0,6,191,105,0,2,1,0,2,110,
20220909,299,228,해미,동군산,131,0,1,1,6,4,143,179,1,1,2,2,1,186,
20220909,299,234,해미,서천,190,0,0,0,1,5,196,121,0,1,1,3,2,128,
20220909,299,253,해미,서서울,331,0,0,4,1,13,349,408,0,0,1,0,12,421,
20220909,299,257,해미,홍성,293,3,2,0,1,8,307,98,2,0,1,0,2,103,
20220909,299,258,해미,광천,173,0,0,2,0,6,181,128,0,0,0,0,3,131,
20220909,299,259,해미,대천,123,4,3,0,0,5,135,178,4,7,1,1,3,194,
20220909,299,298,해미,서산,223,3,3,3,34,11,277,529,7,3,0,9,23,571,
20220909,500,173,남여주,양지,125,7,11,13,7,6,169,94,3,9,3,6,7,122,
20220909,500,176,남여주,이천,173,1,7,3,1,9,194,149,3,3,2,1,9,167,
20220909,500,190,남여주,동서울,338,3,0,1,0,16,358,182,2,6,1,1,9,201,
20220909,500,517,남여주,양평,365,0,2,2,34,13,416,900,2,2,5,54,15,978,
20220909,500,597,남여주,서여주,207,0,0,0,0,9,216,504,1,0,0,1,15,521,
20220909,500,598,남여주,북여주,428,3,8,1,1,14,455,362,0,2,2,0,15,381,
20220909,500,735,남여주,남양평,198,0,0,0,0,6,204,485,0,0,0,0,9,494,
20220909,501,167,서김제,광주,155,1,0,1,0,4,161,139,0,0,4,0,3,146,
20220909,501,504,서김제,선운산,169,0,1,1,0,3,174,103,0,2,1,4,4,114,
20220909,501,505,서김제,고창,182,0,1,3,0,1,187,102,0,6,4,0,6,118,
20220909,501,509,서김제,목포,858,0,3,3,0,13,877,227,1,3,5,0,4,240,
20220909,502,167,부안,광주,407,2,2,1,0,12,424,594,7,3,3,0,12,619,
20220909,502,228,부안,동군산,192,2,3,0,2,12,211,296,3,3,2,0,9,313,
20220909,502,253,부안,서서울,250,2,1,1,1,5,260,719,0,0,0,0,24,743,
20220909,502,503,부안,줄포,246,1,2,4,3,5,261,94,2,2,2,1,1,102,
20220909,502,504,부안,선운산,251,1,3,1,0,7,263,154,1,5,0,0,0,160,
20220909,502,505,부안,고창,350,0,3,3,0,8,364,128,3,3,4,1,4,143,
20220909,502,509,부안,목포,907,0,6,7,4,19,943,223,0,5,5,7,5,245,
20220909,503,167,줄포,광주,323,3,2,0,1,6,335,592,2,0,0,1,11,606,
20220909,503,502,줄포,부안,94,2,2,2,1,1,102,246,1,2,4,3,5,261,
20220909,503,509,줄포,목포,690,1,6,1,0,14,712,155,1,2,0,0,5,163,
20220909,504,167,선운산,광주,250,4,0,1,5,7,267,372,1,0,0,6,8,387,
20220909,504,228,선운산,동군산,175,0,7,2,3,7,194,163,1,1,0,0,3,168,
20220909,504,501,선운산,서김제,103,0,2,1,4,4,114,169,0,1,1,0,3,174,
20220909,504,502,선운산,부안,154,1,5,0,0,0,160,251,1,3,1,0,7,263,
20220909,504,505,선운산,고창,126,0,1,1,0,4,132,134,0,0,1,0,9,144,
20220909,504,506,선운산,영광,415,1,4,7,2,13,442,238,2,3,6,0,4,253,
20220909,504,509,선운산,목포,613,2,6,19,1,18,659,822,4,16,10,9,25,886,
20220909,505,167,고창,광주,424,5,1,2,1,13,446,594,6,1,2,1,21,625,
20220909,505,228,고창,동군산,196,3,5,0,0,8,212,160,1,2,0,1,6,170,
20220909,505,501,고창,서김제,102,0,6,4,0,6,118,182,0,1,3,0,1,187,
20220909,505,502,고창,부안,128,3,3,4,1,4,143,350,0,3,3,0,8,364,
20220909,505,504,고창,선운산,134,0,0,1,0,9,144,126,0,1,1,0,4,132,
20220909,505,506,고창,영광,246,0,6,1,0,6,259,126,2,1,0,0,0,129,
20220909,505,509,고창,목포,344,1,6,0,0,9,360,194,2,7,0,0,4,207,
20220909,505,569,고창,북광주,103,1,1,2,0,0,107,148,2,0,1,0,2,153,
20220909,506,228,영광,동군산,134,0,5,9,0,1,149,180,0,4,2,0,6,192,
20220909,506,253,영광,서서울,151,0,0,0,0,4,155,627,0,0,0,0,16,643,
20220909,506,504,영광,선운산,238,2,3,6,0,4,253,415,1,4,7,2,13,442,
20220909,506,505,영광,고창,126,2,1,0,0,0,129,246,0,6,1,0,6,259,
20220909,506,509,영광,목포,150,2,1,0,2,4,159,369,4,3,1,3,9,389,
20220909,506,569,영광,북광주,129,2,0,1,0,5,137,142,1,0,0,0,2,145,
20220909,507,508,함평,무안,188,3,0,5,1,2,199,134,3,0,0,0,3,140,
20220909,507,509,함평,목포,317,0,9,3,4,9,342,972,2,5,8,2,24,1013,
20220909,508,507,무안,함평,134,3,0,0,0,3,140,188,3,0,5,1,2,199,
20220909,508,509,무안,목포,749,11,5,4,3,22,794,1821,20,17,6,22,51,1937,
20220909,508,553,무안,동광산,1511,6,15,5,1,41,1579,4831,29,57,14,17,134,5082,
20220909,509,228,목포,동군산,454,4,5,8,11,20,502,600,2,2,4,6,10,624,
20220909,509,253,목포,서서울,848,0,18,3,1,14,884,2560,1,1,2,0,40,2604,
20220909,509,501,목포,서김제,227,1,3,5,0,4,240,858,0,3,3,0,13,877,
20220909,509,502,목포,부안,223,0,5,5,7,5,245,907,0,6,7,4,19,943,
20220909,509,503,목포,줄포,155,1,2,0,0,5,163,690,1,6,1,0,14,712,
20220909,509,504,목포,선운산,822,4,16,10,9,25,886,613,2,6,19,1,18,659,
20220909,509,505,목포,고창,194,2,7,0,0,4,207,344,1,6,0,0,9,360,
20220909,509,506,목포,영광,369,4,3,1,3,9,389,150,2,1,0,2,4,159,
20220909,509,507,목포,함평,972,2,5,8,2,24,1013,317,0,9,3,4,9,342,
20220909,509,508,목포,무안,1821,20,17,6,22,51,1937,749,11,5,4,3,22,794,
20220909,509,548,목포,북무안,764,4,5,6,5,24,808,231,0,3,2,1,6,243,
20220909,509,549,목포,동함평,348,4,2,2,3,9,368,160,4,2,1,0,2,169,
20220909,509,552,목포,서광산,392,11,6,5,4,7,425,260,9,7,1,1,8,286,
20220909,509,553,목포,동광산,8966,70,131,25,47,253,9492,7626,47,93,32,13,205,8016,
20220909,509,578,목포,서세종,147,1,1,0,0,5,154,216,0,0,2,0,10,228,
20220909,509,613,목포,남풍세,105,0,2,0,5,3,115,573,0,3,0,0,13,589,
20220909,510,174,양양,춘천,236,0,5,0,0,6,247,507,2,7,0,0,17,533,
20220909,510,189,양양,강릉,139,2,3,0,1,9,154,187,3,1,1,1,10,203,
20220909,510,284,양양,남양양,119,2,0,0,0,4,125,192,3,0,0,0,7,202,
20220909,510,554,양양,동홍천,329,3,7,0,0,13,352,1223,3,15,4,0,29,1274,
20220909,510,580,양양,북강릉,150,3,0,1,0,9,163,247,3,2,1,0,8,261,
20220909,510,701,양양,북양양,300,2,7,0,0,11,320,215,2,0,0,0,11,228,
20220909,510,702,양양,속초,523,3,1,0,0,17,544,424,2,0,0,0,11,437,
20220909,510,766,양양,인제,150,1,0,0,1,8,160,187,2,0,0,0,12,201,
20220909,511,227,무창포,군산,482,1,3,3,2,9,500,306,2,2,5,1,4,320,
20220909,511,228,무창포,동군산,285,7,16,0,1,12,321,645,9,43,2,9,22,730,
20220909,511,234,무창포,서천,657,10,25,7,13,14,726,426,5,12,3,8,15,469,
20220909,511,253,무창포,서서울,206,0,3,0,0,5,214,335,1,1,0,0,12,349,
20220909,511,260,무창포,춘장대,167,2,2,1,0,5,177,170,2,6,1,1,10,190,
20220909,512,513,연화산,고성,153,1,0,0,0,16,170,178,1,0,0,0,11,190,
20220909,512,516,연화산,통영,161,3,1,0,0,18,183,266,3,0,0,0,17,286,
20220909,513,225,고성,서진주,176,5,0,1,1,16,199,216,2,0,0,0,14,232,
20220909,513,292,고성,진주,391,5,21,1,2,23,443,416,4,21,0,2,23,466,
20220909,513,512,고성,연화산,178,1,0,0,0,11,190,153,1,0,0,0,16,170,
20220909,513,514,고성,동고성,293,2,4,0,6,14,319,278,4,2,0,6,28,318,
20220909,513,515,고성,북통영,2732,16,56,6,3,158,2971,2532,15,64,7,3,129,2750,
20220909,513,516,고성,통영,5429,27,39,13,16,299,5823,5305,16,35,9,13,278,5656,
20220909,514,513,동고성,고성,278,4,2,0,6,28,318,293,2,4,0,6,14,319,
20220909,514,515,동고성,북통영,144,2,0,0,0,14,160,170,2,1,0,0,13,186,
20220909,514,516,동고성,통영,1009,10,8,0,2,88,1117,1456,6,7,2,3,121,1595,
20220909,515,225,북통영,서진주,260,0,1,0,1,14,276,230,0,1,0,1,14,246,
20220909,515,272,북통영,광양,111,2,5,0,0,3,121,94,0,4,0,1,3,102,
20220909,515,291,북통영,사천,148,11,0,0,0,11,170,117,8,1,0,0,9,135,
20220909,515,292,북통영,진주,423,4,7,1,0,16,451,398,2,3,1,0,20,424,
20220909,515,513,북통영,고성,2532,15,64,7,3,129,2750,2732,16,56,6,3,158,2971,
20220909,515,514,북통영,동고성,170,2,1,0,0,13,186,144,2,0,0,0,14,160,
20220909,516,101,통영,서울,260,2,30,0,0,12,304,358,1,37,0,0,14,410,
20220909,516,190,통영,동서울,260,0,8,0,0,8,276,304,0,8,0,0,17,329,
20220909,516,223,통영,단성,407,0,2,1,0,15,425,150,0,0,0,0,6,156,
20220909,516,225,통영,서진주,768,8,2,1,0,31,810,600,1,1,1,1,47,651,
20220909,516,261,통영,동광주,296,0,5,1,0,9,311,340,1,2,0,0,7,350,
20220909,516,272,통영,광양,664,0,8,1,0,28,701,353,1,6,1,0,8,369,
20220909,516,275,통영,옥곡,160,0,0,0,4,8,172,208,0,6,1,3,14,232,
20220909,516,277,통영,하동,217,0,0,0,1,12,230,118,0,0,0,1,9,128,
20220909,516,291,통영,사천,557,15,8,1,0,32,613,442,29,5,0,1,29,506,
20220909,516,292,통영,진주,1122,14,13,1,0,67,1217,843,8,14,0,0,49,914,
20220909,516,293,통영,문산,105,1,1,0,0,4,111,160,0,0,0,0,5,165,
20220909,516,512,통영,연화산,266,3,0,0,0,17,286,161,3,1,0,0,18,183,
20220909,516,513,통영,고성,5305,16,35,9,13,278,5656,5429,27,39,13,16,299,5823,
20220909,516,514,통영,동고성,1456,6,7,2,3,121,1595,1009,10,8,0,2,88,1117,
20220909,516,544,통영,완주,193,0,8,0,0,5,206,176,0,2,0,2,9,189,
20220909,516,545,통영,소양,138,0,2,0,0,8,148,146,1,1,0,0,8,156,
20220909,517,177,양평,여주,548,1,1,4,0,9,563,98,1,1,3,5,7,115,
20220909,517,500,양평,남여주,900,2,2,5,54,15,978,365,0,2,2,34,13,416,
20220909,517,560,양평,감곡,709,1,0,0,0,15,725,235,2,0,4,1,6,248,
20220909,517,561,양평,북충주,274,1,0,0,0,7,282,121,2,0,0,0,5,128,
20220909,517,570,양평,북상주,107,0,0,0,0,0,107,135,0,0,0,0,0,135,
20220909,517,597,양평,서여주,1109,13,35,21,5,21,1204,708,12,40,14,4,30,808,
20220909,517,598,양평,북여주,2974,7,3,8,6,82,3080,1528,3,2,2,7,54,1596,
20220909,517,735,양평,남양평,196,0,0,0,0,8,204,431,1,1,0,0,20,453,
20220909,518,127,칠곡물류,서대구,296,34,35,53,8,15,441,280,39,33,47,11,10,420,
20220909,518,129,칠곡물류,북대구,206,18,8,1,2,17,252,266,27,12,3,1,17,326,
20220909,518,772,칠곡물류,북달성,79,4,9,28,2,5,127,73,3,9,22,3,7,117,
20220909,518,774,칠곡물류,남칠곡,88,5,23,23,5,2,146,92,8,24,21,2,3,150,
20220909,519,224,남대구,함양,217,2,0,0,0,14,233,133,2,0,0,0,10,145,
20220909,519,231,남대구,화원옥포,5491,16,35,7,2,331,5882,4866,18,28,5,2,287,5206,
20220909,519,232,남대구,달성,1665,11,18,0,2,88,1784,1641,14,36,0,1,109,1801,
20220909,519,233,남대구,현풍,3864,19,39,18,16,204,4160,3630,29,44,14,15,201,3933,
20220909,519,235,남대구,창녕,842,1,19,0,1,27,890,579,1,25,0,1,17,623,
20220909,519,236,남대구,영산,360,1,2,1,1,11,376,611,4,11,3,0,16,645,
20220909,519,237,남대구,남지,136,3,4,9,2,6,160,148,3,8,12,1,4,176,
20220909,519,238,남대구,칠서,105,0,2,0,1,4,112,105,1,3,0,1,5,115,
20220909,519,239,남대구,칠원,1810,11,68,12,8,82,1991,2087,9,62,6,7,78,2249,
20220909,519,241,남대구,동고령,3631,15,38,5,0,170,3859,2766,16,35,6,2,142,2967,
20220909,519,242,남대구,고령,2844,10,18,3,11,114,3000,2122,11,34,2,10,100,2279,
20220909,519,243,남대구,해인사,1135,1,1,1,0,38,1176,867,1,2,0,2,23,895,
20220909,519,261,남대구,동광주,607,1,57,14,0,15,694,540,3,51,3,0,16,613,
20220909,519,272,남대구,광양,198,0,6,0,0,4,208,111,0,3,0,0,6,120,
20220909,519,274,남대구,가조,500,2,0,0,0,18,520,350,1,0,0,0,7,358,
20220909,519,280,남대구,거창,1466,11,32,2,2,69,1582,870,8,35,2,1,39,955,
20220909,519,291,남대구,사천,351,2,7,1,0,13,374,249,1,6,1,0,8,265,
20220909,519,538,남대구,성주,499,1,0,0,0,18,518,244,0,0,0,1,7,252,
20220909,519,539,남대구,남성주,331,2,0,0,0,6,339,228,1,1,3,0,6,239,
20220909,519,544,남대구,완주,219,1,6,2,1,3,232,238,2,7,1,1,7,256,
20220909,519,545,남대구,소양,209,1,20,0,0,12,242,177,0,23,0,1,7,208,
20220909,519,730,남대구,유천,2192,14,4,0,0,113,2323,2352,10,2,0,0,126,2490,
20220909,519,731,남대구,북현풍,1582,3,8,0,0,78,1671,1383,4,1,0,0,76,1464,
20220909,520,107,평택,안성,556,4,2,0,0,19,581,145,1,0,0,0,12,158,
20220909,520,108,평택,천안,710,0,1,2,0,26,739,108,0,2,0,0,1,111,
20220909,520,253,평택,서서울,1879,17,14,15,20,62,2007,3751,7,9,13,15,113,3908,
20220909,520,254,평택,군자,412,4,2,3,1,17,439,627,3,4,3,2,20,659,
20220909,520,257,평택,홍성,328,2,0,0,0,17,347,232,1,3,0,0,8,244,
20220909,520,258,평택,광천,171,0,3,0,0,5,179,143,0,2,0,1,4,150,
20220909,520,259,평택,대천,261,1,13,2,0,14,291,230,0,14,2,0,13,259,
20220909,520,281,평택,매송,152,1,2,1,1,9,166,313,1,0,1,1,19,335,
20220909,520,285,평택,서평택,251,2,1,2,14,10,280,153,5,5,5,17,13,198,
20220909,520,287,평택,송악,297,3,1,0,16,12,329,454,2,3,1,32,25,517,
20220909,520,288,평택,당진,261,1,20,0,0,15,297,310,4,32,0,3,15,364,
20220909,520,298,평택,서산,805,7,26,1,0,37,876,623,7,59,0,1,20,710,
20220909,520,540,평택,청북,1259,5,40,16,22,41,1383,3476,8,44,5,17,97,3647,
20220909,520,541,평택,송탄,165,3,3,2,2,13,188,224,5,1,1,0,7,238,
20220909,520,542,평택,서안성,240,3,3,3,1,12,262,100,0,4,1,4,6,115,
20220909,520,543,평택,남안성,811,7,1,2,2,22,845,176,10,1,2,2,7,198,
20220909,520,572,평택,고덕,104,0,3,0,0,6,113,112,0,14,0,0,7,133,
20220909,520,685,평택,서시흥,3910,16,50,39,59,173,4247,109,0,0,0,0,3,112,
20220909,520,741,평택,평택고덕,1855,9,18,1,5,57,1945,658,6,38,1,4,37,744,
20220909,521,208,단양,서안동,557,2,1,0,0,17,577,100,0,0,1,0,4,105,
20220909,521,210,단양,영주,211,2,0,0,3,9,225,116,1,1,0,0,5,123,
20220909,521,211,단양,풍기,1579,5,11,1,2,47,1645,589,4,0,0,0,27,620,
20220909,522,211,북단양,풍기,519,3,6,0,3,7,538,192,4,0,0,0,7,203,
20220909,522,218,북단양,남원주,125,2,1,2,0,3,133,264,1,2,1,0,14,282,
20220909,522,297,북단양,동충주,224,1,0,0,11,6,242,433,4,2,0,8,11,458,
20220909,522,523,북단양,남제천,115,0,0,0,2,7,124,285,1,0,0,1,6,293,
20220909,523,128,남제천,금왕꽃동네,175,2,1,1,5,5,189,292,1,1,0,4,7,305,
20220909,523,136,남제천,음성,199,1,0,1,14,5,220,207,0,0,0,10,3,220,
20220909,523,208,남제천,서안동,273,0,1,0,0,10,284,115,0,1,0,0,8,124,
20220909,523,211,남제천,풍기,587,0,2,0,0,15,604,318,3,0,0,3,14,338,
20220909,523,240,남제천,제천,141,2,0,0,0,8,151,375,0,0,1,1,12,389,
20220909,523,297,남제천,동충주,297,4,2,1,4,13,321,583,7,3,1,3,17,614,
20220909,523,522,남제천,북단양,285,1,0,0,1,6,293,115,0,0,0,2,7,124,
20220909,523,542,남제천,서안성,85,1,0,0,12,6,104,132,0,1,0,10,4,147,
20220909,523,543,남제천,남안성,297,1,0,0,37,15,350,280,5,1,2,26,13,327,
20220909,524,127,청통와촌,서대구,441,12,4,7,2,16,482,743,22,6,5,3,28,807,
20220909,524,129,청통와촌,북대구,971,38,11,4,9,36,1069,820,23,5,4,0,36,888,
20220909,524,230,청통와촌,팔공산,946,20,12,2,0,36,1016,1311,14,11,2,1,57,1396,
20220909,524,525,청통와촌,북영천,336,0,0,0,0,11,347,228,2,0,0,1,4,235,
20220909,524,527,청통와촌,포항,972,36,8,0,2,43,1061,945,25,10,4,2,21,1007,
20220909,524,621,청통와촌,동대구,240,3,7,3,0,5,258,313,7,6,1,0,8,335,
20220909,524,730,청통와촌,유천,117,5,0,0,2,3,127,106,3,0,0,0,2,111,
20220909,525,127,북영천,서대구,490,1,2,2,0,17,512,1087,3,0,3,3,27,1123,
20220909,525,129,북영천,북대구,1021,4,4,1,1,42,1073,1080,1,4,0,0,48,1133,
20220909,525,230,북영천,팔공산,917,3,1,1,0,36,958,1695,3,1,1,0,58,1758,
20220909,525,524,북영천,청통와촌,228,2,0,0,1,4,235,336,0,0,0,0,11,347,
20220909,525,527,북영천,포항,434,4,4,4,6,17,469,666,7,3,2,3,19,700,
20220909,525,621,북영천,동대구,232,0,0,0,0,1,233,420,0,1,0,0,8,429,
20220909,525,730,북영천,유천,120,0,0,0,0,3,123,180,0,0,0,0,2,182,
20220909,526,129,서포항,북대구,162,0,0,2,0,6,170,329,0,1,2,0,7,339,
20220909,526,230,서포항,팔공산,121,1,0,1,0,3,126,468,0,1,0,0,18,487,
20220909,526,527,서포항,포항,1640,2,9,1,5,85,1742,3336,6,10,0,3,154,3509,
20220909,527,115,포항,대전,120,1,5,0,0,10,136,187,2,6,0,0,9,204,
20220909,527,123,포항,구미,223,0,1,1,1,7,233,242,0,1,0,1,9,253,
20220909,527,125,포항,남구미,163,0,0,0,1,7,171,251,0,2,1,0,19,273,
20220909,527,126,포항,왜관,320,7,3,2,5,10,347,227,13,1,1,3,11,256,
20220909,527,127,포항,서대구,1087,14,18,3,7,40,1169,1626,11,17,7,12,94,1767,
20220909,527,129,포항,북대구,2423,13,12,7,26,100,2581,1869,11,7,6,12,70,1975,
20220909,527,201,포항,칠곡,170,1,0,0,4,10,185,220,2,1,0,2,9,234,
20220909,527,230,포항,팔공산,1683,7,5,3,2,58,1758,2412,9,7,1,5,102,2536,
20220909,527,231,포항,화원옥포,223,0,4,1,0,5,233,122,0,1,1,2,9,135,
20220909,527,233,포항,현풍,103,0,3,0,7,5,118,120,0,2,1,2,6,131,
20220909,527,242,포항,고령,244,0,0,2,5,9,260,135,0,0,0,4,3,142,
20220909,527,261,포항,동광주,243,0,7,1,0,8,259,198,0,7,0,0,5,210,
20220909,527,524,포항,청통와촌,945,25,10,4,2,21,1007,972,36,8,0,2,43,1061,
20220909,527,525,포항,북영천,666,7,3,2,3,19,700,434,4,4,4,6,17,469,
20220909,527,526,포항,서포항,3336,6,10,0,3,154,3509,1640,2,9,1,5,85,1742,
20220909,527,621,포항,동대구,704,6,63,1,0,18,792,805,5,56,0,0,32,898,
20220909,527,730,포항,유천,243,0,0,0,0,9,252,247,0,0,0,0,7,254,
20220909,527,772,포항,북달성,85,2,9,2,0,3,101,148,0,10,1,0,2,161,
20220909,528,101,기흥동탄,서울,5625,16,384,111,4,210,6350,6046,23,384,115,5,200,6773,
20220909,528,103,기흥동탄,수원신갈,1262,6,4,1,1,62,1336,1071,6,11,0,0,40,1128,
20220909,528,106,기흥동탄,오산,484,13,30,3,6,30,566,189,12,11,5,1,10,228,
20220909,528,107,기흥동탄,안성,407,6,4,1,3,29,450,430,6,4,0,1,33,474,
20220909,528,108,기흥동탄,천안,539,9,13,1,5,21,588,396,8,5,1,7,24,441,
20220909,528,111,기흥동탄,청주,122,0,0,0,0,5,127,130,0,1,0,1,6,138,
20220909,528,171,기흥동탄,마성,129,0,2,0,0,8,139,174,0,0,0,0,2,176,
20220909,528,212,기흥동탄,북수원,273,1,3,0,0,11,288,341,0,1,3,2,12,359,
20220909,528,214,기흥동탄,동군포,112,1,0,0,0,3,116,91,3,1,0,0,7,102,
20220909,528,253,기흥동탄,서서울,542,7,8,0,5,22,584,501,1,4,6,3,12,527,
20220909,528,254,기흥동탄,군자,444,1,6,3,0,21,475,460,6,7,3,6,21,503,
20220909,528,542,기흥동탄,서안성,145,3,15,7,2,5,177,388,11,15,10,4,16,444,
20220909,528,543,기흥동탄,남안성,147,5,7,5,2,8,174,186,14,11,8,5,10,234,
20220909,528,555,기흥동탄,북진천,209,1,1,0,0,9,220,101,3,0,0,1,5,110,
20220909,528,673,기흥동탄,북오산,309,5,3,3,0,11,331,117,5,0,0,0,8,130,
20220909,528,677,기흥동탄,북평택,242,3,4,1,19,9,278,107,1,3,8,17,5,141,
20220909,528,741,기흥동탄,평택고덕,188,0,55,1,0,1,245,173,0,66,0,0,3,242,
20220909,529,135,노포,경주,148,0,66,0,0,11,225,144,0,70,0,0,5,219,
20220909,529,138,노포,양산,317,2,0,0,1,16,336,419,8,1,1,0,26,455,
20220909,529,139,노포,서울산,169,1,0,0,0,8,178,165,2,0,0,0,7,174,
20220909,529,148,노포,서김해,261,2,5,3,2,17,290,183,1,3,2,0,11,200,
20220909,529,149,노포,동김해,264,2,2,0,0,22,290,192,1,1,0,0,16,210,
20220909,529,245,노포,장유,345,1,1,0,1,13,361,205,1,2,0,1,5,214,
20220909,529,250,노포,남양산,266,1,5,0,0,24,296,319,7,4,2,0,22,354,
20220909,529,252,노포,대동,1212,8,13,4,7,58,1302,336,0,17,0,1,22,376,
20220909,529,286,노포,통도사휴게소,114,0,24,0,0,5,143,142,0,24,0,0,3,169,
20220909,530,159,내장산,서전주,129,0,2,1,0,4,136,442,3,4,0,0,6,455,
20220909,530,163,내장산,정읍,95,0,0,1,0,4,100,251,2,6,2,0,5,266,
20220909,530,167,내장산,광주,619,10,3,2,0,17,651,755,7,4,6,2,18,792,
20220909,531,532,문의청남대,회인,763,2,0,2,0,27,794,418,1,0,1,0,15,435,
20220909,531,533,문의청남대,보은,528,2,2,0,2,23,557,455,4,2,1,2,15,479,
20220909,531,534,문의청남대,속리산,305,1,1,0,0,15,322,255,1,0,0,0,6,262,
20220909,531,535,문의청남대,화서,426,1,0,0,0,8,435,106,0,0,0,0,3,109,
20220909,531,536,문의청남대,남상주,446,0,2,1,1,9,459,281,0,5,0,1,11,298,
20220909,532,531,회인,문의청남대,418,1,0,1,0,15,435,763,2,0,2,0,27,794,
20220909,533,112,보은,남청주,131,4,2,2,0,9,148,120,4,0,0,0,9,133,
20220909,533,198,보은,서청주,116,2,1,0,0,7,126,124,3,0,1,0,6,134,
20220909,533,210,보은,영주,114,0,0,0,0,2,116,95,0,0,0,1,5,101,
20220909,533,531,보은,문의청남대,455,4,2,1,2,15,479,528,2,2,0,2,23,557,
20220909,533,536,보은,남상주,314,1,1,2,1,7,326,214,1,0,1,0,8,224,
20220909,534,531,속리산,문의청남대,255,1,0,0,0,6,262,305,1,1,0,0,15,322,
20220909,534,536,속리산,남상주,111,1,2,0,3,5,122,123,2,0,0,0,3,128,
20220909,535,531,화서,문의청남대,106,0,0,0,0,3,109,426,1,0,0,0,8,435,
20220909,535,536,화서,남상주,366,1,5,4,3,10,389,426,4,6,3,2,10,451,
20220909,536,207,남상주,남안동,161,0,2,6,0,5,174,125,1,2,5,0,4,137,
20220909,536,531,남상주,문의청남대,281,0,5,0,1,11,298,446,0,2,1,1,9,459,
20220909,536,533,남상주,보은,214,1,0,1,0,8,224,314,1,1,2,1,7,326,
20220909,536,534,남상주,속리산,123,2,0,0,0,3,128,111,1,2,0,3,5,122,
20220909,536,535,남상주,화서,426,4,6,3,2,10,451,366,1,5,4,3,10,389,
20220909,537,233,남김천,현풍,253,2,4,10,7,11,287,247,1,3,4,2,9,266,
20220909,537,239,남김천,칠원,246,2,3,7,6,12,276,438,2,1,4,12,17,474,
20220909,537,242,남김천,고령,120,0,0,0,0,3,123,106,0,0,1,1,3,111,
20220909,537,538,남김천,성주,342,0,4,3,9,16,374,283,1,5,3,3,10,305,
20220909,538,231,성주,화원옥포,114,0,1,0,0,4,119,176,3,1,0,0,8,188,
20220909,538,233,성주,현풍,212,3,0,3,3,11,232,281,2,2,3,2,10,300,
20220909,538,519,성주,남대구,244,0,0,0,1,7,252,499,1,0,0,0,18,518,
20220909,538,537,성주,남김천,283,1,5,3,3,10,305,342,0,4,3,9,16,374,
20220909,539,233,남성주,현풍,188,1,0,4,2,5,200,207,1,3,8,3,7,229,
20220909,539,519,남성주,남대구,228,1,1,3,0,6,239,331,2,0,0,0,6,339,
20220909,540,107,청북,안성,636,5,2,2,2,27,674,317,0,1,0,0,15,333,
20220909,540,108,청북,천안,479,1,3,1,0,18,502,150,1,1,0,1,7,160,
20220909,540,111,청북,청주,124,2,1,0,0,6,133,110,1,2,1,0,1,115,
20220909,540,253,청북,서서울,677,12,4,4,12,42,751,2184,8,2,10,9,64,2277,
20220909,540,287,청북,송악,204,0,4,2,11,5,226,71,4,6,7,21,2,111,
20220909,540,520,청북,평택,3476,8,44,5,17,97,3647,1259,5,40,16,22,41,1383,
20220909,540,541,청북,송탄,203,4,4,6,5,7,229,177,3,3,5,4,7,199,
20220909,540,542,청북,서안성,387,1,6,7,13,10,424,164,1,6,8,11,2,192,
20220909,540,543,청북,남안성,836,3,4,2,4,37,886,274,13,6,2,1,10,306,
20220909,540,555,청북,북진천,529,7,1,3,3,12,555,123,5,1,2,1,8,140,
20220909,540,741,청북,평택고덕,1658,4,5,11,4,51,1733,667,5,15,15,4,32,738,
20220909,541,101,송탄,서울,561,8,7,2,2,25,605,515,2,3,3,0,37,560,
20220909,541,107,송탄,안성,950,18,4,5,2,73,1052,512,6,0,1,0,36,555,
20220909,541,108,송탄,천안,919,21,6,3,1,34,984,362,18,4,2,1,22,409,
20220909,541,229,송탄,북천안,267,5,3,4,1,7,287,78,7,4,10,0,6,105,
20220909,541,253,송탄,서서울,172,2,3,1,2,8,188,90,3,2,4,1,4,104,
20220909,541,520,송탄,평택,224,5,1,1,0,7,238,165,3,3,2,2,13,188,
20220909,541,540,송탄,청북,177,3,3,5,4,7,199,203,4,4,6,5,7,229,
20220909,541,542,송탄,서안성,257,4,1,3,2,9,276,91,2,1,2,3,2,101,
20220909,541,543,송탄,남안성,854,16,7,2,3,40,922,366,14,3,4,1,30,418,
20220909,541,555,송탄,북진천,402,8,1,3,1,19,434,111,6,0,2,0,11,130,
20220909,541,742,송탄,남사진위,101,2,0,7,4,5,119,196,4,3,3,0,13,219,
20220909,542,101,서안성,서울,2129,21,51,121,12,97,2431,590,4,40,45,10,18,707,
20220909,542,106,서안성,오산,335,10,9,20,2,21,397,156,3,6,18,1,10,194,
20220909,542,107,서안성,안성,365,6,1,2,0,13,387,228,6,0,3,0,17,254,
20220909,542,108,서안성,천안,1037,6,27,16,7,33,1126,533,8,34,9,10,23,617,
20220909,542,128,서안성,금왕꽃동네,137,1,1,2,4,3,148,121,2,3,3,6,4,139,
20220909,542,136,서안성,음성,1317,2,0,18,10,34,1381,133,1,1,3,4,2,144,
20220909,542,188,서안성,서충주,145,0,2,1,1,8,157,99,1,1,2,2,8,113,
20220909,542,297,서안성,동충주,232,2,0,4,7,3,248,110,2,2,2,4,4,124,
20220909,542,520,서안성,평택,100,0,4,1,4,6,115,240,3,3,3,1,12,262,
20220909,542,523,서안성,남제천,132,0,1,0,10,4,147,85,1,0,0,12,6,104,
20220909,542,528,서안성,기흥동탄,388,11,15,10,4,16,444,145,3,15,7,2,5,177,
20220909,542,540,서안성,청북,164,1,6,8,11,2,192,387,1,6,7,13,10,424,
20220909,542,541,서안성,송탄,91,2,1,2,3,2,101,257,4,1,3,2,9,276,
20220909,542,543,서안성,남안성,1380,8,18,28,15,53,1502,558,21,20,22,21,34,676,
20220909,542,555,서안성,북진천,912,10,22,9,5,32,990,269,7,11,7,5,14,313,
20220909,542,742,서안성,남사진위,413,10,7,28,2,33,493,200,2,5,22,2,14,245,
20220909,543,101,남안성,서울,1077,47,41,46,9,44,1264,784,28,23,22,4,32,893,
20220909,543,103,남안성,수원신갈,155,4,6,3,0,1,169,113,1,3,4,0,4,125,
20220909,543,106,남안성,오산,309,8,3,10,4,16,350,406,5,5,2,1,16,435,
20220909,543,128,남안성,금왕꽃동네,209,3,6,4,3,8,233,338,2,11,9,14,24,398,
20220909,543,136,남안성,음성,1412,1,9,10,10,29,1471,225,3,5,2,13,10,258,
20220909,543,188,남안성,서충주,287,0,3,4,4,11,309,358,2,8,8,8,14,398,
20220909,543,195,남안성,대소,122,6,0,4,2,4,138,210,15,5,6,2,4,242,
20220909,543,211,남안성,풍기,257,1,0,0,2,8,268,114,0,1,2,2,4,123,
20220909,543,253,남안성,서서울,282,7,0,4,3,12,308,226,5,4,3,1,8,247,
20220909,543,297,남안성,동충주,486,2,2,1,21,20,532,583,2,4,7,26,26,648,
20220909,543,520,남안성,평택,176,10,1,2,2,7,198,811,7,1,2,2,22,845,
20220909,543,523,남안성,남제천,280,5,1,2,26,13,327,297,1,0,0,37,15,350,
20220909,543,528,남안성,기흥동탄,186,14,11,8,5,10,234,147,5,7,5,2,8,174,
20220909,543,540,남안성,청북,274,13,6,2,1,10,306,836,3,4,2,4,37,886,
20220909,543,541,남안성,송탄,366,14,3,4,1,30,418,854,16,7,2,3,40,922,
20220909,543,542,남안성,서안성,558,21,20,22,21,34,676,1380,8,18,28,15,53,1502,
20220909,543,555,남안성,북진천,1178,27,11,20,13,38,1287,423,30,15,13,20,27,528,
20220909,543,561,남안성,북충주,159,1,0,1,3,4,168,141,2,0,2,3,7,155,
20220909,543,671,남안성,봉담,272,1,3,5,1,17,299,123,4,3,6,1,5,142,
20220909,543,673,남안성,북오산,227,6,3,4,1,13,254,116,8,0,3,0,9,136,
20220909,543,741,남안성,평택고덕,84,4,1,4,5,5,103,170,0,0,0,1,4,175,
20220909,543,742,남안성,남사진위,157,4,5,7,1,3,177,462,3,0,4,0,22,491,
20220909,544,135,완주,경주,118,1,1,0,0,3,123,113,0,1,3,1,0,118,
20220909,544,145,완주,산인,299,1,12,3,0,15,330,529,0,6,2,9,14,560,
20220909,544,150,완주,북부산,149,0,0,0,0,5,154,91,0,2,1,4,4,102,
20220909,544,152,완주,유성,93,0,1,0,0,6,100,163,1,1,1,0,6,172,
20220909,544,169,완주,장수,571,0,2,0,0,16,589,323,2,2,2,0,12,341,
20220909,544,225,완주,서진주,108,0,0,0,2,2,112,104,0,0,0,0,3,107,
20220909,544,244,완주,서부산,194,3,11,0,15,9,232,118,3,19,3,21,1,165,
20220909,544,516,완주,통영,176,0,2,0,2,9,189,193,0,8,0,0,5,206,
20220909,544,519,완주,남대구,238,2,7,1,1,7,256,219,1,6,2,1,3,232,
20220909,544,545,완주,소양,701,2,11,5,2,6,727,467,2,9,8,3,6,495,
20220909,544,546,완주,진안,573,3,6,3,0,9,594,253,1,5,3,1,5,268,
20220909,544,556,완주,동순천,736,1,1,2,16,13,769,142,2,7,1,41,6,199,
20220909,544,587,완주,오수,268,3,0,6,0,2,279,163,4,3,8,1,1,180,
20220909,545,145,소양,산인,207,1,24,0,0,7,239,318,0,24,0,0,8,350,
20220909,545,156,소양,익산,147,6,9,1,1,2,166,132,0,1,1,1,2,137,
20220909,545,157,소양,삼례,125,0,2,0,1,1,129,109,0,0,1,0,3,113,
20220909,545,169,소양,장수,1133,2,1,0,0,24,1160,592,3,0,0,0,21,616,
20220909,545,516,소양,통영,146,1,1,0,0,8,156,138,0,2,0,0,8,148,
20220909,545,519,소양,남대구,177,0,23,0,1,7,208,209,1,20,0,0,12,242,
20220909,545,544,소양,완주,467,2,9,8,3,6,495,701,2,11,5,2,6,727,
20220909,545,546,소양,진안,410,3,27,1,0,12,453,237,0,28,0,0,5,270,
20220909,546,169,진안,장수,120,3,0,0,0,5,128,130,3,0,0,0,2,135,
20220909,546,544,진안,완주,253,1,5,3,1,5,268,573,3,6,3,0,9,594,
20220909,546,545,진안,소양,237,0,28,0,0,5,270,410,3,27,1,0,12,453,
20220909,547,553,무안공항,동광산,670,1,1,1,0,18,691,1179,0,0,1,0,23,1203,
20220909,548,509,북무안,목포,231,0,3,2,1,6,243,764,4,5,6,5,24,808,
20220909,548,552,북무안,서광산,161,3,3,0,0,3,170,354,6,3,1,0,5,369,
20220909,548,553,북무안,동광산,1880,12,15,6,5,37,1955,4562,5,18,5,5,105,4700,
20220909,549,509,동함평,목포,160,4,2,1,0,2,169,348,4,2,2,3,9,368,
20220909,549,552,동함평,서광산,244,1,2,0,0,6,253,309,0,4,3,2,8,326,
20220909,549,553,동함평,동광산,3024,12,24,5,13,86,3164,4703,11,40,8,14,128,4904,
20220909,550,553,문평,동광산,847,2,3,1,7,19,879,1451,0,6,2,5,33,1497,
20220909,551,552,나주,서광산,166,1,1,3,6,5,182,197,1,4,2,5,6,215,
20220909,551,553,나주,동광산,1441,3,4,4,16,57,1525,2074,4,4,6,15,81,2184,
20220909,552,509,서광산,목포,260,9,7,1,1,8,286,392,11,6,5,4,7,425,
20220909,552,548,서광산,북무안,354,6,3,1,0,5,369,161,3,3,0,0,3,170,
20220909,552,549,서광산,동함평,309,0,4,3,2,8,326,244,1,2,0,0,6,253,
20220909,552,551,서광산,나주,197,1,4,2,5,6,215,166,1,1,3,6,5,182,
20220909,552,553,서광산,동광산,3560,68,103,54,17,109,3911,9181,79,132,42,25,243,9702,
20220909,553,508,동광산,무안,4831,29,57,14,17,134,5082,1511,6,15,5,1,41,1579,
20220909,553,509,동광산,목포,7626,47,93,32,13,205,8016,8966,70,131,25,47,253,9492,
20220909,553,547,동광산,무안공항,1179,0,0,1,0,23,1203,670,1,1,1,0,18,691,
20220909,553,548,동광산,북무안,4562,5,18,5,5,105,4700,1880,12,15,6,5,37,1955,
20220909,553,549,동광산,동함평,4703,11,40,8,14,128,4904,3024,12,24,5,13,86,3164,
20220909,553,550,동광산,문평,1451,0,6,2,5,33,1497,847,2,3,1,7,19,879,
20220909,553,551,동광산,나주,2074,4,4,6,15,81,2184,1441,3,4,4,16,57,1525,
20220909,553,552,동광산,서광산,9181,79,132,42,25,243,9702,3560,68,103,54,17,109,3911,
20220909,554,174,동홍천,춘천,921,6,1,1,1,56,986,1528,10,1,4,0,87,1630,
20220909,554,510,동홍천,양양,1223,3,15,4,0,29,1274,329,3,7,0,0,13,352,
20220909,554,701,동홍천,북양양,640,0,5,0,0,28,673,362,2,0,0,0,11,375,
20220909,554,702,동홍천,속초,620,7,2,1,1,16,647,400,5,3,3,0,13,424,
20220909,554,765,동홍천,내촌,264,4,1,1,0,13,283,211,3,0,0,0,15,229,
20220909,554,766,동홍천,인제,422,4,0,1,0,12,439,266,2,3,2,0,17,290,
20220909,555,101,북진천,서울,192,7,3,3,0,7,212,750,2,2,3,4,13,774,
20220909,555,103,북진천,수원신갈,111,4,9,9,1,5,139,178,3,7,9,0,3,200,
20220909,555,106,북진천,오산,161,7,2,4,2,6,182,468,9,4,2,3,14,500,
20220909,555,128,북진천,금왕꽃동네,129,0,1,2,1,4,137,67,3,2,9,16,4,101,
20220909,555,190,북진천,동서울,412,14,1,2,1,7,437,1478,11,2,3,1,41,1536,
20220909,555,253,북진천,서서울,172,1,0,2,4,8,187,299,0,2,2,3,8,314,
20220909,555,297,북진천,동충주,247,0,1,0,6,7,261,352,0,2,2,4,11,371,
20220909,555,528,북진천,기흥동탄,101,3,0,0,1,5,110,209,1,1,0,0,9,220,
20220909,555,540,북진천,청북,123,5,1,2,1,8,140,529,7,1,3,3,12,555,
20220909,555,541,북진천,송탄,111,6,0,2,0,11,130,402,8,1,3,1,19,434,
20220909,555,542,북진천,서안성,269,7,11,7,5,14,313,912,10,22,9,5,32,990,
20220909,555,543,북진천,남안성,423,30,15,13,20,27,528,1178,27,11,20,13,38,1287,
20220909,555,671,북진천,봉담,159,5,0,1,0,12,177,172,3,1,0,0,9,185,
20220909,555,673,북진천,북오산,154,3,3,1,0,6,167,162,2,2,1,0,5,172,
20220909,555,742,북진천,남사진위,114,5,8,11,3,5,146,452,5,2,8,1,14,482,
20220909,556,145,동순천,산인,137,0,11,0,1,7,156,172,0,8,0,1,6,187,
20220909,556,152,동순천,유성,113,0,1,1,1,4,120,549,2,0,1,0,8,560,
20220909,556,153,동순천,서대전,98,0,1,0,2,4,105,184,1,1,0,1,6,193,
20220909,556,156,동순천,익산,109,2,0,0,4,1,116,275,3,2,3,3,4,290,
20220909,556,544,동순천,완주,142,2,7,1,41,6,199,736,1,1,2,16,13,769,
20220909,556,557,동순천,황전,1429,3,3,1,1,36,1473,1015,5,2,1,1,25,1049,
20220909,556,558,동순천,구례화엄사,420,2,0,0,5,8,435,608,4,0,0,4,15,631,
20220909,556,559,동순천,서남원,359,2,1,0,10,8,380,325,2,0,2,6,8,343,
20220909,556,587,동순천,오수,95,0,0,0,12,1,108,691,1,1,0,11,7,711,
20220909,556,588,동순천,임실,156,2,1,1,1,3,164,889,1,4,5,11,15,925,
20220909,556,589,동순천,상관,911,1,9,5,93,16,1035,1834,1,2,3,46,33,1919,
20220909,556,590,동순천,동전주,304,3,2,0,5,10,324,379,2,0,1,7,11,400,
20220909,557,271,황전,순천,389,2,1,0,0,11,403,667,5,0,0,0,19,691,
20220909,557,272,황전,광양,116,0,1,0,0,5,122,138,0,0,0,1,7,146,
20220909,557,273,황전,동광양,132,0,2,0,0,9,143,219,0,0,0,0,10,229,
20220909,557,556,황전,동순천,1015,5,2,1,1,25,1049,1429,3,3,1,1,36,1473,
20220909,558,261,구례화엄사,동광주,398,5,1,0,0,10,414,893,6,0,0,0,17,916,
20220909,558,271,구례화엄사,순천,186,3,1,0,0,1,191,173,2,1,0,0,1,177,
20220909,558,556,구례화엄사,동순천,608,4,0,0,4,15,631,420,2,0,0,5,8,435,
20220909,558,559,구례화엄사,서남원,140,0,0,0,1,5,146,143,1,1,0,2,6,153,
20220909,558,569,구례화엄사,북광주,140,2,2,1,0,1,146,500,1,3,2,0,11,517,
20220909,558,589,구례화엄사,상관,141,2,2,2,1,2,150,332,2,2,2,2,13,353,
20220909,559,261,서남원,동광주,154,3,1,1,0,11,170,186,0,2,0,0,7,195,
20220909,559,556,서남원,동순천,325,2,0,2,6,8,343,359,2,1,0,10,8,380,
20220909,559,558,서남원,구례화엄사,143,1,1,0,2,6,153,140,0,0,0,1,5,146,
20220909,559,589,서남원,상관,142,0,4,2,0,4,152,318,0,4,3,1,3,329,
20220909,560,101,감곡,서울,204,0,1,0,0,3,208,336,2,17,1,0,11,367,
20220909,560,102,감곡,동수원,166,0,4,0,0,4,174,174,0,3,0,0,5,182,
20220909,560,176,감곡,이천,110,1,1,0,0,2,114,294,2,3,0,0,9,308,
20220909,560,190,감곡,동서울,668,7,3,5,3,17,703,1264,1,4,9,3,40,1321,
20220909,560,192,감곡,곤지암,126,1,0,0,0,2,129,196,2,1,0,0,5,204,
20220909,560,212,감곡,북수원,150,0,5,0,0,1,156,208,0,5,0,0,11,224,
20220909,560,253,감곡,서서울,210,2,0,0,0,6,218,366,0,0,1,1,9,377,
20220909,560,254,감곡,군자,197,0,0,3,2,11,213,365,3,3,0,4,10,385,
20220909,560,517,감곡,양평,235,2,0,4,1,6,248,709,1,0,0,0,15,725,
20220909,560,561,감곡,북충주,302,2,6,0,0,16,326,96,2,0,0,0,4,102,
20220909,560,598,감곡,북여주,174,0,0,0,0,9,183,484,1,0,0,0,10,495,
20220909,561,101,북충주,서울,185,2,54,2,0,6,249,209,0,64,0,0,2,275,
20220909,561,128,북충주,금왕꽃동네,101,1,0,0,0,2,104,415,1,1,1,0,15,433,
20220909,561,190,북충주,동서울,489,6,34,4,1,16,550,796,2,32,2,0,24,856,
20220909,561,212,북충주,북수원,93,0,3,2,0,8,106,100,0,2,1,0,4,107,
20220909,561,253,북충주,서서울,183,0,0,3,0,6,192,159,1,0,0,0,8,168,
20220909,561,254,북충주,군자,121,0,13,0,0,8,142,158,0,4,0,0,9,171,
20220909,561,297,북충주,동충주,133,2,0,1,1,5,142,117,2,1,2,2,7,131,
20220909,561,517,북충주,양평,121,2,0,0,0,5,128,274,1,0,0,0,7,282,
20220909,561,543,북충주,남안성,141,2,0,2,3,7,155,159,1,0,1,3,4,168,
20220909,561,560,북충주,감곡,96,2,0,0,0,4,102,302,2,6,0,0,16,326,
20220909,562,101,충주,서울,154,1,0,0,1,6,162,178,0,5,0,0,8,191,
20220909,562,190,충주,동서울,484,2,3,0,1,21,511,650,0,3,0,2,23,678,
20220909,562,253,충주,서서울,155,0,0,0,1,11,167,161,0,1,0,2,8,172,
20220909,562,254,충주,군자,103,0,1,0,2,5,111,137,0,1,1,0,8,147,
20220909,563,190,괴산,동서울,101,1,2,0,0,2,106,557,0,0,0,1,14,572,
20220909,564,566,연풍,점촌함창,126,1,4,0,2,0,133,105,1,2,0,2,2,112,
20220909,565,127,문경새재,서대구,687,0,1,2,0,12,702,104,0,1,0,0,3,108,
20220909,565,129,문경새재,북대구,570,0,0,0,0,9,579,120,0,0,0,0,3,123,
20220909,565,190,문경새재,동서울,151,0,1,1,1,9,163,803,0,5,7,3,16,834,
20220909,565,566,문경새재,점촌함창,273,4,9,1,1,5,293,299,6,26,0,1,6,338,
20220909,565,570,문경새재,북상주,1033,0,3,2,1,17,1056,244,2,3,0,1,3,253,
20220909,566,101,점촌함창,서울,81,0,20,0,0,2,103,119,1,19,0,0,4,143,
20220909,566,127,점촌함창,서대구,441,0,0,2,0,7,450,124,1,0,0,0,4,129,
20220909,566,129,점촌함창,북대구,415,0,1,0,0,4,420,116,1,0,0,1,4,122,
20220909,566,190,점촌함창,동서울,304,0,29,1,0,15,349,445,0,10,3,0,11,469,
20220909,566,253,점촌함창,서서울,104,1,0,1,0,5,111,139,0,0,0,0,5,144,
20220909,566,564,점촌함창,연풍,105,1,2,0,2,2,112,126,1,4,0,2,0,133,
20220909,566,565,점촌함창,문경새재,299,6,26,0,1,6,338,273,4,9,1,1,5,293,
20220909,567,167,남고창,광주,1301,8,25,2,1,38,1375,1593,13,17,0,0,51,1674,
20220909,567,568,남고창,장성물류,168,1,3,1,0,0,173,114,6,2,0,0,3,125,
20220909,567,569,남고창,북광주,300,6,2,0,0,13,321,469,3,10,2,0,17,501,
20220909,568,167,장성물류,광주,86,31,1,3,1,4,126,112,22,1,0,0,5,140,
20220909,568,567,장성물류,남고창,114,6,2,0,0,3,125,168,1,3,1,0,0,173,
20220909,569,145,북광주,산인,188,0,6,2,0,3,199,118,0,0,2,4,4,128,
20220909,569,159,북광주,서전주,218,2,2,1,1,7,231,250,2,4,5,3,2,266,
20220909,569,165,북광주,백양사,144,0,1,0,0,2,147,279,0,0,2,0,4,285,
20220909,569,247,북광주,남원,384,3,1,2,1,19,410,180,3,3,1,1,4,192,
20220909,569,248,북광주,순창,873,1,10,2,5,34,925,541,3,4,0,7,24,579,
20220909,569,249,북광주,담양,556,4,2,4,0,17,583,372,5,1,3,1,7,389,
20220909,569,253,북광주,서서울,125,3,0,0,0,1,129,98,5,0,0,0,3,106,
20220909,569,263,북광주,옥과,1384,2,2,0,1,44,1433,702,1,3,2,0,19,727,
20220909,569,265,북광주,곡성,840,0,0,1,3,22,866,329,2,0,1,4,10,346,
20220909,569,266,북광주,석곡,381,2,0,1,0,11,395,152,0,0,1,1,3,157,
20220909,569,270,북광주,서순천,427,8,5,1,4,13,458,192,11,1,1,1,2,208,
20220909,569,271,북광주,순천,1716,42,14,1,13,41,1827,842,32,18,1,34,18,945,
20220909,569,273,북광주,동광양,151,4,0,1,10,2,168,127,5,0,2,4,4,142,
20220909,569,505,북광주,고창,148,2,0,1,0,2,153,103,1,1,2,0,0,107,
20220909,569,506,북광주,영광,142,1,0,0,0,2,145,129,2,0,1,0,5,137,
20220909,569,558,북광주,구례화엄사,500,1,3,2,0,11,517,140,2,2,1,0,1,146,
20220909,569,567,북광주,남고창,469,3,10,2,0,17,501,300,6,2,0,0,13,321,
20220909,570,127,북상주,서대구,232,2,3,1,1,11,250,356,0,0,0,1,10,367,
20220909,570,129,북상주,북대구,204,0,1,0,0,4,209,317,0,1,0,0,11,329,
20220909,570,190,북상주,동서울,234,3,8,5,0,5,255,411,2,0,2,0,9,424,
20220909,570,239,북상주,칠원,387,0,0,4,4,10,405,164,0,0,0,0,6,170,
20220909,570,517,북상주,양평,135,0,0,0,0,0,135,107,0,0,0,0,0,107,
20220909,570,565,북상주,문경새재,244,2,3,0,1,3,253,1033,0,3,2,1,17,1056,
20220909,571,152,면천,유성,127,1,0,0,0,7,135,203,2,0,0,0,9,214,
20220909,571,298,면천,서산,699,2,13,0,1,19,734,242,4,4,1,1,6,258,
20220909,571,572,면천,고덕,215,0,0,0,0,9,224,192,0,0,0,1,9,202,
20220909,571,573,면천,예산수덕사,206,0,5,1,0,8,220,167,1,5,2,2,7,184,
20220909,571,577,면천,공주,143,0,1,2,0,4,150,138,1,1,0,0,6,146,
20220909,571,579,면천,남세종,134,0,0,0,0,4,138,204,0,0,0,0,6,210,
20220909,572,253,고덕,서서울,601,3,1,0,2,21,628,605,0,0,0,0,23,628,
20220909,572,520,고덕,평택,112,0,14,0,0,7,133,104,0,3,0,0,6,113,
20220909,572,571,고덕,면천,192,0,0,0,1,9,202,215,0,0,0,0,9,224,
20220909,572,573,고덕,예산수덕사,922,4,10,5,3,29,973,185,6,6,1,5,4,207,
20220909,572,579,고덕,남세종,97,0,1,0,0,2,100,114,0,1,0,0,4,119,
20220909,573,115,예산수덕사,대전,240,0,0,0,0,11,251,428,2,0,0,0,21,451,
20220909,573,151,예산수덕사,북대전,244,1,2,1,6,4,258,404,4,3,0,7,14,432,
20220909,573,152,예산수덕사,유성,479,3,0,1,1,16,500,819,5,0,3,0,19,846,
20220909,573,153,예산수덕사,서대전,120,0,0,0,0,5,125,365,1,0,0,0,6,372,
20220909,573,253,예산수덕사,서서울,742,1,3,0,1,37,784,728,1,1,0,1,17,748,
20220909,573,298,예산수덕사,서산,94,1,0,1,2,4,102,146,2,1,0,26,7,182,
20220909,573,571,예산수덕사,면천,167,1,5,2,2,7,184,206,0,5,1,0,8,220,
20220909,573,572,예산수덕사,고덕,185,6,6,1,5,4,207,922,4,10,5,3,29,973,
20220909,573,574,예산수덕사,신양,616,3,2,3,2,13,639,162,3,0,1,1,3,170,
20220909,573,577,예산수덕사,공주,377,7,1,0,1,13,399,525,3,1,2,1,18,550,
20220909,573,578,예산수덕사,서세종,652,11,5,0,1,25,694,1096,12,10,2,1,30,1151,
20220909,573,579,예산수덕사,남세종,439,2,2,1,0,11,455,701,3,0,3,0,14,721,
20220909,574,253,신양,서서울,204,2,1,0,0,5,212,367,1,1,0,0,5,374,
20220909,574,573,신양,예산수덕사,162,3,0,1,1,3,170,616,3,2,3,2,13,639,
20220909,575,577,유구,공주,401,0,0,0,0,10,411,121,1,1,0,0,1,124,
20220909,576,152,마곡사,유성,150,0,0,2,0,3,155,183,0,0,1,0,8,192,
20220909,576,577,마곡사,공주,250,1,2,0,0,8,261,141,1,0,0,0,6,148,
20220909,576,578,마곡사,서세종,207,2,1,0,0,5,215,198,4,0,0,0,1,203,
20220909,576,579,마곡사,남세종,312,2,0,0,0,11,325,153,0,0,0,0,3,156,
20220909,577,298,공주,서산,278,0,1,0,1,9,289,188,4,0,0,1,10,203,
20220909,577,571,공주,면천,138,1,1,0,0,6,146,143,0,1,2,0,4,150,
20220909,577,573,공주,예산수덕사,525,3,1,2,1,18,550,377,7,1,0,1,13,399,
20220909,577,575,공주,유구,121,1,1,0,0,1,124,401,0,0,0,0,10,411,
20220909,577,576,공주,마곡사,141,1,0,0,0,6,148,250,1,2,0,0,8,261,
20220909,577,577,공주,공주,112,1,0,0,0,0,113,112,1,0,0,0,0,113,
20220909,577,613,공주,남풍세,242,5,8,0,0,13,268,400,1,0,0,0,13,414,
20220909,578,115,서세종,대전,200,9,4,0,0,11,224,354,20,6,0,0,15,395,
20220909,578,151,서세종,북대전,199,9,2,1,0,9,220,424,3,0,0,1,17,445,
20220909,578,152,서세종,유성,349,15,3,3,2,13,385,346,12,4,0,0,8,370,
20220909,578,153,서세종,서대전,143,1,0,1,0,5,150,281,3,2,0,0,7,293,
20220909,578,154,서세종,안영,95,0,2,1,0,4,102,166,2,1,0,0,5,174,
20220909,578,227,서세종,군산,336,2,5,0,0,15,358,339,2,1,2,2,12,358,
20220909,578,298,서세종,서산,527,4,0,1,0,16,548,380,4,2,0,5,14,405,
20220909,578,509,서세종,목포,216,0,0,2,0,10,228,147,1,1,0,0,5,154,
20220909,578,573,서세종,예산수덕사,1096,12,10,2,1,30,1151,652,11,5,0,1,25,694,
20220909,578,576,서세종,마곡사,198,4,0,0,0,1,203,207,2,1,0,0,5,215,
20220909,578,579,서세종,남세종,432,17,1,0,0,8,458,634,14,2,0,0,25,675,
20220909,578,591,서세종,동서천,467,1,1,2,7,5,483,129,1,1,0,11,7,149,
20220909,578,592,서세종,서부여,953,4,3,4,1,12,977,199,1,3,2,0,7,212,
20220909,578,593,서세종,부여,290,0,2,0,1,8,301,182,0,3,3,5,6,199,
20220909,578,595,서세종,서공주,317,2,5,2,1,6,333,161,2,2,0,1,4,170,
20220909,579,114,남세종,남대전,307,2,1,1,0,19,330,185,1,1,0,0,10,197,
20220909,579,115,남세종,대전,480,6,11,0,0,20,517,504,3,8,0,0,36,551,
20220909,579,116,남세종,옥천,529,1,0,0,0,19,549,256,2,1,0,0,23,282,
20220909,579,119,남세종,판암,200,3,2,0,0,7,212,349,3,0,0,0,6,358,
20220909,579,151,남세종,북대전,312,3,4,0,0,12,331,227,2,2,0,2,7,240,
20220909,579,152,남세종,유성,486,3,1,0,0,13,503,139,0,4,1,0,2,146,
20220909,579,153,남세종,서대전,444,3,3,0,0,22,472,780,3,2,0,0,29,814,
20220909,579,154,남세종,안영,507,3,2,1,0,24,537,538,7,2,1,0,23,571,
20220909,579,156,남세종,익산,103,2,1,0,1,2,109,107,1,0,0,0,6,114,
20220909,579,167,남세종,광주,676,0,1,1,0,10,688,180,0,6,0,0,5,191,
20220909,579,204,남세종,추부,219,2,0,0,0,9,230,108,2,0,0,0,4,114,
20220909,579,298,남세종,서산,357,3,0,0,0,15,375,304,1,2,1,1,10,319,
20220909,579,571,남세종,면천,204,0,0,0,0,6,210,134,0,0,0,0,4,138,
20220909,579,572,남세종,고덕,114,0,1,0,0,4,119,97,0,1,0,0,2,100,
20220909,579,573,남세종,예산수덕사,701,3,0,3,0,14,721,439,2,2,1,0,11,455,
20220909,579,576,남세종,마곡사,153,0,0,0,0,3,156,312,2,0,0,0,11,325,
20220909,579,578,남세종,서세종,634,14,2,0,0,25,675,432,17,1,0,0,8,458,
20220909,579,595,남세종,서공주,395,3,0,0,0,19,417,308,5,2,1,0,15,331,
20220909,580,174,북강릉,춘천,218,0,8,0,0,11,237,441,1,8,0,0,20,470,
20220909,580,180,북강릉,원주,153,4,1,1,0,0,159,328,3,1,1,0,10,343,
20220909,580,184,북강릉,대관령,399,5,4,0,0,9,417,440,4,4,0,0,12,460,
20220909,580,185,북강릉,평창,189,1,1,0,0,4,195,357,1,0,0,0,9,367,
20220909,580,187,북강릉,진부,133,3,1,0,0,5,142,193,1,0,2,0,3,199,
20220909,580,189,북강릉,강릉,235,3,0,1,0,3,242,314,7,1,0,0,10,332,
20220909,580,510,북강릉,양양,247,3,2,1,0,8,261,150,3,0,1,0,9,163,
20220909,580,581,북강릉,옥계,119,1,0,1,2,2,125,116,0,0,1,1,2,120,
20220909,580,582,북강릉,망상,221,2,2,0,0,4,229,219,2,0,0,0,17,238,
20220909,580,583,북강릉,동해,260,4,2,4,3,10,283,293,4,4,0,2,20,323,
20220909,580,585,북강릉,하조대,544,7,19,0,0,15,585,674,13,19,0,0,27,733,
20220909,580,701,북강릉,북양양,393,6,1,0,1,15,416,404,5,1,0,1,6,417,
20220909,580,702,북강릉,속초,572,9,2,0,0,25,608,531,19,2,0,1,22,575,
20220909,580,703,북강릉,삼척,161,0,1,0,0,5,167,194,2,0,0,1,10,207,
20220909,580,704,북강릉,근덕,216,2,5,2,0,9,234,362,3,3,2,2,15,387,
20220909,581,189,옥계,강릉,209,3,0,1,5,11,229,217,2,0,0,0,7,226,
20220909,581,580,옥계,북강릉,116,0,0,1,1,2,120,119,1,0,1,2,2,125,
20220909,581,582,옥계,망상,263,4,1,0,2,11,281,282,2,2,1,1,15,303,
20220909,581,583,옥계,동해,474,9,1,4,54,25,567,520,2,1,2,43,14,582,
20220909,581,584,옥계,남강릉,197,0,0,0,3,11,211,237,2,0,0,3,4,246,
20220909,581,703,옥계,삼척,219,0,0,0,1,13,233,196,2,0,4,9,8,219,
20220909,581,704,옥계,근덕,208,0,1,1,17,11,238,299,0,1,0,10,8,318,
20220909,582,189,망상,강릉,454,1,46,0,2,21,524,568,5,68,0,2,19,662,
20220909,582,580,망상,북강릉,219,2,0,0,0,17,238,221,2,2,0,0,4,229,
20220909,582,581,망상,옥계,282,2,2,1,1,15,303,263,4,1,0,2,11,281,
20220909,582,583,망상,동해,284,0,1,0,2,12,299,341,0,0,0,1,10,352,
20220909,582,584,망상,남강릉,493,6,3,1,0,28,531,529,8,3,0,1,28,569,
20220909,582,585,망상,하조대,104,0,0,0,0,5,109,111,0,0,0,0,1,112,
20220909,582,703,망상,삼척,180,0,0,0,0,6,186,222,1,1,0,0,6,230,
20220909,582,704,망상,근덕,165,1,0,0,2,8,176,251,1,2,0,1,4,259,
20220909,583,174,동해,춘천,124,0,0,0,1,5,130,213,0,0,0,0,10,223,
20220909,583,180,동해,원주,124,3,3,0,2,4,136,225,0,0,1,2,7,235,
20220909,583,189,동해,강릉,749,12,24,0,13,45,843,838,12,2,3,9,46,910,
20220909,583,580,동해,북강릉,293,4,4,0,2,20,323,260,4,2,4,3,10,283,
20220909,583,581,동해,옥계,520,2,1,2,43,14,582,474,9,1,4,54,25,567,
20220909,583,582,동해,망상,341,0,0,0,1,10,352,284,0,1,0,2,12,299,
20220909,583,584,동해,남강릉,847,15,1,3,8,50,924,813,9,6,3,11,48,890,
20220909,583,585,동해,하조대,175,3,2,1,0,8,189,150,3,2,0,1,8,164,
20220909,583,702,동해,속초,165,1,0,1,3,4,174,138,0,0,0,1,9,148,
20220909,583,703,동해,삼척,660,1,60,1,1,33,756,674,2,58,0,0,38,772,
20220909,583,704,동해,근덕,1403,6,20,2,24,89,1544,1514,5,18,1,21,73,1632,
20220909,584,581,남강릉,옥계,237,2,0,0,3,4,246,197,0,0,0,3,11,211,
20220909,584,582,남강릉,망상,529,8,3,0,1,28,569,493,6,3,1,0,28,531,
20220909,584,583,남강릉,동해,813,9,6,3,11,48,890,847,15,1,3,8,50,924,
20220909,584,703,남강릉,삼척,645,4,3,1,1,40,694,514,2,4,0,1,27,548,
20220909,584,704,남강릉,근덕,683,2,5,0,3,22,715,806,6,0,0,5,29,846,
20220909,585,184,하조대,대관령,137,1,0,0,0,4,142,127,1,0,0,0,1,129,
20220909,585,189,하조대,강릉,524,4,12,0,2,24,566,545,3,13,0,1,29,591,
20220909,585,284,하조대,남양양,357,3,2,0,0,18,380,328,4,4,1,1,15,353,
20220909,585,580,하조대,북강릉,674,13,19,0,0,27,733,544,7,19,0,0,15,585,
20220909,585,582,하조대,망상,111,0,0,0,0,1,112,104,0,0,0,0,5,109,
20220909,585,583,하조대,동해,150,3,2,0,1,8,164,175,3,2,1,0,8,189,
20220909,585,701,하조대,북양양,127,3,0,0,0,3,133,121,0,0,0,0,7,128,
20220909,585,702,하조대,속초,261,3,0,0,0,8,272,296,3,4,0,0,8,311,
20220909,585,703,하조대,삼척,105,1,1,0,0,6,113,101,1,0,0,0,2,104,
20220909,585,704,하조대,근덕,178,0,1,0,0,5,184,271,0,1,0,0,6,278,
20220909,586,261,북남원,동광주,171,0,0,1,0,3,175,167,1,1,0,0,5,174,
20220909,586,589,북남원,상관,277,0,3,0,1,5,286,363,2,1,0,2,11,379,
20220909,587,261,오수,동광주,149,1,0,0,0,2,152,139,0,0,1,0,3,143,
20220909,587,544,오수,완주,163,4,3,8,1,1,180,268,3,0,6,0,2,279,
20220909,587,556,오수,동순천,691,1,1,0,11,7,711,95,0,0,0,12,1,108,
20220909,587,588,오수,임실,96,3,1,0,0,3,103,113,4,2,2,2,1,124,
20220909,587,589,오수,상관,1135,4,22,9,10,29,1209,1572,8,12,6,10,48,1656,
20220909,587,590,오수,동전주,506,2,0,1,1,11,521,428,3,0,2,0,9,442,
20220909,588,261,임실,동광주,170,2,2,0,0,5,179,149,1,0,2,0,5,157,
20220909,588,556,임실,동순천,889,1,4,5,11,15,925,156,2,1,1,1,3,164,
20220909,588,587,임실,오수,113,4,2,2,2,1,124,96,3,1,0,0,3,103,
20220909,588,589,임실,상관,259,6,3,1,1,4,274,252,3,2,0,0,5,262,
20220909,588,590,임실,동전주,223,0,0,0,0,3,226,134,3,0,0,0,1,138,
20220909,589,269,상관,지리산,106,1,3,1,0,3,114,93,1,1,3,0,4,102,
20220909,589,271,상관,순천,414,0,2,0,5,12,433,279,0,0,0,6,8,293,
20220909,589,272,상관,광양,217,1,1,2,57,4,282,83,0,0,0,44,4,131,
20220909,589,273,상관,동광양,127,0,0,5,41,7,180,213,0,0,1,12,5,231,
20220909,589,556,상관,동순천,1834,1,2,3,46,33,1919,911,1,9,5,93,16,1035,
20220909,589,558,상관,구례화엄사,332,2,2,2,2,13,353,141,2,2,2,1,2,150,
20220909,589,559,상관,서남원,318,0,4,3,1,3,329,142,0,4,2,0,4,152,
20220909,589,586,상관,북남원,363,2,1,0,2,11,379,277,0,3,0,1,5,286,
20220909,589,587,상관,오수,1572,8,12,6,10,48,1656,1135,4,22,9,10,29,1209,
20220909,589,588,상관,임실,252,3,2,0,0,5,262,259,6,3,1,1,4,274,
20220909,590,152,동전주,유성,115,0,0,0,0,8,123,168,0,0,0,0,3,171,
20220909,590,156,동전주,익산,128,8,1,0,0,5,142,135,4,1,0,0,6,146,
20220909,590,556,동전주,동순천,379,2,0,1,7,11,400,304,3,2,0,5,10,324,
20220909,590,587,동전주,오수,428,3,0,2,0,9,442,506,2,0,1,1,11,521,
20220909,590,588,동전주,임실,134,3,0,0,0,1,138,223,0,0,0,0,3,226,
20220909,591,578,동서천,서세종,129,1,1,0,11,7,149,467,1,1,2,7,5,483,
20220909,592,227,서부여,군산,99,0,1,0,0,3,103,177,2,3,1,0,0,183,
20220909,592,578,서부여,서세종,199,1,3,2,0,7,212,953,4,3,4,1,12,977,
20220909,593,227,부여,군산,163,0,0,1,1,4,169,179,0,3,0,0,6,188,
20220909,593,578,부여,서세종,182,0,3,3,5,6,199,290,0,2,0,1,8,301,
20220909,595,115,서공주,대전,158,2,5,0,0,14,179,340,0,4,0,0,21,365,
20220909,595,151,서공주,북대전,197,4,1,0,1,6,209,287,1,0,0,1,11,300,
20220909,595,152,서공주,유성,294,2,3,2,5,10,316,446,5,2,1,7,11,472,
20220909,595,227,서공주,군산,538,0,8,3,0,10,559,96,0,3,0,0,2,101,
20220909,595,578,서공주,서세종,161,2,2,0,1,4,170,317,2,5,2,1,6,333,
20220909,595,579,서공주,남세종,308,5,2,1,0,15,331,395,3,0,0,0,19,417,
20220909,597,500,서여주,남여주,504,1,0,0,1,15,521,207,0,0,0,0,9,216,
20220909,597,517,서여주,양평,708,12,40,14,4,30,808,1109,13,35,21,5,21,1204,
20220909,597,598,서여주,북여주,899,30,111,31,2,39,1112,788,8,22,10,4,47,879,
20220909,597,735,서여주,남양평,275,4,2,0,0,9,290,444,2,0,0,0,7,453,
20220909,598,500,북여주,남여주,362,0,2,2,0,15,381,428,3,8,1,1,14,455,
20220909,598,517,북여주,양평,1528,3,2,2,7,54,1596,2974,7,3,8,6,82,3080,
20220909,598,560,북여주,감곡,484,1,0,0,0,10,495,174,0,0,0,0,9,183,
20220909,598,597,북여주,서여주,788,8,22,10,4,47,879,899,30,111,31,2,39,1112,
20220909,598,735,북여주,남양평,814,3,1,1,0,28,847,1070,9,5,0,0,28,1112,
20220909,599,152,양촌,유성,154,1,0,0,0,3,158,615,2,2,0,0,12,631,
20220909,599,153,양촌,서대전,202,0,0,0,0,12,214,737,1,1,0,0,17,756,
20220909,601,101,남천안,서울,351,1,6,2,1,9,370,3278,2,112,13,8,75,3488,
20220909,601,108,남천안,천안,132,6,5,1,3,4,151,1401,3,7,3,10,45,1469,
20220909,601,229,남천안,북천안,119,2,2,5,2,5,135,906,2,5,9,1,32,955,
20220909,603,613,정안,남풍세,2055,13,12,2,23,69,2174,1892,6,12,1,14,55,1980,
20220909,604,613,남공주,남풍세,120,16,2,1,13,2,154,704,1,0,1,7,26,739,
20220909,605,606,탄천,서논산,130,6,0,0,1,5,142,103,6,1,0,1,5,116,
20220909,606,605,서논산,탄천,103,6,1,0,1,5,116,130,6,0,0,1,5,142,
20220909,606,607,서논산,연무,2180,4,10,12,3,53,2262,244,1,4,5,1,8,263,
20220909,606,613,서논산,남풍세,248,0,0,1,4,19,272,423,0,0,0,1,13,437,
20220909,607,606,연무,서논산,244,1,4,5,1,8,263,2180,4,10,12,3,53,2262,
20220909,607,613,연무,남풍세,444,0,5,4,10,20,483,692,1,2,4,9,23,731,
20220909,613,227,남풍세,군산,381,2,3,0,1,11,398,128,1,4,1,6,2,142,
20220909,613,509,남풍세,목포,573,0,3,0,0,13,589,105,0,2,0,5,3,115,
20220909,613,577,남풍세,공주,400,1,0,0,0,13,414,242,5,8,0,0,13,268,
20220909,613,603,남풍세,정안,1892,6,12,1,14,55,1980,2055,13,12,2,23,69,2174,
20220909,613,604,남풍세,남공주,704,1,0,1,7,26,739,120,16,2,1,13,2,154,
20220909,613,606,남풍세,서논산,423,0,0,0,1,13,437,248,0,0,1,4,19,272,
20220909,613,607,남풍세,연무,692,1,2,4,9,23,731,444,0,5,4,10,20,483,
20220909,621,123,동대구,구미,288,1,1,1,4,9,304,257,1,3,2,5,12,280,
20220909,621,125,동대구,남구미,171,1,3,1,7,13,196,228,1,1,1,6,13,250,
20220909,621,126,동대구,왜관,447,13,1,1,2,20,484,365,7,2,2,1,17,394,
20220909,621,127,동대구,서대구,707,8,2,7,6,39,769,1104,15,37,7,9,51,1223,
20220909,621,129,동대구,북대구,526,7,6,1,8,19,567,282,2,1,4,0,14,303,
20220909,621,131,동대구,경산,989,9,1,6,3,61,1069,1658,25,11,3,11,92,1800,
20220909,621,132,동대구,영천,1314,4,11,0,1,40,1370,1057,3,14,0,2,37,1113,
20220909,621,133,동대구,건천,433,4,3,0,0,26,466,296,3,0,0,0,17,316,
20220909,621,135,동대구,경주,1209,1,40,1,0,43,1294,1003,5,38,1,0,37,1084,
20220909,621,201,동대구,칠곡,149,2,1,0,0,8,160,152,2,0,0,0,8,162,
20220909,621,230,동대구,팔공산,158,2,3,4,0,5,172,224,3,8,3,0,9,247,
20220909,621,231,동대구,화원옥포,161,1,0,0,0,9,171,125,1,3,2,0,6,137,
20220909,621,233,동대구,현풍,106,0,0,2,3,4,115,99,1,1,0,3,6,110,
20220909,621,524,동대구,청통와촌,313,7,6,1,0,8,335,240,3,7,3,0,5,258,
20220909,621,525,동대구,북영천,420,0,1,0,0,8,429,232,0,0,0,0,1,233,
20220909,621,527,동대구,포항,805,5,56,0,0,32,898,704,6,63,1,0,18,792,
20220909,621,641,동대구,울산,305,1,21,0,2,9,338,414,0,21,0,0,17,452,
20220909,621,772,동대구,북달성,151,3,6,0,0,7,167,173,1,1,2,1,10,188,
20220909,621,776,동대구,연경,224,1,0,0,0,6,231,466,1,0,0,2,12,481,
20220909,621,779,동대구,율암,96,0,0,0,0,9,105,132,0,0,0,1,8,141,
20220909,623,624,수성,청도,824,8,0,0,1,27,860,875,6,1,4,0,28,914,
20220909,623,625,수성,밀양,573,2,5,0,2,14,596,566,4,9,0,2,19,600,
20220909,623,626,수성,남밀양,659,1,1,4,0,32,697,756,3,6,5,2,33,805,
20220909,623,627,수성,삼랑진,257,2,0,0,0,14,273,340,0,0,0,0,15,355,
20220909,624,623,청도,수성,875,6,1,4,0,28,914,824,8,0,0,1,27,860,
20220909,624,625,청도,밀양,531,4,2,0,1,13,551,412,8,2,0,2,21,445,
20220909,624,626,청도,남밀양,960,8,6,2,3,44,1023,747,3,2,3,4,34,793,
20220909,624,627,청도,삼랑진,298,3,2,1,0,9,313,277,1,3,0,0,11,292,
20220909,625,623,밀양,수성,566,4,9,0,2,19,600,573,2,5,0,2,14,596,
20220909,625,624,밀양,청도,412,8,2,0,2,21,445,531,4,2,0,1,13,551,
20220909,625,626,밀양,남밀양,1439,17,16,5,0,40,1517,1795,17,19,6,6,49,1892,
20220909,625,627,밀양,삼랑진,628,1,4,0,0,28,661,840,4,3,1,0,32,880,
20220909,626,623,남밀양,수성,756,3,6,5,2,33,805,659,1,1,4,0,32,697,
20220909,626,624,남밀양,청도,747,3,2,3,4,34,793,960,8,6,2,3,44,1023,
20220909,626,625,남밀양,밀양,1795,17,19,6,6,49,1892,1439,17,16,5,0,40,1517,
20220909,626,627,남밀양,삼랑진,918,4,1,0,0,80,1003,1398,8,6,2,1,71,1486,
20220909,627,623,삼랑진,수성,340,0,0,0,0,15,355,257,2,0,0,0,14,273,
20220909,627,624,삼랑진,청도,277,1,3,0,0,11,292,298,3,2,1,0,9,313,
20220909,627,625,삼랑진,밀양,840,4,3,1,0,32,880,628,1,4,0,0,28,661,
20220909,627,626,삼랑진,남밀양,1398,8,6,2,1,71,1486,918,4,1,0,0,80,1003,
20220909,641,115,울산,대전,121,0,1,0,1,2,125,123,0,0,0,0,6,129,
20220909,641,123,울산,구미,131,0,3,1,4,6,145,115,0,2,2,1,6,126,
20220909,641,125,울산,남구미,66,0,4,2,38,2,112,126,0,4,2,32,5,169,
20220909,641,127,울산,서대구,353,2,14,1,4,15,389,322,1,26,4,7,14,374,
20220909,641,129,울산,북대구,450,2,6,5,11,13,487,185,1,0,1,2,8,197,
20220909,641,131,울산,경산,200,0,8,1,2,8,219,216,4,11,0,6,16,253,
20220909,641,132,울산,영천,516,1,3,2,5,25,552,200,4,5,4,8,9,230,
20220909,641,133,울산,건천,419,2,3,1,3,16,444,267,2,1,2,3,8,283,
20220909,641,135,울산,경주,488,1,22,1,3,22,537,404,1,24,3,3,19,454,
20220909,641,137,울산,통도사,918,17,18,1,1,46,1001,760,26,10,1,1,38,836,
20220909,641,138,울산,양산,499,16,28,4,1,23,571,412,26,24,3,2,19,486,
20220909,641,139,울산,서울산,1084,8,12,0,7,64,1175,1296,11,14,3,8,82,1414,
20220909,641,140,울산,부산,421,2,2,0,1,17,443,365,3,0,1,0,20,389,
20220909,641,148,울산,서김해,451,1,11,11,5,25,504,356,0,7,14,1,16,394,
20220909,641,149,울산,동김해,338,2,4,0,0,21,365,273,1,3,1,0,26,304,
20220909,641,230,울산,팔공산,198,1,1,0,3,1,204,124,1,1,1,6,4,137,
20220909,641,245,울산,장유,831,2,14,1,2,39,889,478,3,15,3,4,21,524,
20220909,641,250,울산,남양산,535,22,23,4,2,24,610,526,15,25,0,2,27,595,
20220909,641,251,울산,물금,143,15,1,4,1,3,167,107,14,4,4,2,6,137,
20220909,641,252,울산,대동,2188,13,29,1,8,123,2362,1565,8,27,2,12,80,1694,
20220909,641,289,울산,마산,1238,3,18,6,2,36,1303,346,1,22,1,2,14,386,
20220909,641,621,울산,동대구,414,0,21,0,0,17,452,305,1,21,0,2,9,338,
20220909,641,642,울산,문수,203,2,2,1,0,15,223,215,0,1,0,0,21,237,
20220909,641,643,울산,청량,536,3,2,0,3,43,587,686,6,2,1,0,43,738,
20220909,641,644,울산,온양,511,3,0,0,0,30,544,421,1,0,0,0,28,450,
20220909,641,645,울산,장안,435,1,1,1,0,20,458,406,1,0,0,0,23,430,
20220909,641,646,울산,기장일광,432,1,1,0,0,18,452,349,0,1,0,0,26,376,
20220909,641,647,울산,해운대송정,192,2,0,0,0,7,201,131,0,0,0,0,9,140,
20220909,641,648,울산,해운대,1305,1,0,0,0,63,1369,1373,6,2,0,1,58,1440,
20220909,641,706,울산,남경주,1737,2,6,7,12,76,1840,1301,0,5,5,15,66,1392,
20220909,641,707,울산,남포항,2963,11,13,7,45,96,3135,1577,12,9,10,44,74,1726,
20220909,641,708,울산,동경주,307,0,0,0,1,11,319,246,1,0,0,0,11,258,
20220909,641,722,울산,활천,262,2,2,2,1,12,281,163,5,2,2,1,3,176,
20220909,641,747,울산,범서,123,0,1,0,2,4,130,131,0,1,0,0,3,135,
20220909,642,641,문수,울산,215,0,1,0,0,21,237,203,2,2,1,0,15,223,
20220909,642,643,문수,청량,112,1,0,1,9,4,127,154,1,0,0,3,8,166,
20220909,642,644,문수,온양,159,1,0,0,0,6,166,132,1,0,0,0,10,143,
20220909,642,645,문수,장안,218,0,1,1,0,11,231,263,1,0,0,1,19,284,
20220909,642,646,문수,기장일광,229,1,0,0,0,15,245,232,2,1,0,0,13,248,
20220909,642,648,문수,해운대,724,1,0,0,0,39,764,955,1,0,0,1,41,998,
20220909,642,706,문수,남경주,488,1,1,1,2,25,518,321,2,2,2,2,17,346,
20220909,642,707,문수,남포항,870,1,1,2,4,25,903,421,0,2,2,10,14,449,
20220909,642,747,문수,범서,111,1,1,1,1,4,119,100,3,0,1,3,6,113,
20220909,643,252,청량,대동,200,0,1,3,22,23,249,91,1,1,9,7,11,120,
20220909,643,641,청량,울산,686,6,2,1,0,43,738,536,3,2,0,3,43,587,
20220909,643,642,청량,문수,154,1,0,0,3,8,166,112,1,0,1,9,4,127,
20220909,643,645,청량,장안,1046,4,1,2,13,46,1112,854,2,2,6,24,45,933,
20220909,643,646,청량,기장일광,1037,7,1,2,4,66,1117,746,7,1,1,14,43,812,
20220909,643,647,청량,해운대송정,430,1,0,1,4,21,457,306,1,1,0,3,20,331,
20220909,643,648,청량,해운대,3997,4,5,1,11,197,4215,3598,17,45,10,208,203,4081,
20220909,643,706,청량,남경주,225,3,2,4,25,7,266,149,3,2,5,19,3,181,
20220909,643,707,청량,남포항,463,1,2,4,95,12,577,190,1,1,11,79,3,285,
20220909,643,752,청량,기장철마,207,0,0,5,16,22,250,83,0,0,15,8,9,115,
20220909,644,641,온양,울산,421,1,0,0,0,28,450,511,3,0,0,0,30,544,
20220909,644,642,온양,문수,132,1,0,0,0,10,143,159,1,0,0,0,6,166,
20220909,644,645,온양,장안,135,1,0,0,1,8,145,96,1,0,0,0,7,104,
20220909,644,646,온양,기장일광,203,2,0,0,0,18,223,151,3,1,0,0,8,163,
20220909,644,647,온양,해운대송정,111,1,0,0,0,11,123,98,1,0,0,0,9,108,
20220909,644,648,온양,해운대,713,1,0,0,0,43,757,757,4,2,0,14,43,820,
20220909,644,707,온양,남포항,175,1,1,1,4,12,194,116,0,0,5,5,8,134,
20220909,645,641,장안,울산,406,1,0,0,0,23,430,435,1,1,1,0,20,458,
20220909,645,642,장안,문수,263,1,0,0,1,19,284,218,0,1,1,0,11,231,
20220909,645,643,장안,청량,854,2,2,6,24,45,933,1046,4,1,2,13,46,1112,
20220909,645,644,장안,온양,96,1,0,0,0,7,104,135,1,0,0,1,8,145,
20220909,645,647,장안,해운대송정,353,0,6,0,0,22,381,540,2,4,0,0,31,577,
20220909,645,648,장안,해운대,1254,3,7,0,0,60,1324,2905,9,9,2,5,126,3056,
20220909,645,706,장안,남경주,155,0,1,0,0,4,160,146,1,0,0,0,4,151,
20220909,645,707,장안,남포항,366,2,0,0,0,15,383,270,1,1,2,1,14,289,
20220909,646,641,기장일광,울산,349,0,1,0,0,26,376,432,1,1,0,0,18,452,
20220909,646,642,기장일광,문수,232,2,1,0,0,13,248,229,1,0,0,0,15,245,
20220909,646,643,기장일광,청량,746,7,1,1,14,43,812,1037,7,1,2,4,66,1117,
20220909,646,644,기장일광,온양,151,3,1,0,0,8,163,203,2,0,0,0,18,223,
20220909,646,647,기장일광,해운대송정,962,2,4,2,1,48,1019,588,0,8,2,6,25,629,
20220909,646,648,기장일광,해운대,4874,3,6,1,4,241,5129,5370,10,6,1,37,251,5675,
20220909,646,706,기장일광,남경주,169,1,0,0,0,6,176,103,1,0,0,0,7,111,
20220909,646,707,기장일광,남포항,333,2,2,0,1,19,357,271,0,2,0,0,9,282,
20220909,647,641,해운대송정,울산,131,0,0,0,0,9,140,192,2,0,0,0,7,201,
20220909,647,643,해운대송정,청량,306,1,1,0,3,20,331,430,1,0,1,4,21,457,
20220909,647,644,해운대송정,온양,98,1,0,0,0,9,108,111,1,0,0,0,11,123,
20220909,647,645,해운대송정,장안,540,2,4,0,0,31,577,353,0,6,0,0,22,381,
20220909,647,646,해운대송정,기장일광,588,0,8,2,6,25,629,962,2,4,2,1,48,1019,
20220909,647,707,해운대송정,남포항,198,0,0,0,0,1,199,146,0,0,0,0,4,150,
20220909,648,641,해운대,울산,1373,6,2,0,1,58,1440,1305,1,0,0,0,63,1369,
20220909,648,642,해운대,문수,955,1,0,0,1,41,998,724,1,0,0,0,39,764,
20220909,648,643,해운대,청량,3598,17,45,10,208,203,4081,3997,4,5,1,11,197,4215,
20220909,648,644,해운대,온양,757,4,2,0,14,43,820,713,1,0,0,0,43,757,
20220909,648,645,해운대,장안,2905,9,9,2,5,126,3056,1254,3,7,0,0,60,1324,
20220909,648,646,해운대,기장일광,5370,10,6,1,37,251,5675,4874,3,6,1,4,241,5129,
20220909,648,706,해운대,남경주,752,0,1,0,2,23,778,363,0,0,0,0,13,376,
20220909,648,707,해운대,남포항,2001,5,24,3,54,65,2152,1175,3,6,0,2,42,1228,
20220909,651,652,남양주,화도,6849,76,186,123,30,431,7695,6676,73,183,158,21,337,7448,
20220909,651,653,남양주,서종,2298,5,1,0,2,99,2405,2236,8,3,1,1,99,2348,
20220909,651,654,남양주,설악,5103,9,37,8,1,182,5340,3211,8,39,6,1,115,3380,
20220909,651,655,남양주,강촌,3073,16,81,6,11,113,3300,2456,11,80,2,9,76,2634,
20220909,651,656,남양주,남춘천,3662,11,32,10,8,115,3838,2174,6,20,6,8,65,2279,
20220909,652,651,화도,남양주,6676,73,183,158,21,337,7448,6849,76,186,123,30,431,7695,
20220909,652,653,화도,서종,1242,9,2,2,1,61,1317,1339,13,4,4,2,68,1430,
20220909,652,654,화도,설악,1160,4,2,1,1,49,1217,1000,5,3,0,0,56,1064,
20220909,652,655,화도,강촌,698,4,4,0,0,21,727,565,8,3,2,0,22,600,
20220909,652,656,화도,남춘천,784,5,3,1,1,29,823,531,0,4,3,4,24,566,
20220909,653,651,서종,남양주,2236,8,3,1,1,99,2348,2298,5,1,0,2,99,2405,
20220909,653,652,서종,화도,1339,13,4,4,2,68,1430,1242,9,2,2,1,61,1317,
20220909,653,654,서종,설악,476,1,0,0,0,16,493,249,1,0,0,1,10,261,
20220909,654,651,설악,남양주,3211,8,39,6,1,115,3380,5103,9,37,8,1,182,5340,
20220909,654,652,설악,화도,1000,5,3,0,0,56,1064,1160,4,2,1,1,49,1217,
20220909,654,653,설악,서종,249,1,0,0,1,10,261,476,1,0,0,0,16,493,
20220909,654,655,설악,강촌,787,3,2,2,0,21,815,270,3,1,2,1,13,290,
20220909,654,656,설악,남춘천,740,1,1,0,0,17,759,125,1,1,0,0,8,135,
20220909,655,651,강촌,남양주,2456,11,80,2,9,76,2634,3073,16,81,6,11,113,3300,
20220909,655,652,강촌,화도,565,8,3,2,0,22,600,698,4,4,0,0,21,727,
20220909,655,654,강촌,설악,270,3,1,2,1,13,290,787,3,2,2,0,21,815,
20220909,656,651,남춘천,남양주,2174,6,20,6,8,65,2279,3662,11,32,10,8,115,3838,
20220909,656,652,남춘천,화도,531,0,4,3,4,24,566,784,5,3,1,1,29,823,
20220909,656,654,남춘천,설악,125,1,1,0,0,8,135,740,1,1,0,0,17,759,
20220909,671,106,봉담,오산,436,12,12,3,1,13,477,250,20,8,1,1,21,301,
20220909,671,107,봉담,안성,256,1,6,0,0,13,276,414,3,8,0,0,23,448,
20220909,671,108,봉담,천안,353,1,17,1,0,19,391,408,0,22,0,0,22,452,
20220909,671,111,봉담,청주,138,0,10,0,1,4,153,219,0,12,0,0,15,246,
20220909,671,115,봉담,대전,111,0,12,0,0,2,125,116,0,14,0,0,5,135,
20220909,671,543,봉담,남안성,123,4,3,6,1,5,142,272,1,3,5,1,17,299,
20220909,671,555,봉담,북진천,172,3,1,0,0,9,185,159,5,0,1,0,12,177,
20220909,671,672,봉담,정남,3646,27,9,4,15,111,3812,1497,21,9,5,7,92,1631,
20220909,671,673,봉담,북오산,1510,12,12,15,4,77,1630,1762,15,19,14,3,84,1897,
20220909,671,675,봉담,서오산,461,7,1,0,2,35,506,602,5,0,1,5,31,644,
20220909,671,676,봉담,향남,1183,25,8,4,4,63,1287,605,34,8,1,1,43,692,
20220909,671,677,봉담,북평택,17795,25,34,32,22,679,18587,8810,43,45,22,16,414,9350,
20220909,672,671,정남,봉담,1497,21,9,5,7,92,1631,3646,27,9,4,15,111,3812,
20220909,672,673,정남,북오산,180,2,0,0,0,7,189,723,2,2,3,2,19,751,
20220909,672,677,정남,북평택,191,0,3,1,0,9,204,544,9,9,1,2,36,601,
20220909,673,101,북오산,서울,1147,7,81,10,1,57,1303,1541,13,77,12,1,65,1709,
20220909,673,103,북오산,수원신갈,210,2,2,0,1,8,223,234,2,1,0,1,8,246,
20220909,673,107,북오산,안성,345,1,1,1,0,29,377,485,6,1,2,0,47,541,
20220909,673,108,북오산,천안,411,2,1,0,1,17,432,401,3,0,0,0,23,427,
20220909,673,111,북오산,청주,101,0,2,0,0,5,108,141,1,0,0,0,4,146,
20220909,673,528,북오산,기흥동탄,117,5,0,0,0,8,130,309,5,3,3,0,11,331,
20220909,673,543,북오산,남안성,116,8,0,3,0,9,136,227,6,3,4,1,13,254,
20220909,673,555,북오산,북진천,162,2,2,1,0,5,172,154,3,3,1,0,6,167,
20220909,673,671,북오산,봉담,1762,15,19,14,3,84,1897,1510,12,12,15,4,77,1630,
20220909,673,672,북오산,정남,723,2,2,3,2,19,751,180,2,0,0,0,7,189,
20220909,673,675,북오산,서오산,261,1,1,1,0,9,273,171,0,2,1,1,3,178,
20220909,673,676,북오산,향남,509,6,3,0,0,22,540,385,2,1,1,2,17,408,
20220909,673,677,북오산,북평택,2308,8,8,7,5,84,2420,1461,16,16,3,5,105,1606,
20220909,673,876,북오산,양감,124,4,0,0,0,3,131,167,4,3,2,1,5,182,
20220909,675,671,서오산,봉담,602,5,0,1,5,31,644,461,7,1,0,2,35,506,
20220909,675,673,서오산,북오산,171,0,2,1,1,3,178,261,1,1,1,0,9,273,
20220909,675,676,서오산,향남,2919,37,16,6,24,102,3104,1336,22,21,7,23,68,1477,
20220909,675,677,서오산,북평택,16875,39,61,24,33,456,17488,7608,57,98,15,33,390,8201,
20220909,675,876,서오산,양감,403,9,0,3,1,25,441,424,14,2,4,6,25,475,
20220909,676,671,향남,봉담,605,34,8,1,1,43,692,1183,25,8,4,4,63,1287,
20220909,676,673,향남,북오산,385,2,1,1,2,17,408,509,6,3,0,0,22,540,
20220909,676,675,향남,서오산,1336,22,21,7,23,68,1477,2919,37,16,6,24,102,3104,
20220909,676,677,향남,북평택,3074,39,10,19,16,82,3240,733,32,18,18,15,42,858,
20220909,677,101,북평택,서울,1264,7,137,8,11,65,1492,3780,14,83,16,21,132,4046,
20220909,677,103,북평택,수원신갈,320,1,1,3,0,14,339,517,2,0,1,0,24,544,
20220909,677,528,북평택,기흥동탄,107,1,3,8,17,5,141,242,3,4,1,19,9,278,
20220909,677,671,북평택,봉담,8810,43,45,22,16,414,9350,17795,25,34,32,22,679,18587,
20220909,677,672,북평택,정남,544,9,9,1,2,36,601,191,0,3,1,0,9,204,
20220909,677,673,북평택,북오산,1461,16,16,3,5,105,1606,2308,8,8,7,5,84,2420,
20220909,677,675,북평택,서오산,7608,57,98,15,33,390,8201,16875,39,61,24,33,456,17488,
20220909,677,676,북평택,향남,733,32,18,18,15,42,858,3074,39,10,19,16,82,3240,
20220909,677,876,북평택,양감,1922,22,12,8,14,95,2073,8784,20,7,13,10,266,9100,
20220909,682,683,조암,송산마도,405,15,6,5,2,20,453,452,9,5,2,1,24,493,
20220909,682,684,조암,남안산,552,17,21,10,29,57,686,880,18,9,4,21,33,965,
20220909,682,685,조암,서시흥,1770,26,25,24,50,137,2032,3469,10,13,18,49,139,3698,
20220909,683,682,송산마도,조암,452,9,5,2,1,24,493,405,15,6,5,2,20,453,
20220909,683,684,송산마도,남안산,1585,14,12,7,8,95,1721,2015,12,7,8,6,108,2156,
20220909,683,685,송산마도,서시흥,3744,26,41,20,26,205,4062,4327,22,32,16,19,227,4643,
20220909,684,682,남안산,조암,880,18,9,4,21,33,965,552,17,21,10,29,57,686,
20220909,684,683,남안산,송산마도,2015,12,7,8,6,108,2156,1585,14,12,7,8,95,1721,
20220909,684,685,남안산,서시흥,2095,92,67,141,106,118,2619,3902,61,51,100,60,218,4392,
20220909,685,520,서시흥,평택,109,0,0,0,0,3,112,3910,16,50,39,59,173,4247,
20220909,685,682,서시흥,조암,3469,10,13,18,49,139,3698,1770,26,25,24,50,137,2032,
20220909,685,683,서시흥,송산마도,4327,22,32,16,19,227,4643,3744,26,41,20,26,205,4062,
20220909,685,684,서시흥,남안산,3902,61,51,100,60,218,4392,2095,92,67,141,106,118,2619,
20220909,701,174,북양양,춘천,211,0,0,0,0,10,221,284,0,3,1,0,14,302,
20220909,701,189,북양양,강릉,281,7,1,0,1,17,307,331,8,0,0,0,20,359,
20220909,701,284,북양양,남양양,227,0,0,0,1,5,233,236,5,0,1,0,10,252,
20220909,701,510,북양양,양양,215,2,0,0,0,11,228,300,2,7,0,0,11,320,
20220909,701,554,북양양,동홍천,362,2,0,0,0,11,375,640,0,5,0,0,28,673,
20220909,701,580,북양양,북강릉,404,5,1,0,1,6,417,393,6,1,0,1,15,416,
20220909,701,585,북양양,하조대,121,0,0,0,0,7,128,127,3,0,0,0,3,133,
20220909,701,702,북양양,속초,205,3,0,0,1,11,220,537,1,2,0,0,18,558,
20220909,701,704,북양양,근덕,173,0,0,2,0,4,179,235,0,1,2,0,9,247,
20220909,701,766,북양양,인제,101,3,0,0,0,2,106,104,1,0,0,0,1,106,
20220909,702,174,속초,춘천,209,2,7,0,1,7,226,340,0,0,0,0,17,357,
20220909,702,189,속초,강릉,419,11,4,0,2,26,462,507,11,6,0,1,25,550,
20220909,702,284,속초,남양양,331,5,0,2,0,12,350,320,4,1,0,0,16,341,
20220909,702,510,속초,양양,424,2,0,0,0,11,437,523,3,1,0,0,17,544,
20220909,702,554,속초,동홍천,400,5,3,3,0,13,424,620,7,2,1,1,16,647,
20220909,702,580,속초,북강릉,531,19,2,0,1,22,575,572,9,2,0,0,25,608,
20220909,702,583,속초,동해,138,0,0,0,1,9,148,165,1,0,1,3,4,174,
20220909,702,585,속초,하조대,296,3,4,0,0,8,311,261,3,0,0,0,8,272,
20220909,702,701,속초,북양양,537,1,2,0,0,18,558,205,3,0,0,1,11,220,
20220909,702,703,속초,삼척,124,0,1,1,0,3,129,104,0,0,2,0,4,110,
20220909,702,704,속초,근덕,238,1,1,0,0,6,246,443,1,1,0,0,9,454,
20220909,703,189,삼척,강릉,411,11,9,0,1,24,456,664,4,4,0,0,29,701,
20220909,703,580,삼척,북강릉,194,2,0,0,1,10,207,161,0,1,0,0,5,167,
20220909,703,581,삼척,옥계,196,2,0,4,9,8,219,219,0,0,0,1,13,233,
20220909,703,582,삼척,망상,222,1,1,0,0,6,230,180,0,0,0,0,6,186,
20220909,703,583,삼척,동해,674,2,58,0,0,38,772,660,1,60,1,1,33,756,
20220909,703,584,삼척,남강릉,514,2,4,0,1,27,548,645,4,3,1,1,40,694,
20220909,703,585,삼척,하조대,101,1,0,0,0,2,104,105,1,1,0,0,6,113,
20220909,703,702,삼척,속초,104,0,0,2,0,4,110,124,0,1,1,0,3,129,
20220909,703,704,삼척,근덕,754,7,0,0,2,25,788,682,6,2,0,3,26,719,
20220909,704,189,근덕,강릉,679,8,11,0,2,20,720,636,8,9,0,0,28,681,
20220909,704,580,근덕,북강릉,362,3,3,2,2,15,387,216,2,5,2,0,9,234,
20220909,704,581,근덕,옥계,299,0,1,0,10,8,318,208,0,1,1,17,11,238,
20220909,704,582,근덕,망상,251,1,2,0,1,4,259,165,1,0,0,2,8,176,
20220909,704,583,근덕,동해,1514,5,18,1,21,73,1632,1403,6,20,2,24,89,1544,
20220909,704,584,근덕,남강릉,806,6,0,0,5,29,846,683,2,5,0,3,22,715,
20220909,704,585,근덕,하조대,271,0,1,0,0,6,278,178,0,1,0,0,5,184,
20220909,704,701,근덕,북양양,235,0,1,2,0,9,247,173,0,0,2,0,4,179,
20220909,704,702,근덕,속초,443,1,1,0,0,9,454,238,1,1,0,0,6,246,
20220909,704,703,근덕,삼척,682,6,2,0,3,26,719,754,7,0,0,2,25,788,
20220909,705,101,남이천,서울,172,6,4,0,0,4,186,146,0,2,0,0,1,149,
20220909,705,190,남이천,동서울,1019,37,12,9,9,27,1113,1424,15,13,19,2,28,1501,
20220909,705,192,남이천,곤지암,359,8,5,3,2,10,387,307,7,5,1,1,10,331,
20220909,705,193,남이천,일죽,687,3,8,8,2,19,727,206,3,9,3,6,10,237,
20220909,706,641,남경주,울산,1301,0,5,5,15,66,1392,1737,2,6,7,12,76,1840,
20220909,706,642,남경주,문수,321,2,2,2,2,17,346,488,1,1,1,2,25,518,
20220909,706,643,남경주,청량,149,3,2,5,19,3,181,225,3,2,4,25,7,266,
20220909,706,645,남경주,장안,146,1,0,0,0,4,151,155,0,1,0,0,4,160,
20220909,706,646,남경주,기장일광,103,1,0,0,0,7,111,169,1,0,0,0,6,176,
20220909,706,648,남경주,해운대,363,0,0,0,0,13,376,752,0,1,0,2,23,778,
20220909,706,707,남경주,남포항,2370,17,24,4,25,86,2526,1572,20,27,9,20,78,1726,
20220909,706,708,남경주,동경주,516,2,2,0,0,23,543,455,5,1,0,0,21,482,
20220909,706,747,남경주,범서,207,1,0,1,1,18,228,329,4,0,3,0,18,354,
20220909,707,252,남포항,대동,110,0,0,0,18,8,136,368,1,2,1,13,22,407,
20220909,707,641,남포항,울산,1577,12,9,10,44,74,1726,2963,11,13,7,45,96,3135,
20220909,707,642,남포항,문수,421,0,2,2,10,14,449,870,1,1,2,4,25,903,
20220909,707,643,남포항,청량,190,1,1,11,79,3,285,463,1,2,4,95,12,577,
20220909,707,644,남포항,온양,116,0,0,5,5,8,134,175,1,1,1,4,12,194,
20220909,707,645,남포항,장안,270,1,1,2,1,14,289,366,2,0,0,0,15,383,
20220909,707,646,남포항,기장일광,271,0,2,0,0,9,282,333,2,2,0,1,19,357,
20220909,707,647,남포항,해운대송정,146,0,0,0,0,4,150,198,0,0,0,0,1,199,
20220909,707,648,남포항,해운대,1175,3,6,0,2,42,1228,2001,5,24,3,54,65,2152,
20220909,707,706,남포항,남경주,1572,20,27,9,20,78,1726,2370,17,24,4,25,86,2526,
20220909,707,708,남포항,동경주,2040,11,9,4,7,78,2149,2712,15,11,7,2,105,2852,
20220909,707,747,남포항,범서,211,1,3,1,1,7,224,457,0,1,1,1,14,474,
20220909,708,641,동경주,울산,246,1,0,0,0,11,258,307,0,0,0,1,11,319,
20220909,708,706,동경주,남경주,455,5,1,0,0,21,482,516,2,2,0,0,23,543,
20220909,708,707,동경주,남포항,2712,15,11,7,2,105,2852,2040,11,9,4,7,78,2149,
20220909,712,207,동상주,남안동,648,1,2,0,4,21,676,297,3,3,2,1,10,316,
20220909,712,713,동상주,서의성,646,3,1,0,2,18,670,258,1,2,2,2,9,274,
20220909,712,749,동상주,영덕,789,5,1,1,0,19,815,165,4,0,0,0,2,171,
20220909,713,207,서의성,남안동,148,1,2,2,0,7,160,179,1,3,1,0,10,194,
20220909,713,712,서의성,동상주,258,1,2,2,2,9,274,646,3,1,0,2,18,670,
20220909,714,208,북의성,서안동,245,2,3,0,2,8,260,113,1,2,2,0,4,122,
20220909,714,749,북의성,영덕,584,1,2,0,0,20,607,132,0,0,0,0,4,136,
20220909,715,716,동안동,청송,1182,6,3,2,2,37,1232,838,10,7,1,3,37,896,
20220909,715,748,동안동,동청송영양,403,0,0,1,0,8,412,184,0,0,0,0,4,188,
20220909,715,749,동안동,영덕,1299,4,26,1,0,52,1382,791,3,21,3,0,33,851,
20220909,716,127,청송,서대구,155,0,0,0,0,1,156,293,0,0,0,0,11,304,
20220909,716,715,청송,동안동,838,10,7,1,3,37,896,1182,6,3,2,2,37,1232,
20220909,716,748,청송,동청송영양,235,1,1,0,0,5,242,159,2,0,0,0,4,165,
20220909,716,749,청송,영덕,615,1,3,0,0,24,643,322,0,1,0,0,12,335,
20220909,716,775,청송,동명동호,166,0,0,0,0,1,167,189,0,0,0,0,4,193,
20220909,722,140,활천,부산,192,12,2,0,0,8,214,297,3,1,0,0,20,321,
20220909,722,252,활천,대동,137,3,2,7,4,4,157,250,4,1,5,9,6,275,
20220909,722,641,활천,울산,163,5,2,2,1,3,176,262,2,2,2,1,12,281,
20220909,723,120,북구미,황간,149,0,0,0,0,6,155,102,0,0,0,0,3,105,
20220909,723,122,북구미,김천,424,2,0,0,0,18,444,407,3,0,0,0,17,427,
20220909,723,123,북구미,구미,153,3,1,0,0,12,169,146,3,0,0,0,10,159,
20220909,723,125,북구미,남구미,242,5,0,0,0,10,257,226,5,0,0,0,11,242,
20220909,723,127,북구미,서대구,339,3,0,0,0,18,360,299,1,0,0,0,10,310,
20220909,723,129,북구미,북대구,364,0,0,0,0,13,377,336,1,2,1,0,12,352,
20220909,723,130,북구미,동김천,606,4,1,0,0,24,635,525,4,2,0,0,18,549,
20220909,725,129,임고,북대구,176,0,0,0,0,5,181,194,0,0,0,0,2,196,
20220909,725,230,임고,팔공산,138,0,0,0,0,3,141,305,0,0,0,0,6,311,
20220909,730,123,유천,구미,157,0,0,0,0,8,165,155,0,0,0,0,6,161,
20220909,730,126,유천,왜관,166,2,0,0,0,4,172,186,5,0,0,0,1,192,
20220909,730,129,유천,북대구,295,1,1,0,0,8,305,293,1,0,0,0,11,305,
20220909,730,132,유천,영천,123,0,0,0,0,2,125,110,0,0,0,0,3,113,
20220909,730,135,유천,경주,121,0,0,0,0,6,127,156,1,0,0,0,5,162,
20220909,730,201,유천,칠곡,912,3,0,0,0,29,944,734,2,0,0,0,38,774,
20220909,730,203,유천,가산,220,0,0,0,0,10,230,487,1,2,0,0,11,501,
20220909,730,205,유천,군위,101,1,1,0,0,3,106,127,1,0,0,0,1,129,
20220909,730,206,유천,의성,171,0,0,0,0,9,180,106,0,0,0,0,3,109,
20220909,730,207,유천,남안동,100,0,0,0,0,2,102,110,0,0,0,0,4,114,
20220909,730,230,유천,팔공산,242,0,0,0,0,7,249,300,0,0,0,0,12,312,
20220909,730,519,유천,남대구,2352,10,2,0,0,126,2490,2192,14,4,0,0,113,2323,
20220909,730,524,유천,청통와촌,106,3,0,0,0,2,111,117,5,0,0,2,3,127,
20220909,730,525,유천,북영천,180,0,0,0,0,2,182,120,0,0,0,0,3,123,
20220909,730,527,유천,포항,247,0,0,0,0,7,254,243,0,0,0,0,9,252,
20220909,731,201,북현풍,칠곡,229,0,0,0,0,3,232,186,0,0,0,0,5,191,
20220909,731,519,북현풍,남대구,1383,4,1,0,0,76,1464,1582,3,8,0,0,78,1671,
20220909,732,287,행담도,송악,195,2,4,0,2,17,220,219,4,4,0,2,19,248,
20220909,732,288,행담도,당진,92,4,1,0,0,3,100,113,1,1,0,0,3,118,
20220909,733,101,옥산,서울,160,2,3,0,0,2,167,191,1,15,0,0,3,210,
20220909,733,108,옥산,천안,141,1,0,0,0,3,145,218,2,0,1,0,7,228,
20220909,735,500,남양평,남여주,485,0,0,0,0,9,494,198,0,0,0,0,6,204,
20220909,735,517,남양평,양평,431,1,1,0,0,20,453,196,0,0,0,0,8,204,
20220909,735,597,남양평,서여주,444,2,0,0,0,7,453,275,4,2,0,0,9,290,
20220909,735,598,남양평,북여주,1070,9,5,0,0,28,1112,814,3,1,1,0,28,847,
20220909,736,190,삼성,동서울,258,3,0,0,0,12,273,330,3,0,0,0,14,347,
20220909,741,101,평택고덕,서울,292,1,11,1,0,21,326,157,0,9,0,0,8,174,
20220909,741,107,평택고덕,안성,202,0,0,0,0,16,218,109,0,0,1,1,7,118,
20220909,741,253,평택고덕,서서울,713,6,1,3,2,53,778,723,3,1,0,1,37,765,
20220909,741,254,평택고덕,군자,128,1,0,0,0,6,135,129,0,0,0,0,8,137,
20220909,741,520,평택고덕,평택,658,6,38,1,4,37,744,1855,9,18,1,5,57,1945,
20220909,741,528,평택고덕,기흥동탄,173,0,66,0,0,3,242,188,0,55,1,0,1,245,
20220909,741,540,평택고덕,청북,667,5,15,15,4,32,738,1658,4,5,11,4,51,1733,
20220909,741,543,평택고덕,남안성,170,0,0,0,1,4,175,84,4,1,4,5,5,103,
20220909,741,742,평택고덕,남사진위,121,1,8,2,0,6,138,167,0,9,2,0,3,181,
20220909,742,107,남사진위,안성,1220,13,31,15,1,49,1329,657,25,29,15,2,34,762,
20220909,742,108,남사진위,천안,2483,19,10,15,2,62,2591,431,11,7,11,3,21,484,
20220909,742,111,남사진위,청주,189,1,3,4,2,6,205,115,1,7,3,0,2,128,
20220909,742,541,남사진위,송탄,196,4,3,3,0,13,219,101,2,0,7,4,5,119,
20220909,742,542,남사진위,서안성,200,2,5,22,2,14,245,413,10,7,28,2,33,493,
20220909,742,543,남사진위,남안성,462,3,0,4,0,22,491,157,4,5,7,1,3,177,
20220909,742,555,남사진위,북진천,452,5,2,8,1,14,482,114,5,8,11,3,5,146,
20220909,742,741,남사진위,평택고덕,167,0,9,2,0,3,181,121,1,8,2,0,6,138,
20220909,747,641,범서,울산,131,0,1,0,0,3,135,123,0,1,0,2,4,130,
20220909,747,642,범서,문수,100,3,0,1,3,6,113,111,1,1,1,1,4,119,
20220909,747,706,범서,남경주,329,4,0,3,0,18,354,207,1,0,1,1,18,228,
20220909,747,707,범서,남포항,457,0,1,1,1,14,474,211,1,3,1,1,7,224,
20220909,748,127,동청송영양,서대구,99,3,0,0,0,2,104,301,1,1,0,0,9,312,
20220909,748,715,동청송영양,동안동,184,0,0,0,0,4,188,403,0,0,1,0,8,412,
20220909,748,716,동청송영양,청송,159,2,0,0,0,4,165,235,1,1,0,0,5,242,
20220909,748,749,동청송영양,영덕,824,1,4,2,0,24,855,1403,3,2,1,1,35,1445,
20220909,748,775,동청송영양,동명동호,98,0,2,0,0,3,103,196,0,1,0,0,4,201,
20220909,749,127,영덕,서대구,148,2,2,1,1,5,159,364,1,0,0,0,10,375,
20220909,749,203,영덕,가산,165,1,0,2,2,13,183,460,3,1,1,1,15,481,
20220909,749,712,영덕,동상주,165,4,0,0,0,2,171,789,5,1,1,0,19,815,
20220909,749,714,영덕,북의성,132,0,0,0,0,4,136,584,1,2,0,0,20,607,
20220909,749,715,영덕,동안동,791,3,21,3,0,33,851,1299,4,26,1,0,52,1382,
20220909,749,716,영덕,청송,322,0,1,0,0,12,335,615,1,3,0,0,24,643,
20220909,749,748,영덕,동청송영양,1403,3,2,1,1,35,1445,824,1,4,2,0,24,855,
20220909,749,775,영덕,동명동호,108,0,0,0,0,2,110,179,0,0,0,0,2,181,
20220909,752,250,기장철마,남양산,321,4,2,0,0,21,348,250,1,8,0,0,14,273,
20220909,752,252,기장철마,대동,2162,10,9,4,7,132,2324,1671,14,8,6,27,97,1823,
20220909,752,289,기장철마,마산,526,2,1,1,1,26,557,248,1,2,0,3,10,264,
20220909,752,643,기장철마,청량,83,0,0,15,8,9,115,207,0,0,5,16,22,250,
20220909,752,753,기장철마,금정,502,5,5,0,1,39,552,456,2,4,0,2,51,515,
20220909,752,755,기장철마,광재,251,0,3,0,2,14,270,214,2,3,0,1,9,229,
20220909,752,757,기장철마,진영,178,1,1,2,0,9,191,96,1,1,2,0,8,108,
20220909,753,146,금정,동창원,161,0,0,0,1,9,171,117,0,0,0,0,7,124,
20220909,753,252,금정,대동,871,10,9,10,11,41,952,1595,15,19,17,41,80,1767,
20220909,753,289,금정,마산,388,0,6,0,1,10,405,271,1,9,0,1,8,290,
20220909,753,752,금정,기장철마,456,2,4,0,2,51,515,502,5,5,0,1,39,552,
20220909,753,755,금정,광재,190,1,1,0,0,12,204,254,4,2,0,3,8,271,
20220909,753,757,금정,진영,145,1,0,0,0,8,154,133,4,0,0,0,4,141,
20220909,754,754,김해가야휴게소,김해가야휴게소,97,0,0,0,0,9,106,97,0,0,0,0,9,106,
20220909,755,135,광재,경주,150,4,0,1,1,1,157,94,0,0,1,2,3,100,
20220909,755,138,광재,양산,112,3,5,1,0,6,127,108,4,4,0,0,2,118,
20220909,755,140,광재,부산,837,6,3,0,1,51,898,985,7,11,0,0,42,1045,
20220909,755,146,광재,동창원,204,17,1,2,2,6,232,96,10,1,2,0,7,116,
20220909,755,250,광재,남양산,329,6,0,0,2,20,357,267,0,1,0,1,16,285,
20220909,755,251,광재,물금,321,6,1,0,0,14,342,301,9,5,0,0,19,334,
20220909,755,252,광재,대동,1453,13,11,6,5,76,1564,1707,12,8,6,9,85,1827,
20220909,755,289,광재,마산,333,13,8,7,1,10,372,258,8,11,9,0,9,295,
20220909,755,752,광재,기장철마,214,2,3,0,1,9,229,251,0,3,0,2,14,270,
20220909,755,753,광재,금정,254,4,2,0,3,8,271,190,1,1,0,0,12,204,
20220909,755,756,광재,한림,90,6,4,0,0,10,110,93,4,6,1,0,9,113,
20220909,755,757,광재,진영,244,15,8,14,0,23,304,210,12,14,16,1,18,271,
20220909,756,140,한림,부산,268,1,3,3,0,7,282,332,3,5,2,0,9,351,
20220909,756,252,한림,대동,590,8,4,9,6,32,649,554,4,2,3,1,31,595,
20220909,756,755,한림,광재,93,4,6,1,0,9,113,90,6,4,0,0,10,110,
20220909,757,140,진영,부산,489,2,4,9,0,27,531,735,4,3,6,0,31,779,
20220909,757,250,진영,남양산,152,5,1,2,1,7,168,211,3,0,2,0,10,226,
20220909,757,251,진영,물금,153,9,1,2,0,5,170,240,9,2,2,0,7,260,
20220909,757,252,진영,대동,604,5,3,0,3,38,653,587,7,4,0,2,39,639,
20220909,757,289,진영,마산,649,13,7,2,3,26,700,404,6,9,2,8,26,455,
20220909,757,752,진영,기장철마,96,1,1,2,0,8,108,178,1,1,2,0,9,191,
20220909,757,753,진영,금정,133,4,0,0,0,4,141,145,1,0,0,0,8,154,
20220909,757,755,진영,광재,210,12,14,16,1,18,271,244,15,8,14,0,23,304,
20220909,765,174,내촌,춘천,105,1,0,0,1,6,113,145,0,0,0,0,11,156,
20220909,765,554,내촌,동홍천,211,3,0,0,0,15,229,264,4,1,1,0,13,283,
20220909,766,174,인제,춘천,160,1,0,0,0,7,168,213,1,0,0,0,10,224,
20220909,766,510,인제,양양,187,2,0,0,0,12,201,150,1,0,0,1,8,160,
20220909,766,554,인제,동홍천,266,2,3,2,0,17,290,422,4,0,1,0,12,439,
20220909,766,701,인제,북양양,104,1,0,0,0,1,106,101,3,0,0,0,2,106,
20220909,766,766,인제,인제,143,2,0,0,0,8,153,143,2,0,0,0,8,153,
20220909,771,137,배내골,통도사,96,1,0,0,0,4,101,114,1,0,0,0,8,123,
20220909,771,139,배내골,서울산,109,0,1,1,0,9,120,126,0,1,0,0,10,137,
20220909,771,140,배내골,부산,102,0,0,0,0,5,107,171,1,0,0,0,15,187,
20220909,772,123,북달성,구미,449,1,8,5,2,17,482,402,1,9,3,0,18,433,
20220909,772,125,북달성,남구미,273,4,10,5,1,20,313,330,3,7,1,1,21,363,
20220909,772,126,북달성,왜관,452,13,9,6,2,29,511,427,19,4,8,3,30,491,
20220909,772,129,북달성,북대구,527,0,3,0,0,25,555,389,2,0,1,1,25,418,
20220909,772,131,북달성,경산,116,3,4,0,0,2,125,132,8,3,5,1,7,156,
20220909,772,230,북달성,팔공산,131,0,3,0,0,7,141,119,2,1,0,0,3,125,
20220909,772,518,북달성,칠곡물류,73,3,9,22,3,7,117,79,4,9,28,2,5,127,
20220909,772,527,북달성,포항,148,0,10,1,0,2,161,85,2,9,2,0,3,101,
20220909,772,621,북달성,동대구,173,1,1,2,1,10,188,151,3,6,0,0,7,167,
20220909,772,773,북달성,북다사,264,0,0,1,2,16,283,225,2,0,0,2,9,238,
20220909,772,774,북달성,남칠곡,2658,14,15,7,6,94,2794,2492,9,13,13,6,92,2625,
20220909,773,123,북다사,구미,143,0,0,0,0,7,150,113,2,0,0,0,6,121,
20220909,773,126,북다사,왜관,163,2,1,1,0,4,171,132,5,1,0,0,2,140,
20220909,773,129,북다사,북대구,395,1,2,1,0,17,416,133,0,1,1,0,10,145,
20220909,773,772,북다사,북달성,225,2,0,0,2,9,238,264,0,0,1,2,16,283,
20220909,773,774,북다사,남칠곡,1402,2,0,0,0,61,1465,1031,4,0,0,0,41,1076,
20220909,774,123,남칠곡,구미,448,2,3,0,5,18,476,396,2,2,1,2,6,409,
20220909,774,125,남칠곡,남구미,323,3,1,1,5,17,350,282,3,2,0,5,14,306,
20220909,774,126,남칠곡,왜관,658,8,4,2,1,33,706,500,7,3,2,2,16,530,
20220909,774,127,남칠곡,서대구,236,1,5,0,1,14,257,461,0,4,0,0,12,477,
20220909,774,130,남칠곡,동김천,225,0,0,2,1,2,230,134,1,0,2,5,4,146,
20220909,774,518,남칠곡,칠곡물류,92,8,24,21,2,3,150,88,5,23,23,5,2,146,
20220909,774,772,남칠곡,북달성,2492,9,13,13,6,92,2625,2658,14,15,7,6,94,2794,
20220909,774,773,남칠곡,북다사,1031,4,0,0,0,41,1076,1402,2,0,0,0,61,1465,
20220909,775,202,동명동호,다부,311,5,1,1,4,8,330,524,3,2,1,2,25,557,
20220909,775,203,동명동호,가산,1331,11,12,3,2,36,1395,3430,12,19,28,17,94,3600,
20220909,775,205,동명동호,군위,593,1,2,2,1,24,623,836,1,1,0,1,29,868,
20220909,775,206,동명동호,의성,785,1,1,0,1,25,813,750,1,5,3,0,19,778,
20220909,775,207,동명동호,남안동,760,7,2,0,1,35,805,755,6,3,2,3,17,786,
20220909,775,208,동명동호,서안동,412,0,2,0,3,8,425,529,3,3,0,4,10,549,
20220909,775,210,동명동호,영주,584,0,1,0,2,16,603,433,2,1,0,2,17,455,
20220909,775,716,동명동호,청송,189,0,0,0,0,4,193,166,0,0,0,0,1,167,
20220909,775,748,동명동호,동청송영양,196,0,1,0,0,4,201,98,0,2,0,0,3,103,
20220909,775,749,동명동호,영덕,179,0,0,0,0,2,181,108,0,0,0,0,2,110,
20220909,776,131,연경,경산,572,11,9,7,7,23,629,519,23,9,3,8,24,586,
20220909,776,132,연경,영천,274,0,0,0,3,12,289,130,0,1,1,0,9,141,
20220909,776,135,연경,경주,302,0,0,0,1,12,315,166,0,0,1,0,12,179,
20220909,776,621,연경,동대구,466,1,0,0,2,12,481,224,1,0,0,0,6,231,
20220909,776,777,연경,파군재,5430,9,10,4,5,247,5705,3449,9,6,5,3,158,3630,
20220909,776,778,연경,둔산,550,8,8,4,0,15,585,362,4,0,2,0,10,378,
20220909,776,779,연경,율암,6085,22,30,37,43,294,6511,5744,11,19,28,34,261,6097,
20220909,777,131,파군재,경산,129,0,1,0,1,9,140,191,1,0,1,0,12,205,
20220909,777,776,파군재,연경,3449,9,6,5,3,158,3630,5430,9,10,4,5,247,5705,
20220909,777,778,파군재,둔산,185,1,0,0,0,6,192,151,1,0,0,0,4,156,
20220909,777,779,파군재,율암,2554,6,2,0,2,142,2706,2893,4,6,1,2,147,3053,
20220909,778,776,둔산,연경,362,4,0,2,0,10,378,550,8,8,4,0,15,585,
20220909,778,777,둔산,파군재,151,1,0,0,0,4,156,185,1,0,0,0,6,192,
20220909,778,779,둔산,율암,164,3,1,0,0,4,172,207,1,0,0,0,9,217,
20220909,779,131,율암,경산,118,1,0,0,0,5,124,364,8,3,0,0,29,404,
20220909,779,132,율암,영천,145,0,1,0,0,6,152,220,2,1,0,1,9,233,
20220909,779,135,율암,경주,201,1,0,0,0,7,209,362,4,1,1,0,12,380,
20220909,779,621,율암,동대구,132,0,0,0,1,8,141,96,0,0,0,0,9,105,
20220909,779,776,율암,연경,5744,11,19,28,34,261,6097,6085,22,30,37,43,294,6511,
20220909,779,777,율암,파군재,2893,4,6,1,2,147,3053,2554,6,2,0,2,142,2706,
20220909,779,778,율암,둔산,207,1,0,0,0,9,217,164,3,1,0,0,4,172,
20220909,876,673,양감,북오산,167,4,3,2,1,5,182,124,4,0,0,0,3,131,
20220909,876,675,양감,서오산,424,14,2,4,6,25,475,403,9,0,3,1,25,441,
20220909,876,677,양감,북평택,8784,20,7,13,10,266,9100,1922,22,12,8,14,95,2073,
20220909,981,982,서영암,강진무위사,8698,14,46,25,4,135,8922,2498,13,40,22,6,55,2634,
20220909,981,983,서영암,장흥,1534,4,3,1,1,34,1577,639,3,6,0,4,17,669,
20220909,981,984,서영암,보성,347,1,2,0,2,3,355,205,7,0,2,0,2,216,
20220909,981,985,서영암,벌교,668,2,2,3,1,12,688,420,3,7,2,5,5,442,
20220909,981,987,서영암,남순천,2859,3,40,12,43,55,3012,3462,15,47,16,43,89,3672,
20220909,982,981,강진무위사,서영암,2498,13,40,22,6,55,2634,8698,14,46,25,4,135,8922,
20220909,982,984,강진무위사,보성,144,1,3,0,0,1,149,167,0,0,0,0,2,169,
20220909,982,985,강진무위사,벌교,219,1,1,1,0,3,225,219,3,2,0,2,3,229,
20220909,982,987,강진무위사,남순천,1278,7,12,4,13,20,1334,3105,5,12,4,7,43,3176,
20220909,983,981,장흥,서영암,639,3,6,0,4,17,669,1534,4,3,1,1,34,1577,
20220909,983,984,장흥,보성,287,1,1,2,0,5,296,392,1,1,0,0,7,401,
20220909,983,985,장흥,벌교,157,3,0,1,3,4,168,205,3,0,0,2,7,217,
20220909,983,987,장흥,남순천,975,3,3,6,6,19,1012,2622,6,5,8,9,44,2694,
20220909,984,981,보성,서영암,205,7,0,2,0,2,216,347,1,2,0,2,3,355,
20220909,984,982,보성,강진무위사,167,0,0,0,0,2,169,144,1,3,0,0,1,149,
20220909,984,983,보성,장흥,392,1,1,0,0,7,401,287,1,1,2,0,5,296,
20220909,984,985,보성,벌교,4973,22,18,8,4,80,5105,2078,20,22,3,4,36,2163,
20220909,984,987,보성,남순천,2351,12,19,13,48,55,2498,3402,19,23,13,53,54,3564,
20220909,985,981,벌교,서영암,420,3,7,2,5,5,442,668,2,2,3,1,12,688,
20220909,985,982,벌교,강진무위사,219,3,2,0,2,3,229,219,1,1,1,0,3,225,
20220909,985,983,벌교,장흥,205,3,0,0,2,7,217,157,3,0,1,3,4,168,
20220909,985,984,벌교,보성,2078,20,22,3,4,36,2163,4973,22,18,8,4,80,5105,
20220909,985,987,벌교,남순천,1009,1,7,2,5,20,1044,2165,5,4,0,7,33,2214,
20220909,986,987,고흥,남순천,5077,26,51,14,20,100,5288,14177,34,57,35,18,267,14588,
20220909,987,981,남순천,서영암,3462,15,47,16,43,89,3672,2859,3,40,12,43,55,3012,
20220909,987,982,남순천,강진무위사,3105,5,12,4,7,43,3176,1278,7,12,4,13,20,1334,
20220909,987,983,남순천,장흥,2622,6,5,8,9,44,2694,975,3,3,6,6,19,1012,
20220909,987,984,남순천,보성,3402,19,23,13,53,54,3564,2351,12,19,13,48,55,2498,
20220909,987,985,남순천,벌교,2165,5,4,0,7,33,2214,1009,1,7,2,5,20,1044,
20220909,987,986,남순천,고흥,14177,34,57,35,18,267,14588,5077,26,51,14,20,100,5288,
