집계일자,출발영업소코드,도착영업소코드,출발영업소명,도착영업소명,도착지방향1종교통량,도착지방향2종교통량,도착지방향3종교통량,도착지방향4종교통량,도착지방향5종교통량,도착지방향6종교통량,도착지방향총교통량,출발지방향1종교통량,출발지방향2종교통량,출발지방향3종교통량,출발지방향4종교통량,출발지방향5종교통량,출발지방향6종교통량,출발지방향총교통량,Unnamed: 19
20221008,101,102,서울,동수원,3708,30,201,11,8,179,4137,4293,29,293,26,14,208,4863,
20221008,101,103,서울,수원신갈,14117,367,971,280,94,619,16448,13754,423,973,261,89,603,16103,
20221008,101,105,서울,기흥,6094,56,133,48,20,223,6574,5061,68,192,85,22,227,5655,
20221008,101,106,서울,오산,4728,202,319,97,48,281,5675,5344,303,349,118,49,283,6446,
20221008,101,107,서울,안성,3473,47,265,23,8,154,3970,3601,36,262,38,19,192,4148,
20221008,101,108,서울,천안,6006,37,360,31,9,217,6660,5265,32,358,22,16,200,5893,
20221008,101,110,서울,목천,543,4,25,13,6,13,604,550,10,26,54,13,20,673,
20221008,101,111,서울,청주,798,10,387,14,18,34,1261,986,9,323,15,24,38,1395,
20221008,101,112,서울,남청주,87,0,15,24,5,4,135,107,0,11,9,2,3,132,
20221008,101,113,서울,신탄진,637,11,30,30,17,19,744,700,10,9,22,16,20,777,
20221008,101,115,서울,대전,662,5,168,5,0,22,862,683,5,170,1,0,23,882,
20221008,101,116,서울,옥천,198,0,4,9,11,3,225,96,1,7,27,10,5,146,
20221008,101,123,서울,구미,71,0,62,0,0,2,135,67,0,51,1,1,4,124,
20221008,101,127,서울,서대구,235,6,110,2,0,7,360,180,3,80,5,2,6,276,
20221008,101,128,서울,금왕꽃동네,130,0,6,2,1,5,144,119,0,7,3,2,5,136,
20221008,101,129,서울,북대구,287,1,16,0,1,8,313,278,4,33,3,0,5,323,
20221008,101,136,서울,음성,397,2,25,1,3,6,434,131,5,19,3,5,4,167,
20221008,101,151,서울,북대전,246,4,142,3,0,13,408,436,3,126,1,1,10,577,
20221008,101,152,서울,유성,228,6,75,7,1,6,323,267,5,101,3,1,8,385,
20221008,101,171,서울,마성,3460,51,106,52,6,139,3814,3142,20,113,53,6,133,3467,
20221008,101,172,서울,용인,2272,57,60,27,18,132,2566,2882,94,65,43,23,174,3281,
20221008,101,173,서울,양지,2360,103,96,38,28,67,2692,4245,271,107,84,58,133,4898,
20221008,101,175,서울,덕평,495,43,69,15,7,14,643,588,84,65,25,7,20,789,
20221008,101,176,서울,이천,247,4,59,3,5,6,324,283,9,48,23,6,12,381,
20221008,101,177,서울,여주,391,4,36,2,2,9,444,331,1,40,4,2,5,383,
20221008,101,178,서울,문막,230,1,97,1,1,8,338,146,0,54,1,2,7,210,
20221008,101,193,서울,일죽,374,3,21,6,3,12,419,266,9,12,12,2,2,303,
20221008,101,195,서울,대소,96,7,38,2,1,6,150,84,11,26,6,9,4,140,
20221008,101,196,서울,진천,120,0,3,2,1,5,131,88,3,3,3,6,5,108,
20221008,101,197,서울,증평,142,1,7,4,3,7,164,119,2,8,5,4,4,142,
20221008,101,198,서울,서청주,112,0,1,1,0,4,118,125,1,2,1,0,4,133,
20221008,101,199,서울,오창,166,1,1,2,0,2,172,152,1,2,1,0,5,161,
20221008,101,211,서울,풍기,241,1,50,1,1,6,300,87,1,36,1,0,1,126,
20221008,101,218,서울,남원주,116,0,54,0,1,3,174,64,0,69,0,0,2,135,
20221008,101,225,서울,서진주,178,1,5,2,0,3,189,103,0,12,2,0,1,118,
20221008,101,229,서울,북천안,1597,21,87,38,15,55,1813,742,24,35,31,11,30,873,
20221008,101,239,서울,칠원,255,1,127,1,2,10,396,199,2,124,8,1,3,337,
20221008,101,240,서울,제천,250,1,69,0,0,4,324,90,1,53,1,0,3,148,
20221008,101,291,서울,사천,201,1,30,2,2,3,239,72,1,22,3,1,2,101,
20221008,101,292,서울,진주,60,1,53,0,1,2,117,45,0,51,0,3,3,102,
20221008,101,500,서울,남여주,241,1,1,1,0,1,245,252,1,5,2,2,4,266,
20221008,101,516,서울,통영,309,3,49,0,0,10,371,133,0,31,0,0,7,171,
20221008,101,528,서울,기흥동탄,7118,45,540,108,15,307,8133,6675,39,537,100,10,255,7616,
20221008,101,541,서울,송탄,894,14,11,21,7,47,994,638,20,17,28,12,39,754,
20221008,101,542,서울,서안성,976,21,59,61,14,45,1176,2379,37,66,131,28,116,2757,
20221008,101,543,서울,남안성,966,48,35,40,20,48,1157,1153,76,54,57,24,56,1420,
20221008,101,555,서울,북진천,424,3,4,4,9,12,456,263,4,9,7,10,12,305,
20221008,101,560,서울,감곡,316,2,4,5,5,10,342,289,3,10,6,5,3,316,
20221008,101,561,서울,북충주,260,1,11,3,0,10,285,259,3,58,5,1,11,337,
20221008,101,562,서울,충주,182,2,48,1,1,6,240,160,0,8,1,1,3,173,
20221008,101,566,서울,점촌함창,128,0,24,0,1,7,160,116,1,19,6,2,7,151,
20221008,101,601,서울,남천안,2366,23,135,9,20,65,2618,595,10,27,9,11,31,683,
20221008,101,673,서울,북오산,1656,20,95,19,3,92,1885,1607,31,93,15,2,80,1828,
20221008,101,676,서울,향남,212,4,10,3,9,8,246,125,8,9,3,12,8,165,
20221008,101,677,서울,북평택,3581,35,133,42,51,147,3989,2324,25,143,45,95,112,2744,
20221008,101,705,서울,남이천,381,5,7,9,8,2,412,328,9,8,12,8,7,372,
20221008,101,733,서울,옥산,158,2,24,0,0,3,187,156,7,6,0,0,6,175,
20221008,101,741,서울,평택고덕,317,3,20,1,2,17,360,621,1,23,3,2,37,687,
20221008,102,101,동수원,서울,4293,29,293,26,14,208,4863,3708,30,201,11,8,179,4137,
20221008,102,103,동수원,수원신갈,604,9,9,4,2,28,656,262,4,3,1,0,15,285,
20221008,102,105,동수원,기흥,512,5,1,0,1,27,546,302,5,3,0,0,21,331,
20221008,102,106,동수원,오산,232,6,3,0,0,22,263,127,5,1,0,0,11,144,
20221008,102,107,동수원,안성,235,2,1,0,0,13,251,160,1,2,0,0,6,169,
20221008,102,108,동수원,천안,266,0,1,1,2,14,284,121,1,2,0,0,3,127,
20221008,102,171,동수원,마성,916,10,14,0,2,41,983,727,5,15,2,0,53,802,
20221008,102,172,동수원,용인,692,10,5,4,3,40,754,727,15,7,1,0,56,806,
20221008,102,173,동수원,양지,631,21,14,4,13,42,725,1470,39,18,7,1,68,1603,
20221008,102,175,동수원,덕평,268,12,22,3,8,14,327,231,12,19,2,0,10,274,
20221008,102,176,동수원,이천,316,1,12,3,6,17,355,484,6,22,2,4,20,538,
20221008,102,177,동수원,여주,281,2,6,3,1,6,299,362,5,20,7,0,19,413,
20221008,102,178,동수원,문막,222,1,15,1,0,3,242,249,2,15,0,1,4,271,
20221008,102,189,동수원,강릉,172,0,9,1,0,6,188,141,0,12,0,0,7,160,
20221008,102,193,동수원,일죽,124,0,13,0,2,4,143,164,1,14,1,1,6,187,
20221008,102,211,동수원,풍기,109,1,9,0,0,0,119,98,1,9,0,0,0,108,
20221008,102,212,동수원,북수원,3407,20,143,7,15,181,3773,3890,25,160,8,8,183,4274,
20221008,102,213,동수원,부곡,815,10,7,5,6,30,873,725,12,8,1,3,40,789,
20221008,102,214,동수원,동군포,1711,25,7,7,2,96,1848,1478,20,6,3,0,75,1582,
20221008,102,215,동수원,군포,1169,11,10,3,5,74,1272,1836,15,7,6,3,99,1966,
20221008,102,218,동수원,남원주,130,0,0,0,1,6,137,149,0,0,0,0,4,153,
20221008,102,240,동수원,제천,228,0,7,0,0,7,242,236,1,9,0,1,2,249,
20221008,102,253,동수원,서서울,5457,42,32,19,19,298,5867,5595,31,37,15,10,325,6013,
20221008,102,254,동수원,군자,4381,31,42,11,13,181,4659,5597,41,52,27,28,248,5993,
20221008,102,255,동수원,서안산,1310,26,9,6,2,70,1423,1534,34,12,8,6,84,1678,
20221008,102,256,동수원,안산,438,10,1,0,0,22,471,483,8,2,1,0,28,522,
20221008,102,281,동수원,매송,299,2,1,0,0,16,318,298,2,0,1,0,13,314,
20221008,102,500,동수원,남여주,158,1,8,0,4,3,174,275,2,5,0,0,5,287,
20221008,102,528,동수원,기흥동탄,301,1,14,0,1,22,339,121,0,9,0,0,11,141,
20221008,102,560,동수원,감곡,174,1,7,3,2,4,191,223,0,5,2,7,10,247,
20221008,102,561,동수원,북충주,93,0,4,0,4,4,105,157,0,3,0,0,6,166,
20221008,102,705,동수원,남이천,96,2,3,0,1,7,109,152,2,4,0,0,4,162,
20221008,103,101,수원신갈,서울,13754,423,973,261,89,603,16103,14117,367,971,280,94,619,16448,
20221008,103,102,수원신갈,동수원,262,4,3,1,0,15,285,604,9,9,4,2,28,656,
20221008,103,105,수원신갈,기흥,2054,12,11,6,20,100,2203,2232,18,8,3,33,74,2368,
20221008,103,106,수원신갈,오산,894,36,24,13,5,58,1030,1182,49,38,11,8,74,1362,
20221008,103,107,수원신갈,안성,675,10,26,1,0,40,752,855,10,28,4,2,51,950,
20221008,103,108,수원신갈,천안,1027,3,29,1,0,36,1096,1010,9,32,2,1,40,1094,
20221008,103,111,수원신갈,청주,200,0,14,2,1,5,222,308,0,10,1,1,16,336,
20221008,103,113,수원신갈,신탄진,143,1,5,4,3,3,159,194,2,2,4,4,11,217,
20221008,103,115,수원신갈,대전,145,0,15,1,0,8,169,213,4,14,0,0,10,241,
20221008,103,171,수원신갈,마성,558,1,3,2,0,33,597,440,3,2,2,2,25,474,
20221008,103,172,수원신갈,용인,209,6,5,2,0,10,232,198,7,2,6,0,11,224,
20221008,103,173,수원신갈,양지,181,29,29,9,3,5,256,298,28,24,15,9,10,384,
20221008,103,175,수원신갈,덕평,109,13,10,17,3,7,159,69,9,13,7,1,2,101,
20221008,103,176,수원신갈,이천,155,4,10,7,3,8,187,216,8,13,12,8,4,261,
20221008,103,177,수원신갈,여주,138,2,13,6,3,8,170,186,1,17,9,3,7,223,
20221008,103,178,수원신갈,문막,136,1,2,3,0,10,152,120,1,3,3,1,4,132,
20221008,103,212,수원신갈,북수원,751,29,13,9,12,43,857,1559,55,22,29,20,66,1751,
20221008,103,213,수원신갈,부곡,211,24,5,3,15,12,270,233,22,5,5,9,18,292,
20221008,103,214,수원신갈,동군포,607,27,7,11,4,31,687,575,16,5,20,5,28,649,
20221008,103,215,수원신갈,군포,299,12,7,1,0,13,332,404,10,14,0,1,30,459,
20221008,103,229,수원신갈,북천안,259,1,3,2,0,9,274,160,3,3,5,5,11,187,
20221008,103,253,수원신갈,서서울,2235,107,54,44,28,105,2573,2477,76,58,35,35,112,2793,
20221008,103,254,수원신갈,군자,1877,66,43,39,39,90,2154,2326,71,43,71,49,98,2658,
20221008,103,255,수원신갈,서안산,497,38,15,15,10,24,599,619,48,18,16,21,27,749,
20221008,103,256,수원신갈,안산,147,9,6,0,0,8,170,179,8,4,4,0,11,206,
20221008,103,281,수원신갈,매송,93,2,0,1,0,9,105,101,3,2,0,0,5,111,
20221008,103,528,수원신갈,기흥동탄,1503,9,20,5,1,58,1596,1625,7,11,1,1,68,1713,
20221008,103,541,수원신갈,송탄,162,4,3,4,2,4,179,100,6,5,5,2,6,124,
20221008,103,542,수원신갈,서안성,154,1,8,6,0,5,174,366,1,11,14,2,16,410,
20221008,103,543,수원신갈,남안성,126,9,0,7,2,9,153,199,2,8,8,4,9,230,
20221008,103,555,수원신갈,북진천,129,0,4,2,0,4,139,156,1,3,2,0,8,170,
20221008,103,601,수원신갈,남천안,432,3,0,4,3,10,452,131,1,2,0,4,2,140,
20221008,103,673,수원신갈,북오산,321,3,1,5,5,20,355,367,5,4,4,6,26,412,
20221008,103,677,수원신갈,북평택,628,4,7,4,8,22,673,491,7,8,12,16,28,562,
20221008,105,101,기흥,서울,5061,68,192,85,22,227,5655,6094,56,133,48,20,223,6574,
20221008,105,102,기흥,동수원,302,5,3,0,0,21,331,512,5,1,0,1,27,546,
20221008,105,103,기흥,수원신갈,2232,18,8,3,33,74,2368,2054,12,11,6,20,100,2203,
20221008,105,212,기흥,북수원,631,12,3,2,4,36,688,837,16,7,5,3,44,912,
20221008,105,213,기흥,부곡,89,3,0,2,5,8,107,90,1,1,0,1,7,100,
20221008,105,214,기흥,동군포,199,3,3,6,4,10,225,187,4,4,4,0,12,211,
20221008,105,253,기흥,서서울,836,14,7,12,9,34,912,856,9,7,9,6,37,924,
20221008,105,254,기흥,군자,625,9,7,15,10,34,700,788,12,5,12,12,31,860,
20221008,105,255,기흥,서안산,145,5,3,7,2,3,165,192,9,4,4,1,5,215,
20221008,106,101,오산,서울,5344,303,349,118,49,283,6446,4728,202,319,97,48,281,5675,
20221008,106,102,오산,동수원,127,5,1,0,0,11,144,232,6,3,0,0,22,263,
20221008,106,103,오산,수원신갈,1182,49,38,11,8,74,1362,894,36,24,13,5,58,1030,
20221008,106,107,오산,안성,1293,20,20,5,12,92,1442,918,15,9,5,11,77,1035,
20221008,106,108,오산,천안,1489,16,14,7,8,58,1592,792,21,21,11,2,41,888,
20221008,106,110,오산,목천,120,3,1,1,0,4,129,97,3,5,2,2,5,114,
20221008,106,111,오산,청주,184,3,29,3,3,9,231,230,6,27,6,5,10,284,
20221008,106,113,오산,신탄진,132,4,9,1,5,9,160,112,0,5,2,4,4,127,
20221008,106,115,오산,대전,143,7,17,0,0,8,175,100,2,18,3,1,2,126,
20221008,106,136,오산,음성,332,1,3,4,3,9,352,124,2,3,3,2,5,139,
20221008,106,212,오산,북수원,297,12,7,8,2,21,347,323,13,7,10,2,20,375,
20221008,106,229,오산,북천안,803,13,7,15,11,27,876,168,9,6,7,5,13,208,
20221008,106,253,오산,서서울,441,32,15,15,7,18,528,383,27,23,14,10,19,476,
20221008,106,254,오산,군자,299,27,22,23,11,16,398,340,20,22,18,9,24,433,
20221008,106,528,오산,기흥동탄,534,16,11,7,5,45,618,555,24,22,8,10,38,657,
20221008,106,542,오산,서안성,243,8,17,21,10,17,316,300,6,18,34,6,21,385,
20221008,106,543,오산,남안성,400,15,13,12,17,25,482,317,18,12,18,35,25,425,
20221008,106,555,오산,북진천,290,9,8,6,6,17,336,203,13,7,5,5,14,247,
20221008,106,671,오산,봉담,600,25,27,13,10,43,718,514,30,23,13,11,36,627,
20221008,106,673,오산,북오산,127,5,1,0,0,15,148,178,2,1,1,2,12,196,
20221008,107,101,안성,서울,3601,36,262,38,19,192,4148,3473,47,265,23,8,154,3970,
20221008,107,102,안성,동수원,160,1,2,0,0,6,169,235,2,1,0,0,13,251,
20221008,107,103,안성,수원신갈,855,10,28,4,2,51,950,675,10,26,1,0,40,752,
20221008,107,106,안성,오산,918,15,9,5,11,77,1035,1293,20,20,5,12,92,1442,
20221008,107,108,안성,천안,1678,10,26,4,6,107,1831,1875,23,28,2,8,100,2036,
20221008,107,110,안성,목천,121,0,2,1,0,6,130,199,2,3,1,2,12,219,
20221008,107,111,안성,청주,230,2,14,2,1,8,257,374,5,16,2,3,27,427,
20221008,107,115,안성,대전,130,0,4,0,0,7,141,155,0,4,0,0,5,164,
20221008,107,212,안성,북수원,285,5,7,0,0,19,316,332,3,4,1,1,20,361,
20221008,107,229,안성,북천안,707,10,6,4,5,30,762,355,3,3,2,6,23,392,
20221008,107,253,안성,서서울,547,3,2,3,7,23,585,425,9,3,5,4,27,473,
20221008,107,254,안성,군자,156,4,4,0,1,10,175,164,5,8,6,5,6,194,
20221008,107,520,안성,평택,288,7,0,2,0,14,311,420,8,4,5,1,21,459,
20221008,107,528,안성,기흥동탄,728,5,6,3,5,39,786,630,10,8,3,2,43,696,
20221008,107,540,안성,청북,495,8,2,1,4,33,543,577,18,7,5,8,44,659,
20221008,107,541,안성,송탄,617,16,4,8,9,59,713,827,25,8,6,4,64,934,
20221008,107,542,안성,서안성,394,6,6,3,1,19,429,363,10,5,8,0,21,407,
20221008,107,555,안성,북진천,96,3,3,1,0,4,107,95,3,2,3,1,4,108,
20221008,107,601,안성,남천안,370,2,7,3,2,12,396,194,1,5,3,0,10,213,
20221008,107,671,안성,봉담,476,8,4,2,2,32,524,359,5,5,2,1,16,388,
20221008,107,673,안성,북오산,666,10,4,3,2,58,743,567,12,8,2,2,49,640,
20221008,107,741,안성,평택고덕,142,3,0,0,0,15,160,202,3,2,2,2,19,230,
20221008,107,742,안성,남사진위,1003,35,39,19,5,66,1167,1509,20,35,25,8,84,1681,
20221008,108,101,천안,서울,5265,32,358,22,16,200,5893,6006,37,360,31,9,217,6660,
20221008,108,102,천안,동수원,121,1,2,0,0,3,127,266,0,1,1,2,14,284,
20221008,108,103,천안,수원신갈,1010,9,32,2,1,40,1094,1027,3,29,1,0,36,1096,
20221008,108,106,천안,오산,792,21,21,11,2,41,888,1489,16,14,7,8,58,1592,
20221008,108,107,천안,안성,1875,23,28,2,8,100,2036,1678,10,26,4,6,107,1831,
20221008,108,108,천안,천안,221,0,8,2,6,5,242,221,0,8,2,6,5,242,
20221008,108,110,천안,목천,592,6,28,9,8,26,669,565,10,34,9,16,45,679,
20221008,108,111,천안,청주,588,22,55,3,22,38,728,848,16,48,10,14,45,981,
20221008,108,112,천안,남청주,76,12,4,5,4,5,106,90,40,5,6,7,1,149,
20221008,108,113,천안,신탄진,377,9,4,3,10,18,421,446,10,9,6,15,19,505,
20221008,108,115,천안,대전,444,7,40,0,1,35,527,524,6,39,0,4,27,600,
20221008,108,151,천안,북대전,112,0,5,0,1,4,122,218,5,3,1,0,11,238,
20221008,108,212,천안,북수원,276,3,0,1,0,11,291,381,0,0,0,4,13,398,
20221008,108,229,천안,북천안,2112,28,81,18,17,100,2356,1917,55,82,22,38,111,2225,
20221008,108,253,천안,서서울,646,5,2,5,0,28,686,715,10,8,4,4,33,774,
20221008,108,254,천안,군자,188,3,1,2,2,10,206,337,4,6,1,1,13,362,
20221008,108,520,천안,평택,173,2,0,0,1,6,182,418,4,4,0,0,16,442,
20221008,108,528,천안,기흥동탄,667,3,17,2,14,46,749,691,9,27,9,10,34,780,
20221008,108,540,천안,청북,221,1,0,2,1,12,237,316,5,1,2,3,9,336,
20221008,108,541,천안,송탄,666,27,18,7,8,42,768,815,29,21,1,10,40,916,
20221008,108,542,천안,서안성,869,6,36,24,16,44,995,862,19,47,28,13,31,1000,
20221008,108,601,천안,남천안,1273,15,18,14,27,45,1392,281,10,11,9,17,12,340,
20221008,108,671,천안,봉담,368,2,22,1,0,20,413,346,1,23,0,1,18,389,
20221008,108,673,천안,북오산,500,1,5,1,6,22,535,544,1,3,3,2,20,573,
20221008,108,733,천안,옥산,169,3,0,1,0,7,180,237,4,0,0,0,10,251,
20221008,108,741,천안,평택고덕,193,0,15,0,1,12,221,254,1,11,0,2,12,280,
20221008,108,742,천안,남사진위,977,17,16,12,8,44,1074,2039,22,19,13,9,81,2183,
20221008,109,114,계룡,남대전,99,4,2,5,2,6,118,121,2,10,8,2,5,148,
20221008,109,115,계룡,대전,165,3,2,5,4,8,187,160,7,1,6,9,8,191,
20221008,109,119,계룡,판암,269,1,6,2,9,12,299,210,6,1,0,10,14,241,
20221008,109,151,계룡,북대전,189,3,4,11,17,19,243,169,2,2,6,16,15,210,
20221008,109,152,계룡,유성,347,13,6,4,12,22,404,245,13,4,5,11,10,288,
20221008,109,153,계룡,서대전,112,8,2,0,0,5,127,119,3,1,0,2,12,137,
20221008,109,154,계룡,안영,185,3,9,4,48,10,259,204,5,6,3,35,16,269,
20221008,109,155,계룡,논산,230,7,7,10,8,10,272,216,6,7,9,3,14,255,
20221008,109,156,계룡,익산,234,10,2,6,2,6,260,168,11,2,4,1,8,194,
20221008,109,158,계룡,전주,222,4,3,1,0,9,239,176,5,1,3,1,8,194,
20221008,109,159,계룡,서전주,94,1,1,1,3,2,102,109,5,0,0,1,3,118,
20221008,109,167,계룡,광주,191,2,8,6,1,6,214,173,3,7,5,0,1,189,
20221008,110,101,목천,서울,550,10,26,54,13,20,673,543,4,25,13,6,13,604,
20221008,110,106,목천,오산,97,3,5,2,2,5,114,120,3,1,1,0,4,129,
20221008,110,107,목천,안성,199,2,3,1,2,12,219,121,0,2,1,0,6,130,
20221008,110,108,목천,천안,565,10,34,9,16,45,679,592,6,28,9,8,26,669,
20221008,110,111,목천,청주,198,5,8,3,4,12,230,416,17,10,8,6,23,480,
20221008,110,113,목천,신탄진,177,4,1,4,4,6,196,250,5,2,18,8,14,297,
20221008,110,115,목천,대전,239,4,10,0,0,15,268,366,1,12,2,1,22,404,
20221008,110,229,목천,북천안,251,14,11,22,21,18,337,159,6,8,22,8,10,213,
20221008,110,253,목천,서서울,145,1,7,11,8,5,177,88,1,2,7,5,4,107,
20221008,110,742,목천,남사진위,91,3,2,14,4,3,117,167,1,3,3,3,5,182,
20221008,111,101,청주,서울,986,9,323,15,24,38,1395,798,10,387,14,18,34,1261,
20221008,111,103,청주,수원신갈,308,0,10,1,1,16,336,200,0,14,2,1,5,222,
20221008,111,106,청주,오산,230,6,27,6,5,10,284,184,3,29,3,3,9,231,
20221008,111,107,청주,안성,374,5,16,2,3,27,427,230,2,14,2,1,8,257,
20221008,111,108,청주,천안,848,16,48,10,14,45,981,588,22,55,3,22,38,728,
20221008,111,110,청주,목천,416,17,10,8,6,23,480,198,5,8,3,4,12,230,
20221008,111,113,청주,신탄진,475,6,8,3,19,17,528,359,2,7,4,9,17,398,
20221008,111,115,청주,대전,608,7,14,2,4,38,673,508,6,11,5,2,23,555,
20221008,111,116,청주,옥천,175,1,3,2,3,8,192,129,3,7,0,2,5,146,
20221008,111,119,청주,판암,88,1,4,0,0,9,102,136,1,5,1,0,10,153,
20221008,111,151,청주,북대전,179,5,2,2,1,9,198,196,0,1,0,1,4,202,
20221008,111,152,청주,유성,94,3,4,1,2,5,109,152,1,5,0,1,4,163,
20221008,111,212,청주,북수원,126,0,6,0,1,5,138,114,0,8,2,2,4,130,
20221008,111,229,청주,북천안,242,7,9,16,6,14,294,158,9,7,7,8,7,196,
20221008,111,253,청주,서서울,379,7,3,4,1,16,410,252,2,4,5,2,7,272,
20221008,111,254,청주,군자,95,0,10,0,2,4,111,109,5,16,4,10,9,153,
20221008,111,528,청주,기흥동탄,163,0,3,2,2,6,176,113,0,1,0,1,4,119,
20221008,111,531,청주,문의청남대,104,0,3,3,1,2,113,98,0,1,0,1,7,107,
20221008,111,533,청주,보은,190,1,6,3,5,6,211,140,1,5,0,7,7,160,
20221008,111,536,청주,남상주,99,1,2,3,2,5,112,95,4,1,1,2,2,105,
20221008,111,541,청주,송탄,129,4,8,3,6,10,160,93,2,7,4,3,14,123,
20221008,111,601,청주,남천안,107,0,2,4,7,4,124,199,6,3,0,1,13,222,
20221008,111,671,청주,봉담,175,1,16,0,0,10,202,125,0,13,0,1,8,147,
20221008,111,673,청주,북오산,200,0,3,1,0,10,214,97,0,2,0,1,5,105,
20221008,111,742,청주,남사진위,191,2,13,5,2,8,221,204,4,15,6,3,11,243,
20221008,112,101,남청주,서울,107,0,11,9,2,3,132,87,0,15,24,5,4,135,
20221008,112,108,남청주,천안,90,40,5,6,7,1,149,76,12,4,5,4,5,106,
20221008,112,113,남청주,신탄진,513,21,23,22,25,25,629,339,21,16,14,13,16,419,
20221008,112,114,남청주,남대전,102,10,12,4,4,9,141,102,10,9,18,3,7,149,
20221008,112,115,남청주,대전,1416,59,57,14,19,89,1654,1205,64,40,5,7,80,1401,
20221008,112,116,남청주,옥천,546,13,12,14,18,24,627,460,11,9,17,18,14,529,
20221008,112,119,남청주,판암,322,10,4,5,47,23,411,309,21,2,2,62,23,419,
20221008,112,151,남청주,북대전,323,19,4,2,4,20,372,334,15,4,3,4,20,380,
20221008,112,152,남청주,유성,470,28,34,6,4,23,565,465,17,34,9,1,22,548,
20221008,112,153,남청주,서대전,273,13,3,2,1,18,310,312,23,9,3,2,16,365,
20221008,112,154,남청주,안영,188,7,1,0,1,10,207,200,12,0,2,4,10,228,
20221008,112,156,남청주,익산,110,5,2,5,0,2,124,98,5,2,2,1,3,111,
20221008,112,158,남청주,전주,140,8,1,18,5,6,178,100,7,3,18,4,1,133,
20221008,112,167,남청주,광주,224,2,3,22,18,7,276,123,2,3,21,6,4,159,
20221008,112,190,남청주,동서울,327,3,6,9,9,21,375,230,1,4,18,20,7,280,
20221008,112,196,남청주,진천,134,4,9,13,18,5,183,97,9,6,6,14,6,138,
20221008,112,197,남청주,증평,181,11,4,8,8,8,220,103,11,4,17,15,3,153,
20221008,112,198,남청주,서청주,136,14,5,7,6,11,179,293,12,7,10,9,13,344,
20221008,112,199,남청주,오창,187,5,9,10,12,6,229,121,8,5,9,11,5,159,
20221008,112,200,남청주,금산,141,2,4,1,2,8,158,100,5,4,0,1,4,114,
20221008,112,531,남청주,문의청남대,169,3,1,1,4,2,180,124,2,2,2,11,1,142,
20221008,112,533,남청주,보은,273,8,2,3,2,9,297,233,5,0,4,6,10,258,
20221008,112,534,남청주,속리산,108,1,3,0,1,3,116,109,1,2,2,1,2,117,
20221008,112,536,남청주,남상주,115,1,3,4,1,4,128,96,1,2,1,2,4,106,
20221008,113,101,신탄진,서울,700,10,9,22,16,20,777,637,11,30,30,17,19,744,
20221008,113,103,신탄진,수원신갈,194,2,2,4,4,11,217,143,1,5,4,3,3,159,
20221008,113,106,신탄진,오산,112,0,5,2,4,4,127,132,4,9,1,5,9,160,
20221008,113,108,신탄진,천안,446,10,9,6,15,19,505,377,9,4,3,10,18,421,
20221008,113,110,신탄진,목천,250,5,2,18,8,14,297,177,4,1,4,4,6,196,
20221008,113,111,신탄진,청주,359,2,7,4,9,17,398,475,6,8,3,19,17,528,
20221008,113,112,신탄진,남청주,339,21,16,14,13,16,419,513,21,23,22,25,25,629,
20221008,113,114,신탄진,남대전,167,8,10,3,12,13,213,220,6,10,15,15,7,273,
20221008,113,115,신탄진,대전,778,14,5,9,7,82,895,985,11,9,5,3,87,1100,
20221008,113,116,신탄진,옥천,412,10,5,23,30,28,508,400,8,9,30,28,23,498,
20221008,113,119,신탄진,판암,352,5,6,6,7,32,408,536,13,8,6,6,38,607,
20221008,113,151,신탄진,북대전,130,0,1,3,0,9,143,143,1,1,1,7,6,159,
20221008,113,152,신탄진,유성,353,3,6,2,7,24,395,421,2,6,5,4,33,471,
20221008,113,153,신탄진,서대전,298,7,2,2,3,16,328,351,3,5,3,4,22,388,
20221008,113,154,신탄진,안영,166,3,3,2,6,9,189,173,5,5,4,9,14,210,
20221008,113,190,신탄진,동서울,903,10,6,28,31,37,1015,781,5,7,19,24,33,869,
20221008,113,192,신탄진,곤지암,91,0,1,12,14,7,125,128,6,3,8,22,6,173,
20221008,113,196,신탄진,진천,266,14,7,21,15,16,339,322,8,7,14,14,20,385,
20221008,113,197,신탄진,증평,412,7,7,10,28,24,488,347,6,8,14,33,14,422,
20221008,113,198,신탄진,서청주,777,13,14,22,18,48,892,933,15,7,13,6,42,1016,
20221008,113,199,신탄진,오창,791,7,14,21,45,28,906,484,5,8,7,23,20,547,
20221008,113,200,신탄진,금산,134,4,1,3,5,7,154,135,4,1,4,5,8,157,
20221008,113,204,신탄진,추부,124,3,3,5,3,10,148,106,3,2,4,2,7,124,
20221008,113,229,신탄진,북천안,117,1,2,4,10,4,138,99,3,6,4,5,5,122,
20221008,113,253,신탄진,서서울,208,4,2,11,25,6,256,166,4,3,6,10,4,193,
20221008,113,297,신탄진,동충주,174,1,2,7,4,4,192,144,2,4,0,1,11,162,
20221008,113,742,신탄진,남사진위,101,1,4,7,1,6,120,140,12,5,3,6,6,172,
20221008,114,109,남대전,계룡,121,2,10,8,2,5,148,99,4,2,5,2,6,118,
20221008,114,112,남대전,남청주,102,10,9,18,3,7,149,102,10,12,4,4,9,141,
20221008,114,113,남대전,신탄진,220,6,10,15,15,7,273,167,8,10,3,12,13,213,
20221008,114,115,남대전,대전,404,12,11,7,5,24,463,349,10,5,6,2,15,387,
20221008,114,119,남대전,판암,136,1,3,8,4,10,162,160,1,2,2,0,8,173,
20221008,114,151,남대전,북대전,267,3,5,21,7,11,314,198,3,5,10,8,8,232,
20221008,114,152,남대전,유성,693,14,10,14,2,36,769,605,10,4,8,3,32,662,
20221008,114,153,남대전,서대전,1748,33,34,31,15,98,1959,1564,32,36,25,11,81,1749,
20221008,114,154,남대전,안영,641,11,23,13,12,49,749,622,20,18,10,6,41,717,
20221008,114,155,남대전,논산,103,4,5,10,1,3,126,88,1,6,3,2,5,105,
20221008,114,164,남대전,무주,408,1,2,1,0,22,434,309,1,2,0,0,14,326,
20221008,114,200,남대전,금산,472,3,18,1,0,30,524,420,3,16,0,0,31,470,
20221008,114,579,남대전,남세종,263,5,6,15,8,11,308,259,4,5,6,6,11,291,
20221008,115,101,대전,서울,683,5,170,1,0,23,882,662,5,168,5,0,22,862,
20221008,115,103,대전,수원신갈,213,4,14,0,0,10,241,145,0,15,1,0,8,169,
20221008,115,106,대전,오산,100,2,18,3,1,2,126,143,7,17,0,0,8,175,
20221008,115,107,대전,안성,155,0,4,0,0,5,164,130,0,4,0,0,7,141,
20221008,115,108,대전,천안,524,6,39,0,4,27,600,444,7,40,0,1,35,527,
20221008,115,109,대전,계룡,160,7,1,6,9,8,191,165,3,2,5,4,8,187,
20221008,115,110,대전,목천,366,1,12,2,1,22,404,239,4,10,0,0,15,268,
20221008,115,111,대전,청주,508,6,11,5,2,23,555,608,7,14,2,4,38,673,
20221008,115,112,대전,남청주,1205,64,40,5,7,80,1401,1416,59,57,14,19,89,1654,
20221008,115,113,대전,신탄진,985,11,9,5,3,87,1100,778,14,5,9,7,82,895,
20221008,115,114,대전,남대전,349,10,5,6,2,15,387,404,12,11,7,5,24,463,
20221008,115,115,대전,대전,190,1,1,2,0,4,198,190,1,1,2,0,4,198,
20221008,115,116,대전,옥천,2202,79,28,12,5,165,2491,2103,38,26,17,10,163,2357,
20221008,115,118,대전,영동,472,5,4,2,9,36,528,420,7,6,0,6,24,463,
20221008,115,120,대전,황간,230,1,1,1,2,15,250,203,2,1,0,4,9,219,
20221008,115,122,대전,김천,266,1,7,75,8,12,369,265,2,6,90,14,9,386,
20221008,115,123,대전,구미,194,1,1,2,1,13,212,246,1,6,1,2,13,269,
20221008,115,127,대전,서대구,220,3,11,4,1,8,247,217,1,9,4,0,10,241,
20221008,115,129,대전,북대구,257,4,5,1,1,10,278,272,1,5,0,1,7,286,
20221008,115,130,대전,동김천,100,0,0,0,0,6,106,118,0,0,0,3,10,131,
20221008,115,135,대전,경주,173,2,0,3,0,14,192,134,1,2,3,0,5,145,
20221008,115,151,대전,북대전,744,9,2,1,5,54,815,636,7,1,3,5,49,701,
20221008,115,152,대전,유성,465,9,7,0,1,35,517,619,6,12,1,4,38,680,
20221008,115,153,대전,서대전,771,9,7,3,3,48,841,873,13,6,5,8,47,952,
20221008,115,154,대전,안영,371,7,5,4,1,36,424,393,4,3,4,6,27,437,
20221008,115,155,대전,논산,184,1,3,0,0,11,199,157,2,1,0,0,11,171,
20221008,115,156,대전,익산,127,1,0,0,0,9,137,97,0,0,1,0,8,106,
20221008,115,158,대전,전주,149,3,4,1,0,5,162,108,0,8,0,1,0,117,
20221008,115,164,대전,무주,378,3,17,0,2,29,429,296,1,18,0,1,12,328,
20221008,115,167,대전,광주,138,2,0,0,0,2,142,105,1,2,1,0,2,111,
20221008,115,190,대전,동서울,739,9,9,0,0,18,775,675,5,8,1,3,30,722,
20221008,115,192,대전,곤지암,95,3,5,0,1,4,108,104,2,1,0,1,3,111,
20221008,115,196,대전,진천,225,9,8,3,5,9,259,286,12,6,4,7,9,324,
20221008,115,197,대전,증평,397,2,9,0,3,8,419,325,1,11,3,3,16,359,
20221008,115,198,대전,서청주,780,10,8,4,1,59,862,870,8,4,7,2,67,958,
20221008,115,199,대전,오창,642,7,15,1,31,41,737,476,7,7,2,18,27,537,
20221008,115,200,대전,금산,517,2,14,0,0,35,568,512,0,11,0,2,20,545,
20221008,115,204,대전,추부,601,11,10,1,3,42,668,481,15,5,6,2,41,550,
20221008,115,229,대전,북천안,122,2,4,0,0,8,136,125,1,4,2,1,10,143,
20221008,115,239,대전,칠원,190,0,15,4,0,4,213,153,0,14,1,2,6,176,
20221008,115,253,대전,서서울,191,2,2,0,3,13,211,195,0,3,0,1,7,206,
20221008,115,297,대전,동충주,153,0,8,0,0,5,166,106,0,3,0,2,5,116,
20221008,115,298,대전,서산,233,0,21,0,1,7,262,236,2,24,1,0,13,276,
20221008,115,527,대전,포항,144,4,6,1,1,4,160,94,2,4,0,1,0,101,
20221008,115,573,대전,예산수덕사,447,1,3,1,0,25,477,426,4,0,1,0,19,450,
20221008,115,576,대전,마곡사,94,1,1,0,2,7,105,110,1,1,0,6,6,124,
20221008,115,577,대전,공주,104,0,2,0,10,10,126,149,0,1,0,7,7,164,
20221008,115,578,대전,서세종,453,21,7,0,5,43,529,455,22,10,0,5,25,517,
20221008,115,579,대전,남세종,645,11,12,1,22,38,729,849,7,24,2,33,47,962,
20221008,115,593,대전,부여,101,1,2,0,0,3,107,96,1,3,0,0,4,104,
20221008,115,595,대전,서공주,412,2,7,1,0,29,451,338,5,4,0,2,11,360,
20221008,115,671,대전,봉담,120,3,14,0,0,3,140,92,1,13,1,0,2,109,
20221008,115,742,대전,남사진위,121,4,3,2,0,1,131,125,4,2,0,0,5,136,
20221008,116,101,옥천,서울,96,1,7,27,10,5,146,198,0,4,9,11,3,225,
20221008,116,111,옥천,청주,129,3,7,0,2,5,146,175,1,3,2,3,8,192,
20221008,116,112,옥천,남청주,460,11,9,17,18,14,529,546,13,12,14,18,24,627,
20221008,116,113,옥천,신탄진,400,8,9,30,28,23,498,412,10,5,23,30,28,508,
20221008,116,115,옥천,대전,2103,38,26,17,10,163,2357,2202,79,28,12,5,165,2491,
20221008,116,118,옥천,영동,130,3,2,3,5,6,149,97,2,2,1,6,5,113,
20221008,116,119,옥천,판암,500,14,14,0,3,43,574,511,16,15,1,6,39,588,
20221008,116,151,옥천,북대전,680,13,5,6,12,32,748,603,5,5,6,5,31,655,
20221008,116,152,옥천,유성,415,9,4,2,1,22,453,500,9,2,0,1,28,540,
20221008,116,153,옥천,서대전,636,14,6,6,5,34,701,723,15,8,6,7,38,797,
20221008,116,154,옥천,안영,323,12,1,2,2,21,361,388,9,2,2,1,26,428,
20221008,116,190,옥천,동서울,154,2,5,47,19,4,231,230,1,4,18,6,6,265,
20221008,116,198,옥천,서청주,194,3,3,10,2,9,221,239,3,5,5,1,11,264,
20221008,116,199,옥천,오창,114,0,3,6,10,12,145,111,2,3,3,5,7,131,
20221008,116,579,옥천,남세종,320,19,3,1,2,26,371,391,9,1,2,2,33,438,
20221008,117,117,금강,금강,169,0,1,0,0,14,184,169,0,1,0,0,14,184,
20221008,118,115,영동,대전,420,7,6,0,6,24,463,472,5,4,2,9,36,528,
20221008,118,116,영동,옥천,97,2,2,1,6,5,113,130,3,2,3,5,6,149,
20221008,118,119,영동,판암,151,0,2,1,2,7,163,182,1,3,0,1,4,191,
20221008,118,153,영동,서대전,95,2,0,0,1,5,103,126,2,0,0,2,4,134,
20221008,119,109,판암,계룡,210,6,1,0,10,14,241,269,1,6,2,9,12,299,
20221008,119,111,판암,청주,136,1,5,1,0,10,153,88,1,4,0,0,9,102,
20221008,119,112,판암,남청주,309,21,2,2,62,23,419,322,10,4,5,47,23,411,
20221008,119,113,판암,신탄진,536,13,8,6,6,38,607,352,5,6,6,7,32,408,
20221008,119,114,판암,남대전,160,1,2,2,0,8,173,136,1,3,8,4,10,162,
20221008,119,116,판암,옥천,511,16,15,1,6,39,588,500,14,14,0,3,43,574,
20221008,119,118,판암,영동,182,1,3,0,1,4,191,151,0,2,1,2,7,163,
20221008,119,123,판암,구미,104,0,0,0,0,4,108,108,0,1,0,0,6,115,
20221008,119,151,판암,북대전,532,8,6,1,9,45,601,340,2,4,6,6,33,391,
20221008,119,152,판암,유성,472,7,3,0,0,24,506,446,9,2,1,1,13,472,
20221008,119,153,판암,서대전,2216,16,9,7,115,147,2510,2051,20,10,4,96,134,2315,
20221008,119,154,판암,안영,563,10,7,7,7,31,625,515,6,8,2,7,31,569,
20221008,119,155,판암,논산,257,7,3,4,3,19,293,302,2,3,2,1,19,329,
20221008,119,156,판암,익산,187,2,1,0,1,7,198,189,1,1,1,0,9,201,
20221008,119,158,판암,전주,268,1,3,2,1,12,287,205,0,1,0,3,13,222,
20221008,119,164,판암,무주,247,2,1,0,0,14,264,165,1,2,0,0,18,186,
20221008,119,167,판암,광주,180,2,0,0,0,4,186,185,2,2,1,0,5,195,
20221008,119,190,판암,동서울,122,1,1,1,0,5,130,115,0,0,0,0,5,120,
20221008,119,198,판암,서청주,158,1,0,0,0,11,170,119,1,1,0,2,6,129,
20221008,119,199,판암,오창,135,4,4,0,1,7,151,103,0,1,2,1,3,110,
20221008,119,200,판암,금산,447,1,20,0,1,19,488,297,1,24,0,0,19,341,
20221008,119,204,판암,추부,312,2,4,1,2,33,354,185,1,1,0,0,20,207,
20221008,119,573,판암,예산수덕사,160,1,1,0,0,5,167,108,1,2,0,1,1,113,
20221008,119,578,판암,서세종,182,3,2,0,0,6,193,123,1,2,0,1,8,135,
20221008,119,579,판암,남세종,388,7,0,2,7,19,423,334,5,1,2,12,16,370,
20221008,120,115,황간,대전,203,2,1,0,4,9,219,230,1,1,1,2,15,250,
20221008,120,122,황간,김천,144,1,4,4,4,8,165,176,1,4,0,6,9,196,
20221008,120,123,황간,구미,158,1,1,0,2,14,176,278,2,1,2,2,13,298,
20221008,120,127,황간,서대구,87,0,3,5,6,3,104,143,0,2,0,2,3,150,
20221008,120,129,황간,북대구,99,1,1,1,0,1,103,162,1,1,0,0,3,167,
20221008,120,130,황간,동김천,90,1,3,9,3,7,113,128,2,7,3,5,9,154,
20221008,120,723,황간,북구미,96,2,0,0,1,3,102,123,1,1,0,0,2,127,
20221008,121,121,추풍령,추풍령,90,0,2,0,2,18,112,90,0,2,0,2,18,112,
20221008,122,115,김천,대전,265,2,6,90,14,9,386,266,1,7,75,8,12,369,
20221008,122,120,김천,황간,176,1,4,0,6,9,196,144,1,4,4,4,8,165,
20221008,122,123,김천,구미,737,10,5,2,3,51,808,642,4,9,2,5,49,711,
20221008,122,125,김천,남구미,140,6,4,2,2,6,160,174,6,4,4,3,12,203,
20221008,122,127,김천,서대구,410,4,3,2,1,20,440,436,3,4,3,3,22,471,
20221008,122,129,김천,북대구,461,2,5,0,2,22,492,461,3,3,0,4,16,487,
20221008,122,130,김천,동김천,226,1,3,0,0,16,246,201,4,0,1,0,16,222,
20221008,122,723,김천,북구미,457,5,4,0,0,23,489,400,3,1,0,0,21,425,
20221008,122,772,김천,북달성,97,1,5,0,0,4,107,89,3,6,1,0,3,102,
20221008,122,774,김천,남칠곡,117,2,1,1,2,4,127,112,2,2,0,2,4,122,
20221008,123,101,구미,서울,67,0,51,1,1,4,124,71,0,62,0,0,2,135,
20221008,123,115,구미,대전,246,1,6,1,2,13,269,194,1,1,2,1,13,212,
20221008,123,119,구미,판암,108,0,1,0,0,6,115,104,0,0,0,0,4,108,
20221008,123,120,구미,황간,278,2,1,2,2,13,298,158,1,1,0,2,14,176,
20221008,123,122,구미,김천,642,4,9,2,5,49,711,737,10,5,2,3,51,808,
20221008,123,125,구미,남구미,278,6,2,6,3,20,315,205,13,1,4,3,11,237,
20221008,123,126,구미,왜관,430,18,9,5,2,15,479,359,19,10,2,7,17,414,
20221008,123,127,구미,서대구,2087,20,26,14,5,96,2248,2034,24,31,10,3,102,2204,
20221008,123,129,구미,북대구,2089,16,61,6,2,96,2270,2357,10,58,8,6,119,2558,
20221008,123,130,구미,동김천,1094,13,15,18,18,58,1216,900,11,9,11,8,59,998,
20221008,123,131,구미,경산,245,7,10,2,2,11,277,234,10,8,7,5,11,275,
20221008,123,135,구미,경주,208,0,1,2,0,8,219,235,1,3,0,1,8,248,
20221008,123,190,구미,동서울,165,2,13,10,2,6,198,133,0,6,0,2,7,148,
20221008,123,201,구미,칠곡,133,0,0,0,0,12,145,163,1,1,1,0,7,173,
20221008,123,230,구미,팔공산,315,4,1,1,0,14,335,258,4,1,0,0,19,282,
20221008,123,231,구미,화원옥포,96,4,2,1,0,6,109,127,4,2,1,0,6,140,
20221008,123,239,구미,칠원,246,0,3,1,3,9,262,170,0,2,3,0,4,179,
20221008,123,527,구미,포항,304,1,2,0,3,10,320,274,2,2,1,0,9,288,
20221008,123,621,구미,동대구,281,3,3,6,7,11,311,310,1,3,2,9,12,337,
20221008,123,641,구미,울산,108,0,4,2,2,6,122,117,0,4,0,3,3,127,
20221008,123,723,구미,북구미,103,1,0,0,0,9,113,153,1,0,0,0,10,164,
20221008,123,730,구미,유천,148,0,0,0,0,10,158,114,1,0,0,0,10,125,
20221008,123,772,구미,북달성,376,8,7,3,8,24,426,396,7,9,3,2,19,436,
20221008,123,773,구미,북다사,121,2,2,2,1,7,135,135,0,1,2,1,7,146,
20221008,123,774,구미,남칠곡,431,5,4,3,2,34,479,433,1,2,5,3,29,473,
20221008,124,127,상주,서대구,168,4,3,2,0,7,184,214,6,4,2,0,10,236,
20221008,124,129,상주,북대구,159,0,1,0,0,6,166,196,0,4,0,0,10,210,
20221008,125,122,남구미,김천,174,6,4,4,3,12,203,140,6,4,2,2,6,160,
20221008,125,123,남구미,구미,205,13,1,4,3,11,237,278,6,2,6,3,20,315,
20221008,125,126,남구미,왜관,174,19,10,3,7,16,229,164,17,7,14,6,10,218,
20221008,125,127,남구미,서대구,1990,23,42,29,15,126,2225,1919,32,53,17,16,117,2154,
20221008,125,129,남구미,북대구,1633,14,21,6,6,95,1775,1889,16,26,12,3,105,2051,
20221008,125,130,남구미,동김천,229,13,19,7,10,10,288,150,10,7,8,7,11,193,
20221008,125,131,남구미,경산,213,8,18,14,4,12,269,259,9,22,9,11,14,324,
20221008,125,135,남구미,경주,176,2,7,3,1,4,193,172,2,16,2,5,3,200,
20221008,125,230,남구미,팔공산,236,2,4,1,1,16,260,241,3,4,0,1,16,265,
20221008,125,231,남구미,화원옥포,86,2,2,4,2,4,100,84,4,4,3,6,5,106,
20221008,125,239,남구미,칠원,223,4,9,6,5,16,263,148,2,10,2,10,7,179,
20221008,125,518,남구미,칠곡물류,55,7,8,26,6,6,108,46,4,18,43,9,6,126,
20221008,125,527,남구미,포항,282,1,2,0,3,13,301,207,1,4,1,8,10,231,
20221008,125,621,남구미,동대구,239,1,1,2,3,20,266,229,4,4,3,4,17,261,
20221008,125,723,남구미,북구미,255,6,1,1,0,19,282,293,4,1,0,0,17,315,
20221008,125,730,남구미,유천,177,1,0,0,0,6,184,128,0,0,0,0,1,129,
20221008,125,772,남구미,북달성,338,5,13,4,7,20,387,397,5,17,8,7,25,459,
20221008,125,773,남구미,북다사,101,0,0,2,2,10,115,139,1,0,1,2,8,151,
20221008,125,774,남구미,남칠곡,309,6,0,0,7,13,335,305,2,2,5,5,28,347,
20221008,126,123,왜관,구미,359,19,10,2,7,17,414,430,18,9,5,2,15,479,
20221008,126,125,왜관,남구미,164,17,7,14,6,10,218,174,19,10,3,7,16,229,
20221008,126,127,왜관,서대구,2295,73,45,33,40,140,2626,2385,87,52,20,28,126,2698,
20221008,126,129,왜관,북대구,2626,64,30,15,55,115,2905,3196,68,40,17,84,164,3569,
20221008,126,131,왜관,경산,350,37,27,21,41,22,498,381,48,36,23,41,23,552,
20221008,126,132,왜관,영천,122,9,18,16,13,5,183,139,5,19,17,21,3,204,
20221008,126,135,왜관,경주,160,7,9,4,15,10,205,197,6,6,4,27,6,246,
20221008,126,230,왜관,팔공산,405,18,7,1,7,21,459,412,10,8,2,3,24,459,
20221008,126,231,왜관,화원옥포,105,9,3,3,2,2,124,139,10,4,3,2,8,166,
20221008,126,524,왜관,청통와촌,86,13,13,15,10,5,142,87,13,14,11,5,5,135,
20221008,126,527,왜관,포항,255,26,12,7,13,13,326,276,10,7,3,15,9,320,
20221008,126,621,왜관,동대구,440,15,7,8,54,23,547,438,19,6,1,38,23,525,
20221008,126,641,왜관,울산,90,0,1,2,6,3,102,94,0,1,5,6,3,109,
20221008,126,730,왜관,유천,179,9,0,0,0,16,204,131,4,0,0,0,9,144,
20221008,126,772,왜관,북달성,417,26,9,5,5,28,490,478,17,11,10,3,18,537,
20221008,126,773,왜관,북다사,121,6,3,4,1,7,142,153,3,3,2,2,10,173,
20221008,126,774,왜관,남칠곡,433,11,10,8,14,7,483,500,16,7,2,11,21,557,
20221008,127,101,서대구,서울,180,3,80,5,2,6,276,235,6,110,2,0,7,360,
20221008,127,115,서대구,대전,217,1,9,4,0,10,241,220,3,11,4,1,8,247,
20221008,127,120,서대구,황간,143,0,2,0,2,3,150,87,0,3,5,6,3,104,
20221008,127,122,서대구,김천,436,3,4,3,3,22,471,410,4,3,2,1,20,440,
20221008,127,123,서대구,구미,2034,24,31,10,3,102,2204,2087,20,26,14,5,96,2248,
20221008,127,124,서대구,상주,214,6,4,2,0,10,236,168,4,3,2,0,7,184,
20221008,127,125,서대구,남구미,1919,32,53,17,16,117,2154,1990,23,42,29,15,126,2225,
20221008,127,126,서대구,왜관,2385,87,52,20,28,126,2698,2295,73,45,33,40,140,2626,
20221008,127,129,서대구,북대구,731,9,9,6,6,39,800,214,6,8,0,4,13,245,
20221008,127,130,서대구,동김천,621,9,18,9,6,34,697,482,6,13,4,5,16,526,
20221008,127,131,서대구,경산,2033,119,49,46,27,93,2367,1406,81,29,29,36,71,1652,
20221008,127,132,서대구,영천,722,19,34,26,23,35,859,464,18,35,14,25,15,571,
20221008,127,133,서대구,건천,304,4,10,4,7,13,342,183,5,2,2,4,1,197,
20221008,127,134,서대구,선산,150,1,2,0,1,6,160,133,4,1,0,1,6,145,
20221008,127,135,서대구,경주,963,12,21,18,2,45,1061,847,10,26,14,1,30,928,
20221008,127,153,서대구,서대전,105,1,4,1,2,7,120,108,2,3,2,2,5,122,
20221008,127,190,서대구,동서울,465,6,17,9,6,12,515,430,5,13,17,4,15,484,
20221008,127,201,서대구,칠곡,1552,11,28,6,16,67,1680,681,12,11,1,16,32,753,
20221008,127,202,서대구,다부,348,6,4,4,19,11,392,399,5,9,8,5,14,440,
20221008,127,203,서대구,가산,2074,32,44,17,21,91,2279,2255,41,41,24,36,114,2511,
20221008,127,205,서대구,군위,789,8,3,2,1,31,834,688,6,5,0,1,25,725,
20221008,127,206,서대구,의성,830,4,10,3,2,40,889,722,4,6,3,1,26,762,
20221008,127,207,서대구,남안동,805,4,8,5,1,37,860,835,10,12,1,3,31,892,
20221008,127,208,서대구,서안동,422,3,15,2,0,22,464,438,2,5,1,1,14,461,
20221008,127,210,서대구,영주,518,5,16,1,5,19,564,445,5,5,1,1,17,474,
20221008,127,211,서대구,풍기,204,1,2,0,0,7,214,162,0,1,0,0,2,165,
20221008,127,230,서대구,팔공산,1201,17,23,5,1,63,1310,778,14,11,3,1,44,851,
20221008,127,253,서대구,서서울,89,1,4,5,2,0,101,129,2,2,14,1,5,153,
20221008,127,254,서대구,군자,100,2,7,6,2,3,120,86,5,7,9,8,4,119,
20221008,127,518,서대구,칠곡물류,438,66,59,76,20,28,687,411,58,50,75,30,29,653,
20221008,127,524,서대구,청통와촌,754,35,19,12,28,36,884,507,23,21,8,14,18,591,
20221008,127,525,서대구,북영천,693,11,6,1,4,21,736,365,4,4,4,2,13,392,
20221008,127,527,서대구,포항,2063,24,33,10,33,87,2250,1280,16,22,9,22,51,1400,
20221008,127,531,서대구,문의청남대,100,0,0,0,0,3,103,169,1,0,3,1,4,178,
20221008,127,565,서대구,문경새재,146,3,0,0,0,4,153,360,4,3,8,1,10,386,
20221008,127,566,서대구,점촌함창,91,1,3,1,0,4,100,139,1,2,0,4,5,151,
20221008,127,570,서대구,북상주,227,1,2,0,4,9,243,191,3,4,0,4,13,215,
20221008,127,621,서대구,동대구,1427,38,60,18,32,88,1663,969,24,23,15,20,65,1116,
20221008,127,641,서대구,울산,384,0,19,5,8,17,433,276,2,19,2,15,15,329,
20221008,127,716,서대구,청송,212,1,2,0,0,5,220,164,1,3,0,0,8,176,
20221008,127,723,서대구,북구미,341,3,2,1,0,20,367,346,5,2,0,0,23,376,
20221008,127,749,서대구,영덕,329,3,6,0,0,11,349,152,0,3,0,0,7,162,
20221008,127,774,서대구,남칠곡,237,2,6,0,0,8,253,144,1,7,0,1,3,156,
20221008,128,101,금왕꽃동네,서울,119,0,7,3,2,5,136,130,0,6,2,1,5,144,
20221008,128,136,금왕꽃동네,음성,209,8,5,1,4,13,240,168,10,4,3,3,12,200,
20221008,128,188,금왕꽃동네,서충주,171,2,5,11,10,9,208,223,3,7,8,6,8,255,
20221008,128,190,금왕꽃동네,동서울,491,9,7,15,14,25,561,295,5,5,7,7,17,336,
20221008,128,240,금왕꽃동네,제천,111,1,0,3,0,4,119,126,1,0,1,2,3,133,
20221008,128,297,금왕꽃동네,동충주,865,2,14,11,51,24,967,667,4,11,7,17,13,719,
20221008,128,522,금왕꽃동네,북단양,280,1,0,5,13,13,312,117,1,0,1,12,4,135,
20221008,128,523,금왕꽃동네,남제천,436,2,5,10,26,6,485,196,1,4,4,19,2,226,
20221008,128,542,금왕꽃동네,서안성,212,5,6,17,13,13,266,157,5,6,8,18,8,202,
20221008,128,543,금왕꽃동네,남안성,452,13,24,35,52,25,601,272,8,18,25,39,12,374,
20221008,128,555,금왕꽃동네,북진천,81,6,5,4,15,2,113,90,3,6,9,12,3,123,
20221008,128,561,금왕꽃동네,북충주,177,3,4,0,2,3,189,114,2,1,0,0,3,120,
20221008,129,101,북대구,서울,278,4,33,3,0,5,323,287,1,16,0,1,8,313,
20221008,129,115,북대구,대전,272,1,5,0,1,7,286,257,4,5,1,1,10,278,
20221008,129,120,북대구,황간,162,1,1,0,0,3,167,99,1,1,1,0,1,103,
20221008,129,122,북대구,김천,461,3,3,0,4,16,487,461,2,5,0,2,22,492,
20221008,129,123,북대구,구미,2357,10,58,8,6,119,2558,2089,16,61,6,2,96,2270,
20221008,129,124,북대구,상주,196,0,4,0,0,10,210,159,0,1,0,0,6,166,
20221008,129,125,북대구,남구미,1889,16,26,12,3,105,2051,1633,14,21,6,6,95,1775,
20221008,129,126,북대구,왜관,3196,68,40,17,84,164,3569,2626,64,30,15,55,115,2905,
20221008,129,127,북대구,서대구,214,6,8,0,4,13,245,731,9,9,6,6,39,800,
20221008,129,130,북대구,동김천,730,5,19,5,41,25,825,528,10,20,4,6,16,584,
20221008,129,131,북대구,경산,1826,69,56,28,30,88,2097,2365,112,76,36,42,132,2763,
20221008,129,132,북대구,영천,800,20,13,14,29,39,915,857,17,26,15,35,56,1006,
20221008,129,133,북대구,건천,275,6,3,8,2,11,305,280,3,4,5,8,11,311,
20221008,129,135,북대구,경주,860,7,5,3,2,35,912,1300,13,14,8,4,68,1407,
20221008,129,151,북대구,북대전,106,0,1,0,0,2,109,113,0,1,0,0,5,119,
20221008,129,153,북대구,서대전,136,1,3,1,2,6,149,103,0,2,2,4,2,113,
20221008,129,190,북대구,동서울,597,2,6,6,1,9,621,507,5,4,12,3,9,540,
20221008,129,203,북대구,가산,734,5,6,3,13,37,798,815,6,6,3,14,32,876,
20221008,129,205,북대구,군위,232,2,2,0,1,6,243,202,2,2,1,0,3,210,
20221008,129,206,북대구,의성,362,1,0,0,0,11,374,342,0,0,1,0,11,354,
20221008,129,207,북대구,남안동,498,3,3,0,3,20,527,480,0,5,1,2,17,505,
20221008,129,208,북대구,서안동,262,0,30,0,0,12,304,273,1,34,1,0,9,318,
20221008,129,210,북대구,영주,274,2,16,1,1,6,300,213,0,15,0,0,4,232,
20221008,129,230,북대구,팔공산,233,2,3,2,0,16,256,295,11,4,2,5,10,327,
20221008,129,231,북대구,화원옥포,440,18,4,4,3,15,484,292,18,3,4,2,11,330,
20221008,129,233,북대구,현풍,253,7,19,0,8,14,301,209,2,13,2,9,11,246,
20221008,129,239,북대구,칠원,219,1,4,0,3,4,231,129,0,2,0,10,4,145,
20221008,129,241,북대구,동고령,222,4,7,6,10,11,260,146,5,11,6,4,4,176,
20221008,129,242,북대구,고령,238,4,3,2,4,10,261,153,2,2,0,25,6,188,
20221008,129,253,북대구,서서울,128,1,0,4,2,5,140,114,0,1,7,0,6,128,
20221008,129,518,북대구,칠곡물류,398,43,32,19,13,31,536,305,32,33,12,8,24,414,
20221008,129,524,북대구,청통와촌,943,19,20,4,24,32,1042,1158,50,21,14,35,44,1322,
20221008,129,525,북대구,북영천,854,10,8,2,5,33,912,957,9,10,9,12,41,1038,
20221008,129,526,북대구,서포항,186,1,2,0,1,6,196,149,3,3,1,2,7,165,
20221008,129,527,북대구,포항,2777,14,13,20,32,112,2968,3157,32,28,14,60,138,3429,
20221008,129,531,북대구,문의청남대,101,1,1,0,0,6,109,117,2,0,1,0,6,126,
20221008,129,536,북대구,남상주,81,0,14,0,0,8,103,95,0,16,0,0,4,115,
20221008,129,565,북대구,문경새재,158,1,0,0,1,8,168,304,3,0,4,0,6,317,
20221008,129,570,북대구,북상주,225,0,0,0,4,8,237,177,1,1,0,1,4,184,
20221008,129,579,북대구,남세종,100,0,2,0,0,1,103,111,0,0,1,1,2,115,
20221008,129,621,북대구,동대구,406,6,7,10,3,19,451,588,19,19,10,23,30,689,
20221008,129,641,북대구,울산,309,3,1,4,1,12,330,405,4,8,5,9,16,447,
20221008,129,723,북대구,북구미,390,3,2,1,2,16,414,432,2,1,0,0,12,447,
20221008,129,725,북대구,임고,200,0,0,0,0,6,206,170,0,0,0,0,2,172,
20221008,129,730,북대구,유천,415,1,2,0,1,7,426,332,0,1,0,0,9,342,
20221008,129,731,북대구,북현풍,135,0,1,0,1,9,146,109,2,1,0,0,6,118,
20221008,129,772,북대구,북달성,403,7,4,1,3,22,440,474,5,4,1,0,28,512,
20221008,129,773,북대구,북다사,214,2,2,1,3,12,234,526,3,6,3,3,25,566,
20221008,130,115,동김천,대전,118,0,0,0,3,10,131,100,0,0,0,0,6,106,
20221008,130,120,동김천,황간,128,2,7,3,5,9,154,90,1,3,9,3,7,113,
20221008,130,122,동김천,김천,201,4,0,1,0,16,222,226,1,3,0,0,16,246,
20221008,130,123,동김천,구미,900,11,9,11,8,59,998,1094,13,15,18,18,58,1216,
20221008,130,125,동김천,남구미,150,10,7,8,7,11,193,229,13,19,7,10,10,288,
20221008,130,127,동김천,서대구,482,6,13,4,5,16,526,621,9,18,9,6,34,697,
20221008,130,129,동김천,북대구,528,10,20,4,6,16,584,730,5,19,5,41,25,825,
20221008,130,131,동김천,경산,67,6,9,8,31,5,126,70,5,9,20,11,4,119,
20221008,130,230,동김천,팔공산,94,0,1,1,0,6,102,96,0,3,0,0,6,105,
20221008,130,527,동김천,포항,110,3,2,0,1,5,121,99,2,0,1,28,6,136,
20221008,130,621,동김천,동대구,92,1,0,2,6,3,104,102,1,1,0,8,5,117,
20221008,130,723,동김천,북구미,391,2,5,1,1,22,422,483,14,2,0,0,20,519,
20221008,130,774,동김천,남칠곡,150,2,3,1,9,4,169,183,5,3,6,4,7,208,
20221008,131,123,경산,구미,234,10,8,7,5,11,275,245,7,10,2,2,11,277,
20221008,131,125,경산,남구미,259,9,22,9,11,14,324,213,8,18,14,4,12,269,
20221008,131,126,경산,왜관,381,48,36,23,41,23,552,350,37,27,21,41,22,498,
20221008,131,127,경산,서대구,1406,81,29,29,36,71,1652,2033,119,49,46,27,93,2367,
20221008,131,129,경산,북대구,2365,112,76,36,42,132,2763,1826,69,56,28,30,88,2097,
20221008,131,130,경산,동김천,70,5,9,20,11,4,119,67,6,9,8,31,5,126,
20221008,131,132,경산,영천,676,23,24,17,25,29,794,534,24,26,16,19,25,644,
20221008,131,133,경산,건천,449,18,22,5,26,23,543,347,10,11,2,24,23,417,
20221008,131,135,경산,경주,750,10,21,5,5,36,827,840,19,33,6,6,47,951,
20221008,131,201,경산,칠곡,205,10,6,3,4,6,234,287,8,6,5,5,13,324,
20221008,131,203,경산,가산,81,11,5,9,6,6,118,106,8,9,10,10,8,151,
20221008,131,230,경산,팔공산,1018,41,25,7,11,73,1175,1179,38,34,15,16,74,1356,
20221008,131,231,경산,화원옥포,181,9,12,3,14,8,227,182,7,6,7,11,10,223,
20221008,131,233,경산,현풍,95,12,17,4,15,5,148,116,8,10,14,8,5,161,
20221008,131,241,경산,동고령,80,3,10,4,3,4,104,79,1,10,10,4,1,105,
20221008,131,242,경산,고령,126,3,12,5,14,5,165,87,0,9,5,7,1,109,
20221008,131,518,경산,칠곡물류,118,34,28,22,9,3,214,106,32,19,32,15,3,207,
20221008,131,621,경산,동대구,1836,37,25,5,40,102,2045,1796,42,25,12,17,92,1984,
20221008,131,641,경산,울산,245,7,14,14,18,8,306,269,2,14,9,28,9,331,
20221008,131,730,경산,유천,253,13,5,0,1,12,284,220,6,0,0,0,6,232,
20221008,131,772,경산,북달성,179,7,6,10,12,8,222,200,14,10,7,3,11,245,
20221008,131,773,경산,북다사,99,5,2,3,2,4,115,136,11,8,3,1,2,161,
20221008,131,776,경산,연경,697,30,23,6,13,40,809,808,25,22,11,19,45,930,
20221008,131,777,경산,파군재,181,2,2,4,0,6,195,201,0,2,5,1,10,219,
20221008,131,779,경산,율암,510,6,7,2,9,29,563,201,2,2,2,5,16,228,
20221008,132,126,영천,왜관,139,5,19,17,21,3,204,122,9,18,16,13,5,183,
20221008,132,127,영천,서대구,464,18,35,14,25,15,571,722,19,34,26,23,35,859,
20221008,132,129,영천,북대구,857,17,26,15,35,56,1006,800,20,13,14,29,39,915,
20221008,132,131,영천,경산,534,24,26,16,19,25,644,676,23,24,17,25,29,794,
20221008,132,135,영천,경주,157,3,2,3,6,7,178,267,1,5,3,3,10,289,
20221008,132,140,영천,부산,255,2,4,1,5,6,273,277,3,2,1,5,16,304,
20221008,132,230,영천,팔공산,371,9,7,3,8,10,408,467,4,13,5,6,24,519,
20221008,132,252,영천,대동,120,4,1,7,7,14,153,177,3,3,9,21,12,225,
20221008,132,621,영천,동대구,1169,7,21,3,33,43,1276,1359,11,23,2,30,52,1477,
20221008,132,641,영천,울산,262,3,16,11,11,9,312,325,3,15,5,10,15,373,
20221008,132,730,영천,유천,111,0,1,0,1,2,115,102,2,0,0,0,1,105,
20221008,132,776,영천,연경,152,3,5,4,7,9,180,272,4,1,1,7,8,293,
20221008,132,779,영천,율암,283,3,2,1,5,18,312,236,1,1,0,2,9,249,
20221008,133,127,건천,서대구,183,5,2,2,4,1,197,304,4,10,4,7,13,342,
20221008,133,129,건천,북대구,280,3,4,5,8,11,311,275,6,3,8,2,11,305,
20221008,133,131,건천,경산,347,10,11,2,24,23,417,449,18,22,5,26,23,543,
20221008,133,135,건천,경주,186,3,0,4,6,4,203,384,5,2,6,11,8,416,
20221008,133,140,건천,부산,224,2,3,1,3,10,243,332,1,7,0,2,16,358,
20221008,133,230,건천,팔공산,114,1,0,0,1,0,116,161,1,2,0,1,7,172,
20221008,133,252,건천,대동,193,7,6,3,19,9,237,292,7,14,7,11,10,341,
20221008,133,621,건천,동대구,417,4,2,1,1,17,442,521,3,12,2,3,22,563,
20221008,133,641,건천,울산,118,0,2,2,10,5,137,194,2,1,3,9,3,212,
20221008,133,779,건천,율암,182,0,3,1,5,8,199,104,2,1,0,0,8,115,
20221008,134,127,선산,서대구,133,4,1,0,1,6,145,150,1,2,0,1,6,160,
20221008,135,115,경주,대전,134,1,2,3,0,5,145,173,2,0,3,0,14,192,
20221008,135,123,경주,구미,235,1,3,0,1,8,248,208,0,1,2,0,8,219,
20221008,135,125,경주,남구미,172,2,16,2,5,3,200,176,2,7,3,1,4,193,
20221008,135,126,경주,왜관,197,6,6,4,27,6,246,160,7,9,4,15,10,205,
20221008,135,127,경주,서대구,847,10,26,14,1,30,928,963,12,21,18,2,45,1061,
20221008,135,129,경주,북대구,1300,13,14,8,4,68,1407,860,7,5,3,2,35,912,
20221008,135,131,경주,경산,840,19,33,6,6,47,951,750,10,21,5,5,36,827,
20221008,135,132,경주,영천,267,1,5,3,3,10,289,157,3,2,3,6,7,178,
20221008,135,133,경주,건천,384,5,2,6,11,8,416,186,3,0,4,6,4,203,
20221008,135,137,경주,통도사,243,4,1,2,6,15,271,235,4,3,5,5,16,268,
20221008,135,138,경주,양산,431,7,9,3,14,20,484,435,11,8,5,11,25,495,
20221008,135,139,경주,서울산,554,3,30,2,7,24,620,432,3,23,5,3,16,482,
20221008,135,140,경주,부산,2548,6,15,6,15,109,2699,2565,8,23,4,14,124,2738,
20221008,135,146,경주,동창원,136,0,3,0,0,10,149,153,0,3,1,2,14,173,
20221008,135,148,경주,서김해,421,1,11,6,13,18,470,469,0,17,6,5,22,519,
20221008,135,149,경주,동김해,277,3,7,1,5,19,312,278,2,7,3,8,19,317,
20221008,135,230,경주,팔공산,486,4,1,1,1,20,513,459,3,3,2,2,18,487,
20221008,135,245,경주,장유,527,2,11,3,11,27,581,495,2,2,0,9,20,528,
20221008,135,250,경주,남양산,587,6,17,2,3,27,642,678,3,18,1,4,30,734,
20221008,135,251,경주,물금,118,4,2,1,4,2,131,138,4,3,1,3,4,153,
20221008,135,252,경주,대동,1871,8,64,17,54,86,2100,2340,12,66,10,30,81,2539,
20221008,135,261,경주,동광주,123,1,4,1,2,5,136,295,1,8,1,2,8,315,
20221008,135,289,경주,마산,339,0,9,1,3,19,371,462,2,9,1,2,17,493,
20221008,135,529,경주,노포,160,1,63,0,0,13,237,143,0,54,0,0,8,205,
20221008,135,621,경주,동대구,1250,8,46,0,1,40,1345,1274,4,34,1,0,56,1369,
20221008,135,641,경주,울산,493,2,30,3,3,40,571,502,0,30,1,9,36,578,
20221008,135,730,경주,유천,182,2,0,0,0,10,194,148,0,0,0,0,5,153,
20221008,135,755,경주,광재,95,0,2,4,7,9,117,123,1,2,3,4,6,139,
20221008,135,757,경주,진영,93,3,1,0,8,5,110,98,4,0,1,2,6,111,
20221008,135,776,경주,연경,264,2,0,1,0,12,279,240,3,1,3,0,8,255,
20221008,135,779,경주,율암,639,7,1,0,0,33,680,260,0,1,0,0,7,268,
20221008,136,101,음성,서울,131,5,19,3,5,4,167,397,2,25,1,3,6,434,
20221008,136,106,음성,오산,124,2,3,3,2,5,139,332,1,3,4,3,9,352,
20221008,136,128,음성,금왕꽃동네,168,10,4,3,3,12,200,209,8,5,1,4,13,240,
20221008,136,190,음성,동서울,587,8,10,11,17,28,661,936,5,6,9,10,29,995,
20221008,136,192,음성,곤지암,106,1,2,0,0,5,114,129,1,0,1,0,11,142,
20221008,136,240,음성,제천,98,0,3,1,1,4,107,93,1,1,1,1,4,101,
20221008,136,253,음성,서서울,159,4,5,4,0,4,176,282,1,3,8,4,12,310,
20221008,136,297,음성,동충주,481,7,13,13,88,21,623,418,6,12,4,51,14,505,
20221008,136,520,음성,평택,171,1,1,0,0,4,177,332,1,0,1,1,8,343,
20221008,136,522,음성,북단양,144,0,3,6,27,5,185,92,0,1,2,16,1,112,
20221008,136,523,음성,남제천,248,2,4,7,32,7,300,160,5,8,2,78,6,259,
20221008,136,528,음성,기흥동탄,106,1,0,0,2,4,113,187,1,0,0,7,3,198,
20221008,136,540,음성,청북,183,1,3,1,3,2,193,289,1,4,5,6,14,319,
20221008,136,541,음성,송탄,117,2,5,3,2,5,134,212,2,5,3,1,12,235,
20221008,136,542,음성,서안성,431,2,5,5,5,16,464,730,4,7,15,18,24,798,
20221008,136,543,음성,남안성,432,7,28,20,25,14,526,911,4,26,26,34,18,1019,
20221008,136,555,음성,북진천,120,8,9,13,11,6,167,322,2,4,10,5,16,359,
20221008,136,673,음성,북오산,93,0,1,2,0,6,102,153,0,1,5,0,8,167,
20221008,137,135,통도사,경주,235,4,3,5,5,16,268,243,4,1,2,6,15,271,
20221008,137,138,통도사,양산,327,27,30,7,18,14,423,327,29,26,6,3,21,412,
20221008,137,139,통도사,서울산,115,3,0,0,1,9,128,257,4,5,1,0,8,275,
20221008,137,140,통도사,부산,889,33,11,4,17,49,1003,1098,23,14,3,17,46,1201,
20221008,137,250,통도사,남양산,337,12,10,4,77,15,455,415,14,15,3,73,32,552,
20221008,137,252,통도사,대동,485,23,20,15,22,27,592,602,15,17,13,22,41,710,
20221008,137,641,통도사,울산,626,30,15,7,6,37,721,730,22,19,7,6,39,823,
20221008,137,771,통도사,배내골,238,4,3,0,0,9,254,215,1,4,0,0,10,230,
20221008,138,135,양산,경주,435,11,8,5,11,25,495,431,7,9,3,14,20,484,
20221008,138,137,양산,통도사,327,29,26,6,3,21,412,327,27,30,7,18,14,423,
20221008,138,139,양산,서울산,704,29,30,12,4,54,833,777,22,38,17,14,62,930,
20221008,138,140,양산,부산,3902,172,96,40,61,192,4463,4266,197,102,34,54,209,4862,
20221008,138,148,양산,서김해,241,19,12,13,5,10,300,227,27,13,9,5,13,294,
20221008,138,149,양산,동김해,309,22,8,3,4,23,369,312,31,6,9,7,13,378,
20221008,138,245,양산,장유,191,30,10,25,3,17,276,192,21,9,9,5,15,251,
20221008,138,250,양산,남양산,192,8,3,8,26,16,253,384,11,5,2,21,19,442,
20221008,138,251,양산,물금,110,11,5,17,14,5,162,109,18,7,9,15,8,166,
20221008,138,252,양산,대동,1746,176,77,63,91,75,2228,1973,162,51,69,97,83,2435,
20221008,138,286,양산,통도사휴게소,239,5,0,0,0,13,257,284,5,1,0,0,14,304,
20221008,138,289,양산,마산,216,20,11,14,11,9,281,161,10,10,4,10,7,202,
20221008,138,529,양산,노포,327,16,7,5,3,30,388,266,9,5,1,4,21,306,
20221008,138,641,양산,울산,506,66,36,20,8,31,667,595,43,50,20,5,36,749,
20221008,138,722,양산,활천,111,9,5,6,3,6,140,96,5,7,9,2,4,123,
20221008,138,755,양산,광재,126,11,10,3,8,1,159,140,9,13,3,9,4,178,
20221008,139,135,서울산,경주,432,3,23,5,3,16,482,554,3,30,2,7,24,620,
20221008,139,137,서울산,통도사,257,4,5,1,0,8,275,115,3,0,0,1,9,128,
20221008,139,138,서울산,양산,777,22,38,17,14,62,930,704,29,30,12,4,54,833,
20221008,139,140,서울산,부산,2065,39,20,1,6,92,2223,2260,36,17,3,7,105,2428,
20221008,139,148,서울산,서김해,212,3,5,1,2,13,236,168,2,2,1,1,6,180,
20221008,139,149,서울산,동김해,196,2,21,0,0,10,229,156,2,16,4,0,7,185,
20221008,139,245,서울산,장유,177,1,1,0,1,7,187,168,2,6,0,2,5,183,
20221008,139,250,서울산,남양산,716,10,9,2,4,44,785,764,6,9,6,6,43,834,
20221008,139,251,서울산,물금,161,13,6,9,5,13,207,162,8,8,9,3,9,199,
20221008,139,252,서울산,대동,1282,19,18,14,38,76,1447,1287,20,16,14,20,68,1425,
20221008,139,289,서울산,마산,239,2,5,0,2,5,253,158,1,0,2,3,5,169,
20221008,139,529,서울산,노포,201,3,3,0,1,11,219,176,6,1,0,0,11,194,
20221008,139,641,서울산,울산,1676,23,34,11,26,112,1882,1750,19,40,3,34,82,1928,
20221008,139,642,서울산,문수,86,2,10,3,6,8,115,96,1,9,1,2,3,112,
20221008,139,707,서울산,남포항,127,0,0,0,5,7,139,91,0,2,0,3,5,101,
20221008,139,752,서울산,기장철마,110,2,1,1,1,5,120,127,0,2,0,0,4,133,
20221008,139,771,서울산,배내골,281,0,0,0,0,14,295,216,0,1,0,0,6,223,
20221008,140,132,부산,영천,277,3,2,1,5,16,304,255,2,4,1,5,6,273,
20221008,140,133,부산,건천,332,1,7,0,2,16,358,224,2,3,1,3,10,243,
20221008,140,135,부산,경주,2565,8,23,4,14,124,2738,2548,6,15,6,15,109,2699,
20221008,140,137,부산,통도사,1098,23,14,3,17,46,1201,889,33,11,4,17,49,1003,
20221008,140,138,부산,양산,4266,197,102,34,54,209,4862,3902,172,96,40,61,192,4463,
20221008,140,139,부산,서울산,2260,36,17,3,7,105,2428,2065,39,20,1,6,92,2223,
20221008,140,146,부산,동창원,611,3,1,5,2,27,649,348,5,2,2,0,15,372,
20221008,140,148,부산,서김해,94,1,0,0,0,8,103,106,2,1,0,0,7,116,
20221008,140,245,부산,장유,102,1,0,0,0,7,110,123,0,0,1,0,9,133,
20221008,140,250,부산,남양산,7989,109,175,19,19,536,8847,7838,96,158,16,19,533,8660,
20221008,140,251,부산,물금,869,107,17,22,29,39,1083,1047,85,13,28,28,48,1249,
20221008,140,252,부산,대동,1115,25,32,23,36,80,1311,1036,20,26,19,87,65,1253,
20221008,140,286,부산,통도사휴게소,1042,4,4,0,0,34,1084,1124,3,3,0,0,27,1157,
20221008,140,289,부산,마산,1692,7,12,4,5,52,1772,1404,14,9,3,4,54,1488,
20221008,140,291,부산,사천,116,0,1,2,0,4,123,100,0,1,0,0,4,105,
20221008,140,641,부산,울산,540,4,7,0,0,24,575,514,4,7,0,1,29,555,
20221008,140,722,부산,활천,429,7,5,1,7,16,465,206,14,5,0,6,8,239,
20221008,140,754,부산,김해가야휴게소,159,4,0,0,0,4,167,130,2,0,0,0,1,133,
20221008,140,755,부산,광재,1110,9,14,6,12,56,1207,941,9,9,5,17,54,1035,
20221008,140,756,부산,한림,247,7,4,4,28,18,308,239,4,3,6,11,14,277,
20221008,140,757,부산,진영,715,7,7,8,18,34,789,597,4,6,10,3,24,644,
20221008,140,771,부산,배내골,459,2,1,0,0,24,486,277,1,0,0,0,16,294,
20221008,142,144,군북,함안,457,11,18,12,15,44,557,591,14,22,10,8,50,695,
20221008,142,145,군북,산인,4792,40,78,31,47,263,5251,5792,39,72,26,38,285,6252,
20221008,142,146,군북,동창원,89,4,3,6,8,7,117,102,0,3,12,4,3,124,
20221008,142,148,군북,서김해,138,3,4,2,2,9,158,147,0,1,1,1,11,161,
20221008,142,150,군북,북부산,453,1,5,0,3,19,481,542,2,9,1,1,19,574,
20221008,142,238,군북,칠서,71,4,2,6,41,2,126,104,3,2,2,19,6,136,
20221008,142,244,군북,서부산,428,3,5,0,11,24,471,581,4,3,3,15,25,631,
20221008,142,245,군북,장유,128,2,1,4,1,6,142,142,0,2,2,2,8,156,
20221008,142,291,군북,사천,166,5,11,5,16,4,207,163,13,14,4,5,10,209,
20221008,142,292,군북,진주,156,7,6,2,18,3,192,146,3,5,2,6,5,167,
20221008,142,293,군북,문산,179,8,7,2,3,8,207,160,4,3,2,3,9,181,
20221008,142,294,군북,북창원,264,7,3,2,6,18,300,594,8,4,2,12,31,651,
20221008,142,295,군북,진성,118,0,6,1,17,5,147,117,1,4,2,3,6,133,
20221008,143,145,장지,산인,929,5,16,8,26,67,1051,927,7,12,11,26,62,1045,
20221008,144,142,함안,군북,591,14,22,10,8,50,695,457,11,18,12,15,44,557,
20221008,144,145,함안,산인,2252,19,23,18,73,153,2538,2329,34,15,12,59,148,2597,
20221008,144,150,함안,북부산,150,1,0,4,8,6,169,147,1,1,0,22,9,180,
20221008,144,244,함안,서부산,184,3,3,0,21,11,222,215,4,5,0,6,12,242,
20221008,144,291,함안,사천,295,5,6,6,7,10,329,217,4,6,5,6,11,249,
20221008,144,292,함안,진주,293,8,2,4,7,20,334,271,4,2,3,11,20,311,
20221008,144,293,함안,문산,274,8,1,4,6,20,313,230,3,2,3,2,11,251,
20221008,144,294,함안,북창원,225,8,9,3,6,24,275,338,9,13,4,2,23,389,
20221008,144,295,함안,진성,192,5,9,7,6,11,230,187,9,4,3,2,18,223,
20221008,145,142,산인,군북,5792,39,72,26,38,285,6252,4792,40,78,31,47,263,5251,
20221008,145,143,산인,장지,927,7,12,11,26,62,1045,929,5,16,8,26,67,1051,
20221008,145,144,산인,함안,2329,34,15,12,59,148,2597,2252,19,23,18,73,153,2538,
20221008,145,221,산인,생초,390,0,1,0,1,14,406,128,0,3,0,0,3,134,
20221008,145,222,산인,산청,599,2,0,1,0,22,624,348,3,2,0,0,15,368,
20221008,145,223,산인,단성,708,1,5,1,6,34,755,320,1,8,1,0,19,349,
20221008,145,224,산인,함양,347,0,5,0,3,15,370,165,0,7,0,9,11,192,
20221008,145,225,산인,서진주,632,10,4,4,1,26,677,559,13,2,1,1,27,603,
20221008,145,247,산인,남원,208,0,5,0,0,5,218,112,0,2,0,0,3,117,
20221008,145,261,산인,동광주,619,5,76,10,6,11,727,721,2,67,8,9,11,818,
20221008,145,267,산인,주암송광사,153,0,0,0,0,4,157,116,0,1,1,0,1,119,
20221008,145,271,산인,순천,278,0,5,0,3,8,294,266,0,4,1,1,8,280,
20221008,145,272,산인,광양,2091,9,54,14,12,54,2234,1201,7,43,18,4,34,1307,
20221008,145,273,산인,동광양,86,0,0,0,25,3,114,127,1,0,0,8,2,138,
20221008,145,275,산인,옥곡,526,1,30,6,34,13,610,613,0,31,10,32,12,698,
20221008,145,277,산인,하동,1133,1,2,6,11,40,1193,717,5,5,1,13,27,768,
20221008,145,278,산인,진교,1147,3,17,1,2,40,1210,590,2,13,0,1,18,624,
20221008,145,279,산인,곤양,385,0,10,1,0,16,412,223,0,9,2,2,6,242,
20221008,145,291,산인,사천,3059,27,49,12,22,114,3283,2331,44,45,13,17,94,2544,
20221008,145,292,산인,진주,1979,20,143,3,16,108,2269,2225,20,150,10,19,85,2509,
20221008,145,293,산인,문산,1741,18,20,10,9,73,1871,1601,23,16,5,11,81,1737,
20221008,145,295,산인,진성,1290,13,10,5,9,59,1386,1135,11,15,6,9,42,1218,
20221008,145,296,산인,지수,296,3,6,3,5,11,324,175,6,3,3,5,7,199,
20221008,145,544,산인,완주,457,4,13,5,14,11,504,373,0,13,6,19,10,421,
20221008,145,545,산인,소양,444,1,33,0,2,18,498,238,0,31,2,0,3,274,
20221008,145,556,산인,동순천,182,0,9,0,1,5,197,222,1,16,0,1,10,250,
20221008,145,569,산인,북광주,159,1,4,8,8,3,183,191,2,6,8,16,4,227,
20221008,146,135,동창원,경주,153,0,3,1,2,14,173,136,0,3,0,0,10,149,
20221008,146,140,동창원,부산,348,5,2,2,0,15,372,611,3,1,5,2,27,649,
20221008,146,142,동창원,군북,102,0,3,12,4,3,124,89,4,3,6,8,7,117,
20221008,146,147,동창원,진례,144,11,8,1,1,10,175,233,12,13,4,7,17,286,
20221008,146,148,동창원,서김해,318,6,4,2,3,26,359,633,7,14,1,2,34,691,
20221008,146,149,동창원,동김해,334,6,8,4,1,27,380,439,6,8,6,4,29,492,
20221008,146,150,동창원,북부산,1215,8,11,5,8,67,1314,1907,6,8,5,13,82,2021,
20221008,146,244,동창원,서부산,1345,8,21,8,16,93,1491,2407,19,31,9,45,121,2632,
20221008,146,245,동창원,장유,903,9,2,2,1,82,999,1174,7,12,5,2,86,1286,
20221008,146,250,동창원,남양산,192,6,2,1,0,9,210,256,6,3,1,2,11,279,
20221008,146,251,동창원,물금,172,10,4,1,0,13,200,245,7,4,3,5,13,277,
20221008,146,289,동창원,마산,2682,51,41,20,41,205,3040,2417,55,38,15,37,178,2740,
20221008,146,294,동창원,북창원,97,3,3,1,2,4,110,155,1,4,0,3,13,176,
20221008,146,641,동창원,울산,126,0,0,2,0,6,134,209,0,0,1,4,9,223,
20221008,146,752,동창원,기장철마,135,1,0,0,0,4,140,205,1,0,0,1,1,208,
20221008,146,753,동창원,금정,120,2,1,0,0,8,131,134,2,2,0,1,5,144,
20221008,146,755,동창원,광재,141,10,1,1,3,9,165,203,13,3,4,34,9,266,
20221008,147,146,진례,동창원,233,12,13,4,7,17,286,144,11,8,1,1,10,175,
20221008,147,148,진례,서김해,165,6,13,8,3,14,209,219,10,8,4,5,23,269,
20221008,147,149,진례,동김해,281,10,8,10,8,18,335,320,14,8,7,6,18,373,
20221008,147,150,진례,북부산,778,21,14,15,33,51,912,962,25,12,10,18,68,1095,
20221008,147,244,진례,서부산,1058,35,22,29,64,68,1276,1201,47,24,23,65,88,1448,
20221008,147,245,진례,장유,737,25,32,24,14,63,895,816,19,38,21,13,77,984,
20221008,147,289,진례,마산,678,38,35,23,55,46,875,759,47,31,26,59,51,973,
20221008,147,294,진례,북창원,94,3,2,1,2,11,113,126,1,4,3,0,13,147,
20221008,148,135,서김해,경주,469,0,17,6,5,22,519,421,1,11,6,13,18,470,
20221008,148,138,서김해,양산,227,27,13,9,5,13,294,241,19,12,13,5,10,300,
20221008,148,139,서김해,서울산,168,2,2,1,1,6,180,212,3,5,1,2,13,236,
20221008,148,140,서김해,부산,106,2,1,0,0,7,116,94,1,0,0,0,8,103,
20221008,148,142,서김해,군북,147,0,1,1,1,11,161,138,3,4,2,2,9,158,
20221008,148,146,서김해,동창원,633,7,14,1,2,34,691,318,6,4,2,3,26,359,
20221008,148,147,서김해,진례,219,10,8,4,5,23,269,165,6,13,8,3,14,209,
20221008,148,149,서김해,동김해,528,15,13,9,8,51,624,605,12,14,4,5,53,693,
20221008,148,150,서김해,북부산,6421,74,70,40,62,462,7129,6536,67,54,35,35,449,7176,
20221008,148,250,서김해,남양산,999,17,15,13,7,65,1116,852,21,17,3,4,52,949,
20221008,148,251,서김해,물금,1004,33,14,18,12,66,1147,946,32,12,31,10,62,1093,
20221008,148,289,서김해,마산,1958,13,46,3,5,97,2122,1859,22,48,5,11,100,2045,
20221008,148,291,서김해,사천,124,1,0,0,0,6,131,108,2,1,0,1,6,118,
20221008,148,292,서김해,진주,91,1,1,1,2,8,104,91,0,2,0,1,6,100,
20221008,148,294,서김해,북창원,219,0,3,0,3,23,248,246,4,0,1,7,24,282,
20221008,148,529,서김해,노포,169,0,4,2,3,15,193,300,6,11,8,5,25,355,
20221008,148,641,서김해,울산,395,5,17,15,3,34,469,504,5,20,16,7,17,569,
20221008,149,135,동김해,경주,278,2,7,3,8,19,317,277,3,7,1,5,19,312,
20221008,149,138,동김해,양산,312,31,6,9,7,13,378,309,22,8,3,4,23,369,
20221008,149,139,동김해,서울산,156,2,16,4,0,7,185,196,2,21,0,0,10,229,
20221008,149,146,동김해,동창원,439,6,8,6,4,29,492,334,6,8,4,1,27,380,
20221008,149,147,동김해,진례,320,14,8,7,6,18,373,281,10,8,10,8,18,335,
20221008,149,148,동김해,서김해,605,12,14,4,5,53,693,528,15,13,9,8,51,624,
20221008,149,150,동김해,북부산,10762,142,131,32,60,760,11887,9222,123,114,26,27,608,10120,
20221008,149,245,동김해,장유,770,19,38,9,10,55,901,552,22,27,8,2,37,648,
20221008,149,250,동김해,남양산,1003,11,51,5,6,92,1168,904,11,41,7,3,69,1035,
20221008,149,251,동김해,물금,1076,39,11,10,1,107,1244,972,36,12,8,3,102,1133,
20221008,149,289,동김해,마산,1046,18,32,14,5,61,1176,1093,14,27,13,8,57,1212,
20221008,149,294,동김해,북창원,105,0,0,0,1,10,116,122,0,1,1,1,12,137,
20221008,149,529,동김해,노포,159,1,0,0,4,8,172,282,4,3,1,0,20,310,
20221008,149,641,동김해,울산,343,1,3,2,1,28,378,399,10,4,1,2,25,441,
20221008,150,142,북부산,군북,542,2,9,1,1,19,574,453,1,5,0,3,19,481,
20221008,150,144,북부산,함안,147,1,1,0,22,9,180,150,1,0,4,8,6,169,
20221008,150,146,북부산,동창원,1907,6,8,5,13,82,2021,1215,8,11,5,8,67,1314,
20221008,150,147,북부산,진례,962,25,12,10,18,68,1095,778,21,14,15,33,51,912,
20221008,150,148,북부산,서김해,6536,67,54,35,35,449,7176,6421,74,70,40,62,462,7129,
20221008,150,149,북부산,동김해,9222,123,114,26,27,608,10120,10762,142,131,32,60,760,11887,
20221008,150,235,북부산,창녕,134,2,2,1,0,8,147,125,4,3,1,0,6,139,
20221008,150,237,북부산,남지,117,2,0,0,6,8,133,102,4,0,2,7,5,120,
20221008,150,238,북부산,칠서,128,3,1,6,2,5,145,152,6,6,14,17,5,200,
20221008,150,245,북부산,장유,4282,35,69,15,23,252,4676,3726,33,81,4,12,228,4084,
20221008,150,261,북부산,동광주,140,2,3,1,0,3,149,235,1,2,3,1,3,245,
20221008,150,272,북부산,광양,409,2,3,0,1,16,431,281,0,3,1,2,7,294,
20221008,150,275,북부산,옥곡,95,0,2,2,10,2,111,146,2,2,1,30,3,184,
20221008,150,277,북부산,하동,181,0,1,3,2,10,197,162,0,0,0,2,4,168,
20221008,150,278,북부산,진교,178,0,1,0,0,7,186,131,1,1,0,0,5,138,
20221008,150,280,북부산,거창,112,3,1,0,0,8,124,103,2,1,0,1,5,112,
20221008,150,289,북부산,마산,5155,22,109,6,12,187,5491,4986,23,98,13,28,204,5352,
20221008,150,291,북부산,사천,456,2,2,0,1,16,477,421,2,4,0,8,13,448,
20221008,150,292,북부산,진주,220,2,11,1,0,8,242,363,3,5,4,2,15,392,
20221008,150,293,북부산,문산,246,2,2,2,0,11,263,281,1,1,0,1,16,300,
20221008,150,294,북부산,북창원,355,0,1,0,3,12,371,468,5,2,1,4,11,491,
20221008,150,295,북부산,진성,167,0,1,0,0,8,176,167,1,0,0,2,3,173,
20221008,151,101,북대전,서울,436,3,126,1,1,10,577,246,4,142,3,0,13,408,
20221008,151,108,북대전,천안,218,5,3,1,0,11,238,112,0,5,0,1,4,122,
20221008,151,109,북대전,계룡,169,2,2,6,16,15,210,189,3,4,11,17,19,243,
20221008,151,111,북대전,청주,196,0,1,0,1,4,202,179,5,2,2,1,9,198,
20221008,151,112,북대전,남청주,334,15,4,3,4,20,380,323,19,4,2,4,20,372,
20221008,151,113,북대전,신탄진,143,1,1,1,7,6,159,130,0,1,3,0,9,143,
20221008,151,114,북대전,남대전,198,3,5,10,8,8,232,267,3,5,21,7,11,314,
20221008,151,115,북대전,대전,636,7,1,3,5,49,701,744,9,2,1,5,54,815,
20221008,151,116,북대전,옥천,603,5,5,6,5,31,655,680,13,5,6,12,32,748,
20221008,151,119,북대전,판암,340,2,4,6,6,33,391,532,8,6,1,9,45,601,
20221008,151,129,북대전,북대구,113,0,1,0,0,5,119,106,0,1,0,0,2,109,
20221008,151,152,북대전,유성,381,5,5,4,2,19,416,504,5,6,6,11,30,562,
20221008,151,153,북대전,서대전,543,15,6,12,17,42,635,743,14,11,15,17,47,847,
20221008,151,154,북대전,안영,296,4,9,3,15,11,338,275,10,6,6,19,18,334,
20221008,151,155,북대전,논산,146,1,5,17,10,11,190,134,0,6,11,11,8,170,
20221008,151,156,북대전,익산,127,4,6,6,19,3,165,113,2,4,4,19,2,144,
20221008,151,158,북대전,전주,156,3,5,9,8,5,186,98,2,3,4,7,7,121,
20221008,151,167,북대전,광주,166,1,1,21,14,6,209,122,2,3,10,5,5,147,
20221008,151,190,북대전,동서울,526,1,8,1,0,15,551,357,2,7,2,0,13,381,
20221008,151,196,북대전,진천,111,8,6,0,2,3,130,109,1,3,1,4,3,121,
20221008,151,197,북대전,증평,228,0,0,1,2,10,241,122,0,2,1,0,5,130,
20221008,151,198,북대전,서청주,439,0,0,1,0,34,474,358,2,1,0,0,25,386,
20221008,151,199,북대전,오창,408,3,0,0,2,9,422,219,1,3,3,2,8,236,
20221008,151,200,북대전,금산,168,0,3,1,4,12,188,162,0,3,3,2,10,180,
20221008,151,204,북대전,추부,183,1,1,2,2,4,193,149,2,2,2,2,3,160,
20221008,151,227,북대전,군산,134,0,0,0,3,3,140,97,0,0,0,0,4,101,
20221008,151,298,북대전,서산,200,1,4,3,6,9,223,170,0,2,4,7,3,186,
20221008,151,573,북대전,예산수덕사,451,5,4,6,5,15,486,287,4,3,2,4,13,313,
20221008,151,578,북대전,서세종,446,9,3,3,3,10,474,222,9,2,1,1,6,241,
20221008,151,579,북대전,남세종,201,2,5,2,10,8,228,184,0,3,2,9,11,209,
20221008,151,595,북대전,서공주,304,0,3,4,5,15,331,273,2,4,1,3,3,286,
20221008,152,101,유성,서울,267,5,101,3,1,8,385,228,6,75,7,1,6,323,
20221008,152,109,유성,계룡,245,13,4,5,11,10,288,347,13,6,4,12,22,404,
20221008,152,111,유성,청주,152,1,5,0,1,4,163,94,3,4,1,2,5,109,
20221008,152,112,유성,남청주,465,17,34,9,1,22,548,470,28,34,6,4,23,565,
20221008,152,113,유성,신탄진,421,2,6,5,4,33,471,353,3,6,2,7,24,395,
20221008,152,114,유성,남대전,605,10,4,8,3,32,662,693,14,10,14,2,36,769,
20221008,152,115,유성,대전,619,6,12,1,4,38,680,465,9,7,0,1,35,517,
20221008,152,116,유성,옥천,500,9,2,0,1,28,540,415,9,4,2,1,22,453,
20221008,152,119,유성,판암,446,9,2,1,1,13,472,472,7,3,0,0,24,506,
20221008,152,151,유성,북대전,504,5,6,6,11,30,562,381,5,5,4,2,19,416,
20221008,152,153,유성,서대전,451,5,8,3,3,18,488,610,2,7,2,5,37,663,
20221008,152,154,유성,안영,1142,12,31,4,36,57,1282,1040,15,18,11,31,58,1173,
20221008,152,155,유성,논산,714,8,18,11,10,38,799,788,8,18,9,9,32,864,
20221008,152,156,유성,익산,749,8,10,3,13,31,814,658,9,12,4,6,28,717,
20221008,152,157,유성,삼례,141,1,1,0,0,6,149,108,1,2,1,1,2,115,
20221008,152,158,유성,전주,882,12,59,8,7,37,1005,706,5,62,1,12,29,815,
20221008,152,159,유성,서전주,364,3,0,2,0,16,385,406,2,2,0,2,13,425,
20221008,152,162,유성,태인,121,0,3,1,1,3,129,107,0,1,0,1,1,110,
20221008,152,163,유성,정읍,179,0,3,4,1,2,189,190,1,1,4,0,8,204,
20221008,152,164,유성,무주,332,1,0,0,0,5,338,188,2,0,1,0,4,195,
20221008,152,167,유성,광주,788,4,39,7,0,22,860,594,2,34,11,2,13,656,
20221008,152,190,유성,동서울,532,1,5,18,2,22,580,341,1,3,6,2,11,364,
20221008,152,196,유성,진천,140,3,2,1,3,6,155,120,5,2,7,4,7,145,
20221008,152,197,유성,증평,237,0,7,4,2,6,256,163,2,4,6,2,3,180,
20221008,152,198,유성,서청주,436,6,4,1,3,25,475,312,3,3,4,2,23,347,
20221008,152,199,유성,오창,397,3,12,1,0,12,425,196,2,11,2,1,8,220,
20221008,152,200,유성,금산,427,1,7,2,0,18,455,293,1,5,1,0,16,316,
20221008,152,204,유성,추부,447,5,2,2,2,41,499,345,4,0,1,1,29,380,
20221008,152,298,유성,서산,401,2,0,1,0,17,421,364,2,2,4,2,19,393,
20221008,152,544,유성,완주,282,1,2,0,0,6,291,206,1,0,1,0,3,211,
20221008,152,556,유성,동순천,353,1,9,2,0,8,373,189,1,4,1,0,1,196,
20221008,152,571,유성,면천,160,3,2,1,1,8,175,156,1,2,0,1,4,164,
20221008,152,572,유성,고덕,117,0,0,2,3,5,127,103,0,0,1,1,3,108,
20221008,152,573,유성,예산수덕사,876,3,1,1,3,34,918,831,8,3,1,3,38,884,
20221008,152,574,유성,신양,127,2,2,0,0,5,136,137,1,2,0,0,6,146,
20221008,152,575,유성,유구,165,4,1,0,0,9,179,186,4,1,0,1,6,198,
20221008,152,576,유성,마곡사,167,0,0,2,2,5,176,165,2,1,2,1,6,177,
20221008,152,578,유성,서세종,554,17,1,0,5,13,590,483,22,6,0,3,24,538,
20221008,152,579,유성,남세종,192,4,7,2,2,10,217,429,7,5,3,4,18,466,
20221008,152,590,유성,동전주,287,1,0,1,0,24,313,282,0,0,0,0,10,292,
20221008,152,593,유성,부여,162,0,7,0,0,5,174,159,0,5,1,0,7,172,
20221008,152,595,유성,서공주,562,8,3,1,4,17,595,472,7,6,1,4,16,506,
20221008,152,599,유성,양촌,249,1,0,0,0,8,258,209,1,0,0,0,10,220,
20221008,152,613,유성,남풍세,386,4,7,7,7,12,423,244,8,5,13,3,6,279,
20221008,153,109,서대전,계룡,119,3,1,0,2,12,137,112,8,2,0,0,5,127,
20221008,153,112,서대전,남청주,312,23,9,3,2,16,365,273,13,3,2,1,18,310,
20221008,153,113,서대전,신탄진,351,3,5,3,4,22,388,298,7,2,2,3,16,328,
20221008,153,114,서대전,남대전,1564,32,36,25,11,81,1749,1748,33,34,31,15,98,1959,
20221008,153,115,서대전,대전,873,13,6,5,8,47,952,771,9,7,3,3,48,841,
20221008,153,116,서대전,옥천,723,15,8,6,7,38,797,636,14,6,6,5,34,701,
20221008,153,118,서대전,영동,126,2,0,0,2,4,134,95,2,0,0,1,5,103,
20221008,153,119,서대전,판암,2051,20,10,4,96,134,2315,2216,16,9,7,115,147,2510,
20221008,153,127,서대전,서대구,108,2,3,2,2,5,122,105,1,4,1,2,7,120,
20221008,153,129,서대전,북대구,103,0,2,2,4,2,113,136,1,3,1,2,6,149,
20221008,153,151,서대전,북대전,743,14,11,15,17,47,847,543,15,6,12,17,42,635,
20221008,153,152,서대전,유성,610,2,7,2,5,37,663,451,5,8,3,3,18,488,
20221008,153,154,서대전,안영,1305,19,22,17,76,70,1509,1220,32,26,14,71,60,1423,
20221008,153,155,서대전,논산,780,12,25,11,3,26,857,786,9,26,5,2,42,870,
20221008,153,156,서대전,익산,547,17,3,3,4,22,596,502,9,5,4,4,27,551,
20221008,153,158,서대전,전주,692,5,8,5,8,21,739,537,5,4,1,4,12,563,
20221008,153,159,서대전,서전주,218,2,0,0,0,10,230,240,5,1,1,2,14,263,
20221008,153,163,서대전,정읍,149,1,2,1,5,3,161,154,0,2,0,2,4,162,
20221008,153,164,서대전,무주,453,1,2,2,1,14,473,253,1,2,1,3,7,267,
20221008,153,167,서대전,광주,512,3,7,4,7,12,545,419,1,7,1,3,14,445,
20221008,153,190,서대전,동서울,243,2,0,0,0,12,257,220,1,3,1,0,4,229,
20221008,153,198,서대전,서청주,208,8,2,2,1,14,235,172,1,3,0,0,13,189,
20221008,153,199,서대전,오창,204,2,1,2,1,10,220,106,1,2,1,2,4,116,
20221008,153,200,서대전,금산,690,7,12,2,1,31,743,502,4,13,1,1,25,546,
20221008,153,204,서대전,추부,626,11,8,7,5,32,689,497,9,9,1,4,33,553,
20221008,153,298,서대전,서산,165,0,1,0,1,6,173,123,1,1,1,1,5,132,
20221008,153,544,서대전,완주,167,1,2,0,0,3,173,161,2,1,0,0,7,171,
20221008,153,556,서대전,동순천,236,0,5,7,5,5,258,129,0,2,2,4,5,142,
20221008,153,573,서대전,예산수덕사,393,0,1,4,1,15,414,252,1,1,0,0,11,265,
20221008,153,578,서대전,서세종,380,10,2,2,0,21,415,217,7,2,0,1,8,235,
20221008,153,579,서대전,남세종,1041,14,12,5,7,59,1138,888,13,10,4,9,34,958,
20221008,153,590,서대전,동전주,162,1,2,0,0,12,177,184,2,2,0,0,9,197,
20221008,153,595,서대전,서공주,198,2,0,1,1,5,207,123,0,1,0,1,5,130,
20221008,153,599,서대전,양촌,250,0,0,0,0,10,260,204,1,1,0,0,10,216,
20221008,153,613,서대전,남풍세,199,6,4,4,2,14,229,145,2,0,0,0,11,158,
20221008,154,109,안영,계룡,204,5,6,3,35,16,269,185,3,9,4,48,10,259,
20221008,154,112,안영,남청주,200,12,0,2,4,10,228,188,7,1,0,1,10,207,
20221008,154,113,안영,신탄진,173,5,5,4,9,14,210,166,3,3,2,6,9,189,
20221008,154,114,안영,남대전,622,20,18,10,6,41,717,641,11,23,13,12,49,749,
20221008,154,115,안영,대전,393,4,3,4,6,27,437,371,7,5,4,1,36,424,
20221008,154,116,안영,옥천,388,9,2,2,1,26,428,323,12,1,2,2,21,361,
20221008,154,119,안영,판암,515,6,8,2,7,31,569,563,10,7,7,7,31,625,
20221008,154,151,안영,북대전,275,10,6,6,19,18,334,296,4,9,3,15,11,338,
20221008,154,152,안영,유성,1040,15,18,11,31,58,1173,1142,12,31,4,36,57,1282,
20221008,154,153,안영,서대전,1220,32,26,14,71,60,1423,1305,19,22,17,76,70,1509,
20221008,154,155,안영,논산,248,8,11,5,2,7,281,253,9,4,5,3,9,283,
20221008,154,156,안영,익산,182,4,3,0,0,2,191,164,10,0,0,0,1,175,
20221008,154,158,안영,전주,267,2,1,0,1,11,282,197,3,1,0,1,9,211,
20221008,154,159,안영,서전주,96,1,0,1,0,4,102,115,1,2,0,0,7,125,
20221008,154,164,안영,무주,282,2,1,2,0,11,298,185,2,2,0,0,7,196,
20221008,154,167,안영,광주,196,3,2,0,1,7,209,181,1,3,1,0,3,189,
20221008,154,198,안영,서청주,127,3,2,0,0,6,138,117,0,1,1,1,2,122,
20221008,154,200,안영,금산,563,4,5,2,3,29,606,435,4,4,2,1,20,466,
20221008,154,204,안영,추부,370,10,3,1,0,27,411,244,8,3,0,2,23,280,
20221008,154,573,안영,예산수덕사,144,2,0,1,0,5,152,126,2,3,1,2,6,140,
20221008,154,578,안영,서세종,258,13,2,1,1,11,286,188,4,1,2,0,11,206,
20221008,154,579,안영,남세종,685,14,6,3,10,30,748,702,14,6,6,14,26,768,
20221008,155,109,논산,계룡,216,6,7,9,3,14,255,230,7,7,10,8,10,272,
20221008,155,114,논산,남대전,88,1,6,3,2,5,105,103,4,5,10,1,3,126,
20221008,155,115,논산,대전,157,2,1,0,0,11,171,184,1,3,0,0,11,199,
20221008,155,119,논산,판암,302,2,3,2,1,19,329,257,7,3,4,3,19,293,
20221008,155,151,논산,북대전,134,0,6,11,11,8,170,146,1,5,17,10,11,190,
20221008,155,152,논산,유성,788,8,18,9,9,32,864,714,8,18,11,10,38,799,
20221008,155,153,논산,서대전,786,9,26,5,2,42,870,780,12,25,11,3,26,857,
20221008,155,154,논산,안영,253,9,4,5,3,9,283,248,8,11,5,2,7,281,
20221008,155,156,논산,익산,128,12,14,7,3,5,169,97,14,15,17,4,4,151,
20221008,155,158,논산,전주,187,2,10,11,10,3,223,131,5,12,9,6,8,171,
20221008,155,167,논산,광주,207,6,7,10,4,6,240,156,3,4,3,10,4,180,
20221008,156,109,익산,계룡,168,11,2,4,1,8,194,234,10,2,6,2,6,260,
20221008,156,112,익산,남청주,98,5,2,2,1,3,111,110,5,2,5,0,2,124,
20221008,156,115,익산,대전,97,0,0,1,0,8,106,127,1,0,0,0,9,137,
20221008,156,119,익산,판암,189,1,1,1,0,9,201,187,2,1,0,1,7,198,
20221008,156,151,익산,북대전,113,2,4,4,19,2,144,127,4,6,6,19,3,165,
20221008,156,152,익산,유성,658,9,12,4,6,28,717,749,8,10,3,13,31,814,
20221008,156,153,익산,서대전,502,9,5,4,4,27,551,547,17,3,3,4,22,596,
20221008,156,154,익산,안영,164,10,0,0,0,1,175,182,4,3,0,0,2,191,
20221008,156,155,익산,논산,97,14,15,17,4,4,151,128,12,14,7,3,5,169,
20221008,156,158,익산,전주,90,5,5,3,8,4,115,89,10,0,5,6,3,113,
20221008,156,167,익산,광주,147,12,10,11,13,1,194,143,7,9,8,9,3,179,
20221008,156,198,익산,서청주,96,0,5,1,9,4,115,88,1,4,4,10,3,110,
20221008,156,545,익산,소양,127,4,6,1,8,1,147,135,3,6,1,19,4,168,
20221008,156,579,익산,남세종,132,4,2,5,2,4,149,150,2,3,1,3,5,164,
20221008,156,590,익산,동전주,153,10,4,4,0,5,176,124,11,3,0,0,4,142,
20221008,157,152,삼례,유성,108,1,2,1,1,2,115,141,1,1,0,0,6,149,
20221008,157,163,삼례,정읍,95,2,4,7,3,6,117,104,2,7,5,3,6,127,
20221008,157,167,삼례,광주,201,3,4,4,8,5,225,221,6,9,3,6,8,253,
20221008,157,545,삼례,소양,122,2,2,2,8,1,137,92,2,4,1,1,3,103,
20221008,158,109,전주,계룡,176,5,1,3,1,8,194,222,4,3,1,0,9,239,
20221008,158,112,전주,남청주,100,7,3,18,4,1,133,140,8,1,18,5,6,178,
20221008,158,115,전주,대전,108,0,8,0,1,0,117,149,3,4,1,0,5,162,
20221008,158,119,전주,판암,205,0,1,0,3,13,222,268,1,3,2,1,12,287,
20221008,158,151,전주,북대전,98,2,3,4,7,7,121,156,3,5,9,8,5,186,
20221008,158,152,전주,유성,706,5,62,1,12,29,815,882,12,59,8,7,37,1005,
20221008,158,153,전주,서대전,537,5,4,1,4,12,563,692,5,8,5,8,21,739,
20221008,158,154,전주,안영,197,3,1,0,1,9,211,267,2,1,0,1,11,282,
20221008,158,155,전주,논산,131,5,12,9,6,8,171,187,2,10,11,10,3,223,
20221008,158,156,전주,익산,89,10,0,5,6,3,113,90,5,5,3,8,4,115,
20221008,158,159,전주,서전주,93,2,3,5,0,3,106,139,2,6,4,2,4,157,
20221008,158,160,전주,김제,271,5,8,62,14,14,374,299,2,8,56,12,16,393,
20221008,158,161,전주,금산사,125,4,2,2,0,1,134,125,8,2,2,0,2,139,
20221008,158,162,전주,태인,282,9,6,8,5,8,318,190,4,6,2,5,9,216,
20221008,158,163,전주,정읍,524,9,11,7,6,10,567,551,12,14,4,5,19,605,
20221008,158,166,전주,장성,100,0,1,3,4,1,109,106,8,5,2,7,2,130,
20221008,158,167,전주,광주,976,25,61,20,4,34,1120,1136,28,69,25,6,40,1304,
20221008,158,190,전주,동서울,109,0,3,0,0,1,113,224,0,1,2,4,3,234,
20221008,158,569,전주,북광주,115,2,3,3,2,2,127,131,1,3,3,1,6,145,
20221008,158,579,전주,남세종,135,1,3,0,3,7,149,243,1,3,1,4,9,261,
20221008,159,109,서전주,계룡,109,5,0,0,1,3,118,94,1,1,1,3,2,102,
20221008,159,152,서전주,유성,406,2,2,0,2,13,425,364,3,0,2,0,16,385,
20221008,159,153,서전주,서대전,240,5,1,1,2,14,263,218,2,0,0,0,10,230,
20221008,159,154,서전주,안영,115,1,2,0,0,7,125,96,1,0,1,0,4,102,
20221008,159,158,서전주,전주,139,2,6,4,2,4,157,93,2,3,5,0,3,106,
20221008,159,160,서전주,김제,161,7,10,7,7,8,200,159,9,11,8,15,4,206,
20221008,159,161,서전주,금산사,127,4,2,0,2,4,139,95,5,1,1,2,5,109,
20221008,159,162,서전주,태인,340,5,15,11,12,12,395,255,5,8,14,4,8,294,
20221008,159,163,서전주,정읍,755,10,25,7,24,14,835,937,13,23,12,22,22,1029,
20221008,159,166,서전주,장성,186,9,7,14,5,5,226,179,8,10,32,19,3,251,
20221008,159,167,서전주,광주,2225,53,35,22,32,57,2424,2196,49,37,25,23,56,2386,
20221008,159,530,서전주,내장산,141,0,2,0,2,5,150,144,2,1,1,2,4,154,
20221008,159,569,서전주,북광주,237,2,1,8,6,4,258,261,4,7,4,2,10,288,
20221008,159,579,서전주,남세종,118,1,1,0,1,2,123,119,0,0,0,3,5,127,
20221008,160,158,김제,전주,299,2,8,56,12,16,393,271,5,8,62,14,14,374,
20221008,160,159,김제,서전주,159,9,11,8,15,4,206,161,7,10,7,7,8,200,
20221008,160,163,김제,정읍,398,5,19,3,2,9,436,351,5,21,4,5,13,399,
20221008,160,166,김제,장성,92,4,1,3,6,3,109,80,1,2,3,15,3,104,
20221008,160,167,김제,광주,956,29,15,4,4,25,1033,777,10,9,7,2,23,828,
20221008,161,158,금산사,전주,125,8,2,2,0,2,139,125,4,2,2,0,1,134,
20221008,161,159,금산사,서전주,95,5,1,1,2,5,109,127,4,2,0,2,4,139,
20221008,161,167,금산사,광주,150,7,3,0,0,6,166,157,5,4,2,1,7,176,
20221008,162,152,태인,유성,107,0,1,0,1,1,110,121,0,3,1,1,3,129,
20221008,162,158,태인,전주,190,4,6,2,5,9,216,282,9,6,8,5,8,318,
20221008,162,159,태인,서전주,255,5,8,14,4,8,294,340,5,15,11,12,12,395,
20221008,162,167,태인,광주,351,10,15,7,5,11,399,304,11,14,8,3,10,350,
20221008,163,152,정읍,유성,190,1,1,4,0,8,204,179,0,3,4,1,2,189,
20221008,163,153,정읍,서대전,154,0,2,0,2,4,162,149,1,2,1,5,3,161,
20221008,163,157,정읍,삼례,104,2,7,5,3,6,127,95,2,4,7,3,6,117,
20221008,163,158,정읍,전주,551,12,14,4,5,19,605,524,9,11,7,6,10,567,
20221008,163,159,정읍,서전주,937,13,23,12,22,22,1029,755,10,25,7,24,14,835,
20221008,163,160,정읍,김제,351,5,21,4,5,13,399,398,5,19,3,2,9,436,
20221008,163,166,정읍,장성,91,1,4,6,10,6,118,102,5,8,5,8,6,134,
20221008,163,167,정읍,광주,996,21,36,12,10,30,1105,966,28,37,18,8,34,1091,
20221008,163,569,정읍,북광주,153,6,3,0,2,6,170,161,2,2,3,1,9,178,
20221008,164,114,무주,남대전,309,1,2,0,0,14,326,408,1,2,1,0,22,434,
20221008,164,115,무주,대전,296,1,18,0,1,12,328,378,3,17,0,2,29,429,
20221008,164,119,무주,판암,165,1,2,0,0,18,186,247,2,1,0,0,14,264,
20221008,164,152,무주,유성,188,2,0,1,0,4,195,332,1,0,0,0,5,338,
20221008,164,153,무주,서대전,253,1,2,1,3,7,267,453,1,2,2,1,14,473,
20221008,164,154,무주,안영,185,2,2,0,0,7,196,282,2,1,2,0,11,298,
20221008,164,169,무주,장수,109,5,1,4,2,3,124,101,1,2,0,1,4,109,
20221008,164,200,무주,금산,188,4,2,0,5,8,207,205,2,1,0,5,5,218,
20221008,164,204,무주,추부,115,3,2,0,0,2,122,154,5,1,1,3,6,170,
20221008,165,167,백양사,광주,556,5,11,9,9,12,602,628,5,6,9,8,13,669,
20221008,165,569,백양사,북광주,94,0,0,3,2,2,101,111,2,0,2,3,4,122,
20221008,166,158,장성,전주,106,8,5,2,7,2,130,100,0,1,3,4,1,109,
20221008,166,159,장성,서전주,179,8,10,32,19,3,251,186,9,7,14,5,5,226,
20221008,166,160,장성,김제,80,1,2,3,15,3,104,92,4,1,3,6,3,109,
20221008,166,163,장성,정읍,102,5,8,5,8,6,134,91,1,4,6,10,6,118,
20221008,166,167,장성,광주,3003,58,65,16,53,105,3300,3925,83,68,21,26,145,4268,
20221008,166,271,장성,순천,142,6,6,2,4,2,162,126,3,6,0,3,4,142,
20221008,167,109,광주,계룡,173,3,7,5,0,1,189,191,2,8,6,1,6,214,
20221008,167,112,광주,남청주,123,2,3,21,6,4,159,224,2,3,22,18,7,276,
20221008,167,115,광주,대전,105,1,2,1,0,2,111,138,2,0,0,0,2,142,
20221008,167,119,광주,판암,185,2,2,1,0,5,195,180,2,0,0,0,4,186,
20221008,167,151,광주,북대전,122,2,3,10,5,5,147,166,1,1,21,14,6,209,
20221008,167,152,광주,유성,594,2,34,11,2,13,656,788,4,39,7,0,22,860,
20221008,167,153,광주,서대전,419,1,7,1,3,14,445,512,3,7,4,7,12,545,
20221008,167,154,광주,안영,181,1,3,1,0,3,189,196,3,2,0,1,7,209,
20221008,167,155,광주,논산,156,3,4,3,10,4,180,207,6,7,10,4,6,240,
20221008,167,156,광주,익산,143,7,9,8,9,3,179,147,12,10,11,13,1,194,
20221008,167,157,광주,삼례,221,6,9,3,6,8,253,201,3,4,4,8,5,225,
20221008,167,158,광주,전주,1136,28,69,25,6,40,1304,976,25,61,20,4,34,1120,
20221008,167,159,광주,서전주,2196,49,37,25,23,56,2386,2225,53,35,22,32,57,2424,
20221008,167,160,광주,김제,777,10,9,7,2,23,828,956,29,15,4,4,25,1033,
20221008,167,161,광주,금산사,157,5,4,2,1,7,176,150,7,3,0,0,6,166,
20221008,167,162,광주,태인,304,11,14,8,3,10,350,351,10,15,7,5,11,399,
20221008,167,163,광주,정읍,966,28,37,18,8,34,1091,996,21,36,12,10,30,1105,
20221008,167,165,광주,백양사,628,5,6,9,8,13,669,556,5,11,9,9,12,602,
20221008,167,166,광주,장성,3925,83,68,21,26,145,4268,3003,58,65,16,53,105,3300,
20221008,167,190,광주,동서울,218,5,1,6,4,6,240,551,5,4,10,5,14,589,
20221008,167,196,광주,진천,119,0,2,4,1,0,126,110,1,1,11,14,2,139,
20221008,167,197,광주,증평,89,0,5,1,7,5,107,84,1,4,14,11,2,116,
20221008,167,199,광주,오창,134,1,1,7,1,2,146,102,0,4,9,11,2,128,
20221008,167,227,광주,군산,251,3,2,0,4,6,266,201,3,2,2,7,6,221,
20221008,167,228,광주,동군산,898,21,14,9,29,20,991,884,20,12,7,23,18,964,
20221008,167,253,광주,서서울,466,3,3,22,13,7,514,668,6,7,12,7,13,713,
20221008,167,298,광주,서산,95,3,2,4,2,0,106,139,1,0,2,4,3,149,
20221008,167,299,광주,해미,136,0,5,0,1,4,146,113,0,6,0,0,3,122,
20221008,167,501,광주,서김제,182,5,4,5,2,2,200,154,1,1,0,3,6,165,
20221008,167,502,광주,부안,813,8,3,6,1,18,849,599,10,6,4,1,16,636,
20221008,167,503,광주,줄포,670,3,2,2,1,16,694,452,5,5,2,3,13,480,
20221008,167,504,광주,선운산,609,7,1,1,17,18,653,445,6,3,0,10,16,480,
20221008,167,505,광주,고창,825,5,10,8,2,20,870,654,9,5,4,2,19,693,
20221008,167,511,광주,무창포,270,2,5,0,0,7,284,143,0,1,2,1,4,151,
20221008,167,530,광주,내장산,863,17,13,22,6,27,948,714,15,11,16,4,32,792,
20221008,167,567,광주,남고창,1795,18,33,14,10,82,1952,1723,12,33,7,8,71,1854,
20221008,167,568,광주,장성물류,117,30,3,2,1,4,157,138,33,7,4,4,3,189,
20221008,167,579,광주,남세종,201,3,3,0,0,7,214,312,2,1,4,1,6,326,
20221008,168,169,덕유산,장수,103,0,1,1,1,2,108,127,2,1,1,0,1,132,
20221008,168,544,덕유산,완주,97,3,0,0,2,2,104,143,3,1,0,1,4,152,
20221008,168,545,덕유산,소양,103,1,0,0,0,3,107,112,4,0,0,0,4,120,
20221008,169,164,장수,무주,101,1,2,0,1,4,109,109,5,1,4,2,3,124,
20221008,169,168,장수,덕유산,127,2,1,1,0,1,132,103,0,1,1,1,2,108,
20221008,169,544,장수,완주,285,2,12,7,13,12,331,355,2,9,6,15,14,401,
20221008,169,545,장수,소양,655,5,3,2,3,22,690,690,4,5,1,3,22,725,
20221008,169,546,장수,진안,120,6,0,1,4,4,135,122,3,3,0,5,4,137,
20221008,170,224,서상,함양,131,3,5,0,3,7,149,166,2,5,0,0,12,185,
20221008,171,101,마성,서울,3142,20,113,53,6,133,3467,3460,51,106,52,6,139,3814,
20221008,171,102,마성,동수원,727,5,15,2,0,53,802,916,10,14,0,2,41,983,
20221008,171,103,마성,수원신갈,440,3,2,2,2,25,474,558,1,3,2,0,33,597,
20221008,171,171,마성,마성,109,0,0,0,0,4,113,109,0,0,0,0,4,113,
20221008,171,173,마성,양지,252,5,4,4,5,9,279,1031,18,18,5,26,31,1129,
20221008,171,175,마성,덕평,96,5,5,4,1,2,113,166,8,4,1,6,8,193,
20221008,171,212,마성,북수원,691,5,3,0,2,31,732,1327,15,7,3,1,53,1406,
20221008,171,213,마성,부곡,110,0,1,0,0,4,115,143,2,5,0,1,10,161,
20221008,171,214,마성,동군포,288,1,1,0,1,13,304,381,7,2,2,1,17,410,
20221008,171,215,마성,군포,173,2,0,0,2,15,192,297,3,4,0,0,26,330,
20221008,171,253,마성,서서울,1302,6,12,3,2,72,1397,1216,13,8,4,4,70,1315,
20221008,171,254,마성,군자,811,5,6,2,5,45,874,1139,8,11,6,6,70,1240,
20221008,171,255,마성,서안산,188,6,2,0,1,12,209,267,8,4,6,4,14,303,
20221008,171,528,마성,기흥동탄,403,0,1,0,0,19,423,318,0,2,0,1,16,337,
20221008,172,101,용인,서울,2882,94,65,43,23,174,3281,2272,57,60,27,18,132,2566,
20221008,172,102,용인,동수원,727,15,7,1,0,56,806,692,10,5,4,3,40,754,
20221008,172,103,용인,수원신갈,198,7,2,6,0,11,224,209,6,5,2,0,10,232,
20221008,172,173,용인,양지,2025,84,53,42,74,95,2373,1305,87,55,60,110,93,1710,
20221008,172,175,용인,덕평,540,27,10,14,15,27,633,178,16,12,11,9,13,239,
20221008,172,176,용인,이천,269,8,10,5,9,24,325,143,15,9,14,8,20,209,
20221008,172,177,용인,여주,387,4,8,13,2,13,427,108,5,2,6,4,2,127,
20221008,172,178,용인,문막,427,1,14,0,3,15,460,103,4,12,0,1,4,124,
20221008,172,212,용인,북수원,699,23,5,6,19,40,792,676,22,8,5,11,34,756,
20221008,172,214,용인,동군포,219,5,1,6,3,16,250,143,3,2,9,1,11,169,
20221008,172,215,용인,군포,272,4,1,1,1,18,297,236,5,3,0,2,11,257,
20221008,172,253,용인,서서울,898,26,10,21,12,60,1027,748,28,7,14,11,37,845,
20221008,172,254,용인,군자,671,13,5,17,27,30,763,624,14,11,15,29,31,724,
20221008,172,255,용인,서안산,246,8,8,6,9,16,293,270,11,4,6,6,11,308,
20221008,172,256,용인,안산,92,1,0,0,1,6,100,101,0,2,1,1,2,107,
20221008,173,101,양지,서울,4245,271,107,84,58,133,4898,2360,103,96,38,28,67,2692,
20221008,173,102,양지,동수원,1470,39,18,7,1,68,1603,631,21,14,4,13,42,725,
20221008,173,103,양지,수원신갈,298,28,24,15,9,10,384,181,29,29,9,3,5,256,
20221008,173,171,양지,마성,1031,18,18,5,26,31,1129,252,5,4,4,5,9,279,
20221008,173,172,양지,용인,1305,87,55,60,110,93,1710,2025,84,53,42,74,95,2373,
20221008,173,174,양지,춘천,228,1,1,2,0,11,243,149,1,7,2,2,10,171,
20221008,173,175,양지,덕평,171,17,10,12,4,4,218,138,4,8,22,176,7,355,
20221008,173,176,양지,이천,211,13,3,10,33,16,286,369,15,11,24,41,21,481,
20221008,173,177,양지,여주,390,12,27,27,15,15,486,290,14,26,22,16,19,387,
20221008,173,178,양지,문막,536,14,17,8,22,13,610,232,13,8,6,10,9,278,
20221008,173,179,양지,홍천,270,2,3,2,0,6,283,119,1,5,2,0,8,135,
20221008,173,180,양지,원주,176,8,4,10,20,5,223,87,6,8,19,19,2,141,
20221008,173,189,양지,강릉,252,6,2,11,3,12,286,124,4,2,2,4,1,137,
20221008,173,190,양지,동서울,453,28,14,17,9,21,542,313,26,9,16,9,10,383,
20221008,173,212,양지,북수원,1434,49,21,15,9,57,1585,769,40,24,17,6,26,882,
20221008,173,213,양지,부곡,157,13,3,4,29,13,219,73,4,3,2,17,6,105,
20221008,173,214,양지,동군포,429,8,11,18,5,20,491,183,12,6,19,2,9,231,
20221008,173,215,양지,군포,304,22,8,7,2,15,358,196,13,9,4,0,6,228,
20221008,173,218,양지,남원주,251,7,1,5,2,21,287,125,5,2,2,2,11,147,
20221008,173,240,양지,제천,282,1,0,1,0,1,285,95,3,1,0,0,1,100,
20221008,173,253,양지,서서울,1299,78,39,70,28,54,1568,711,42,24,32,18,32,859,
20221008,173,254,양지,군자,901,49,36,83,69,47,1185,619,28,42,58,81,26,854,
20221008,173,255,양지,서안산,280,26,27,46,15,16,410,179,19,22,27,3,4,254,
20221008,173,500,양지,남여주,252,4,22,21,34,7,340,252,5,14,18,42,10,341,
20221008,173,705,양지,남이천,101,4,1,2,10,4,122,95,7,1,6,0,5,114,
20221008,173,735,양지,남양평,125,1,0,0,0,2,128,112,1,0,0,0,5,118,
20221008,174,173,춘천,양지,149,1,7,2,2,10,171,228,1,1,2,0,11,243,
20221008,174,174,춘천,춘천,176,1,0,0,0,5,182,176,1,0,0,0,5,182,
20221008,174,176,춘천,이천,91,2,4,1,0,4,102,131,3,3,2,0,7,146,
20221008,174,177,춘천,여주,330,1,8,4,2,10,355,340,1,7,6,2,11,367,
20221008,174,178,춘천,문막,170,40,15,4,8,12,249,173,44,7,9,7,10,250,
20221008,174,179,춘천,홍천,3545,36,74,23,21,267,3966,3582,52,66,24,38,244,4006,
20221008,174,189,춘천,강릉,284,4,5,0,0,19,312,287,5,7,1,1,16,317,
20221008,174,211,춘천,풍기,137,0,0,0,0,7,144,94,2,2,0,0,4,102,
20221008,174,216,춘천,횡성,1424,41,19,11,20,62,1577,1123,34,16,11,13,74,1271,
20221008,174,217,춘천,북원주,705,22,12,4,31,42,816,560,16,6,7,8,38,635,
20221008,174,218,춘천,남원주,1541,29,60,5,2,73,1710,1520,20,60,10,4,91,1705,
20221008,174,240,춘천,제천,530,1,7,3,23,17,581,429,2,6,3,18,23,481,
20221008,174,284,춘천,남양양,193,2,1,0,3,7,206,150,1,1,1,0,5,158,
20221008,174,510,춘천,양양,606,3,14,1,1,30,655,342,1,11,0,0,15,369,
20221008,174,554,춘천,동홍천,1662,19,36,10,9,92,1828,1328,18,18,3,15,78,1460,
20221008,174,580,춘천,북강릉,410,2,8,1,1,30,452,266,1,6,2,1,13,289,
20221008,174,583,춘천,동해,158,1,0,0,4,7,170,128,0,0,0,8,7,143,
20221008,174,701,춘천,북양양,375,1,3,0,0,12,391,301,2,2,0,0,17,322,
20221008,174,702,춘천,속초,351,1,4,0,0,20,376,311,2,8,0,0,19,340,
20221008,174,765,춘천,내촌,126,1,0,3,4,12,146,124,2,1,1,2,4,134,
20221008,174,766,춘천,인제,254,0,4,0,2,11,271,262,1,1,2,2,19,287,
20221008,174,775,춘천,동명동호,90,0,0,0,1,9,100,111,1,1,0,0,3,116,
20221008,175,101,덕평,서울,588,84,65,25,7,20,789,495,43,69,15,7,14,643,
20221008,175,102,덕평,동수원,231,12,19,2,0,10,274,268,12,22,3,8,14,327,
20221008,175,103,덕평,수원신갈,69,9,13,7,1,2,101,109,13,10,17,3,7,159,
20221008,175,171,덕평,마성,166,8,4,1,6,8,193,96,5,5,4,1,2,113,
20221008,175,172,덕평,용인,178,16,12,11,9,13,239,540,27,10,14,15,27,633,
20221008,175,173,덕평,양지,138,4,8,22,176,7,355,171,17,10,12,4,4,218,
20221008,175,176,덕평,이천,114,7,5,8,0,7,141,180,7,4,12,8,9,220,
20221008,175,177,덕평,여주,181,5,12,17,6,9,230,150,3,13,28,7,6,207,
20221008,175,178,덕평,문막,131,11,0,4,1,8,155,95,6,2,2,4,9,118,
20221008,175,190,덕평,동서울,600,51,23,36,14,15,739,688,22,17,30,7,28,792,
20221008,175,192,덕평,곤지암,90,7,5,5,3,6,116,111,3,5,2,2,4,127,
20221008,175,212,덕평,북수원,204,13,6,6,48,9,286,223,18,11,10,25,10,297,
20221008,175,253,덕평,서서울,214,24,11,15,2,10,276,213,15,8,16,4,5,261,
20221008,175,254,덕평,군자,162,11,12,17,12,4,218,194,16,19,22,18,4,273,
20221008,175,255,덕평,서안산,73,3,12,23,3,1,115,71,3,15,17,6,5,117,
20221008,175,500,덕평,남여주,68,4,4,19,3,3,101,143,4,8,22,4,1,182,
20221008,176,101,이천,서울,283,9,48,23,6,12,381,247,4,59,3,5,6,324,
20221008,176,102,이천,동수원,484,6,22,2,4,20,538,316,1,12,3,6,17,355,
20221008,176,103,이천,수원신갈,216,8,13,12,8,4,261,155,4,10,7,3,8,187,
20221008,176,172,이천,용인,143,15,9,14,8,20,209,269,8,10,5,9,24,325,
20221008,176,173,이천,양지,369,15,11,24,41,21,481,211,13,3,10,33,16,286,
20221008,176,174,이천,춘천,131,3,3,2,0,7,146,91,2,4,1,0,4,102,
20221008,176,175,이천,덕평,180,7,4,12,8,9,220,114,7,5,8,0,7,141,
20221008,176,177,이천,여주,474,5,15,15,6,21,536,336,5,17,29,14,22,423,
20221008,176,178,이천,문막,452,4,13,3,2,13,487,144,3,7,2,6,6,168,
20221008,176,180,이천,원주,151,5,2,11,7,6,182,68,6,6,12,6,4,102,
20221008,176,190,이천,동서울,1709,35,75,115,39,85,2058,1175,16,44,28,23,68,1354,
20221008,176,192,이천,곤지암,133,2,12,9,1,15,172,95,5,9,2,2,5,118,
20221008,176,193,이천,일죽,104,19,9,17,20,6,175,117,22,12,12,17,6,186,
20221008,176,198,이천,서청주,91,99,19,1,2,3,215,79,99,15,1,4,3,201,
20221008,176,212,이천,북수원,301,6,8,16,2,9,342,188,4,8,2,2,10,214,
20221008,176,218,이천,남원주,209,6,2,3,0,10,230,116,4,3,1,0,12,136,
20221008,176,240,이천,제천,368,1,5,0,12,9,395,116,1,2,2,4,4,129,
20221008,176,253,이천,서서울,268,4,5,37,20,19,353,166,1,6,37,12,12,234,
20221008,176,254,이천,군자,305,1,13,15,20,16,370,212,8,11,12,37,15,295,
20221008,176,255,이천,서안산,128,3,7,16,17,6,177,90,6,3,5,19,4,127,
20221008,176,500,이천,남여주,219,3,15,7,3,12,259,218,1,7,5,1,14,246,
20221008,176,560,이천,감곡,187,2,3,0,5,4,201,181,3,5,2,11,5,207,
20221008,177,101,여주,서울,331,1,40,4,2,5,383,391,4,36,2,2,9,444,
20221008,177,102,여주,동수원,362,5,20,7,0,19,413,281,2,6,3,1,6,299,
20221008,177,103,여주,수원신갈,186,1,17,9,3,7,223,138,2,13,6,3,8,170,
20221008,177,172,여주,용인,108,5,2,6,4,2,127,387,4,8,13,2,13,427,
20221008,177,173,여주,양지,290,14,26,22,16,19,387,390,12,27,27,15,15,486,
20221008,177,174,여주,춘천,340,1,7,6,2,11,367,330,1,8,4,2,10,355,
20221008,177,175,여주,덕평,150,3,13,28,7,6,207,181,5,12,17,6,9,230,
20221008,177,176,여주,이천,336,5,17,29,14,22,423,474,5,15,15,6,21,536,
20221008,177,178,여주,문막,353,7,16,1,25,17,419,298,7,8,3,25,10,351,
20221008,177,179,여주,홍천,110,3,9,1,8,2,133,165,2,8,2,6,2,185,
20221008,177,180,여주,원주,127,4,9,4,2,4,150,125,3,9,10,7,6,160,
20221008,177,189,여주,강릉,153,1,9,9,10,2,184,189,2,10,7,6,7,221,
20221008,177,190,여주,동서울,1043,9,31,27,16,27,1153,1048,5,31,24,14,31,1153,
20221008,177,192,여주,곤지암,167,3,4,7,1,7,189,152,3,3,3,0,3,164,
20221008,177,193,여주,일죽,63,3,14,13,6,4,103,80,4,15,9,3,4,115,
20221008,177,212,여주,북수원,203,4,4,2,4,5,222,207,0,7,0,1,9,224,
20221008,177,218,여주,남원주,270,2,12,2,0,17,303,227,4,17,5,0,16,269,
20221008,177,240,여주,제천,163,3,11,4,3,6,190,190,2,9,2,2,5,210,
20221008,177,253,여주,서서울,217,0,0,6,5,8,236,168,2,1,7,5,12,195,
20221008,177,254,여주,군자,193,6,4,12,20,11,246,215,3,5,6,28,10,267,
20221008,177,517,여주,양평,114,2,2,2,3,1,124,180,1,1,5,4,9,200,
20221008,178,101,문막,서울,146,0,54,1,2,7,210,230,1,97,1,1,8,338,
20221008,178,102,문막,동수원,249,2,15,0,1,4,271,222,1,15,1,0,3,242,
20221008,178,103,문막,수원신갈,120,1,3,3,1,4,132,136,1,2,3,0,10,152,
20221008,178,172,문막,용인,103,4,12,0,1,4,124,427,1,14,0,3,15,460,
20221008,178,173,문막,양지,232,13,8,6,10,9,278,536,14,17,8,22,13,610,
20221008,178,174,문막,춘천,173,44,7,9,7,10,250,170,40,15,4,8,12,249,
20221008,178,175,문막,덕평,95,6,2,2,4,9,118,131,11,0,4,1,8,155,
20221008,178,176,문막,이천,144,3,7,2,6,6,168,452,4,13,3,2,13,487,
20221008,178,177,문막,여주,298,7,8,3,25,10,351,353,7,16,1,25,17,419,
20221008,178,179,문막,홍천,126,12,1,7,18,7,171,113,11,9,2,20,8,163,
20221008,178,180,문막,원주,280,23,19,16,16,20,374,290,30,20,15,10,25,390,
20221008,178,181,문막,새말,154,4,6,0,6,10,180,178,6,17,5,7,9,222,
20221008,178,189,문막,강릉,197,1,3,8,6,6,221,148,3,8,18,7,6,190,
20221008,178,190,문막,동서울,370,4,19,3,21,22,439,535,11,16,5,1,24,592,
20221008,178,212,문막,북수원,134,1,13,1,2,4,155,257,3,14,2,1,6,283,
20221008,178,216,문막,횡성,364,14,8,8,32,11,437,133,13,3,7,17,12,185,
20221008,178,218,문막,남원주,161,8,3,2,4,12,190,126,5,6,1,0,16,154,
20221008,178,240,문막,제천,424,22,6,13,31,12,508,264,19,9,9,16,22,339,
20221008,178,253,문막,서서울,126,2,4,3,10,5,150,171,0,2,4,2,10,189,
20221008,178,254,문막,군자,191,2,15,2,32,5,247,287,7,21,7,13,7,342,
20221008,179,173,홍천,양지,119,1,5,2,0,8,135,270,2,3,2,0,6,283,
20221008,179,174,홍천,춘천,3582,52,66,24,38,244,4006,3545,36,74,23,21,267,3966,
20221008,179,177,홍천,여주,165,2,8,2,6,2,185,110,3,9,1,8,2,133,
20221008,179,178,홍천,문막,113,11,9,2,20,8,163,126,12,1,7,18,7,171,
20221008,179,216,홍천,횡성,186,9,8,4,34,12,253,153,17,6,3,82,6,267,
20221008,179,217,홍천,북원주,185,12,7,5,19,11,239,125,14,3,9,6,3,160,
20221008,179,218,홍천,남원주,698,7,15,7,13,24,764,671,7,23,2,10,22,735,
20221008,179,240,홍천,제천,146,2,2,3,6,4,163,129,2,2,0,7,3,143,
20221008,180,173,원주,양지,87,6,8,19,19,2,141,176,8,4,10,20,5,223,
20221008,180,176,원주,이천,68,6,6,12,6,4,102,151,5,2,11,7,6,182,
20221008,180,177,원주,여주,125,3,9,10,7,6,160,127,4,9,4,2,4,150,
20221008,180,178,원주,문막,290,30,20,15,10,25,390,280,23,19,16,16,20,374,
20221008,180,181,원주,새말,435,25,13,19,6,21,519,485,18,25,12,14,24,578,
20221008,180,182,원주,둔내,654,9,12,4,6,25,710,464,6,14,8,5,27,524,
20221008,180,183,원주,면온,229,4,2,2,2,10,249,108,5,1,0,1,3,118,
20221008,180,184,원주,대관령,325,5,7,1,0,15,353,112,5,3,1,0,11,132,
20221008,180,185,원주,평창,129,8,13,2,1,6,159,154,7,9,2,1,10,183,
20221008,180,187,원주,진부,324,4,10,1,2,7,348,162,1,10,2,2,6,183,
20221008,180,189,원주,강릉,1037,16,27,12,4,46,1142,665,16,38,9,3,27,758,
20221008,180,240,원주,제천,132,16,2,9,14,3,176,108,7,3,1,12,4,135,
20221008,180,580,원주,북강릉,340,1,2,1,0,13,357,189,4,6,0,1,8,208,
20221008,180,583,원주,동해,213,1,5,1,6,4,230,142,5,4,1,7,6,165,
20221008,181,178,새말,문막,178,6,17,5,7,9,222,154,4,6,0,6,10,180,
20221008,181,180,새말,원주,485,18,25,12,14,24,578,435,25,13,19,6,21,519,
20221008,181,182,새말,둔내,537,13,35,5,4,13,607,189,6,5,1,2,5,208,
20221008,181,184,새말,대관령,363,0,5,0,0,6,374,181,3,4,0,0,4,192,
20221008,181,185,새말,평창,103,2,12,4,2,4,127,89,3,2,2,4,3,103,
20221008,181,187,새말,진부,318,5,13,4,1,9,350,197,2,5,2,1,5,212,
20221008,181,189,새말,강릉,582,4,26,8,13,19,652,282,5,7,4,5,11,314,
20221008,181,218,새말,남원주,194,5,6,5,4,3,217,131,1,9,7,3,8,159,
20221008,182,180,둔내,원주,464,6,14,8,5,27,524,654,9,12,4,6,25,710,
20221008,182,181,둔내,새말,189,6,5,1,2,5,208,537,13,35,5,4,13,607,
20221008,182,189,둔내,강릉,249,1,2,2,0,6,260,125,2,3,3,7,7,147,
20221008,182,218,둔내,남원주,113,2,2,8,0,5,130,169,3,10,1,1,4,188,
20221008,183,180,면온,원주,108,5,1,0,1,3,118,229,4,2,2,2,10,249,
20221008,183,184,면온,대관령,334,4,2,1,0,8,349,259,1,1,0,0,6,267,
20221008,183,187,면온,진부,223,1,3,0,0,1,228,111,2,4,1,0,0,118,
20221008,183,189,면온,강릉,259,3,14,0,0,13,289,158,2,2,0,0,6,168,
20221008,184,180,대관령,원주,112,5,3,1,0,11,132,325,5,7,1,0,15,353,
20221008,184,181,대관령,새말,181,3,4,0,0,4,192,363,0,5,0,0,6,374,
20221008,184,183,대관령,면온,259,1,1,0,0,6,267,334,4,2,1,0,8,349,
20221008,184,185,대관령,평창,440,3,6,2,4,10,465,563,3,5,6,1,9,587,
20221008,184,187,대관령,진부,241,2,23,1,2,6,275,207,5,20,2,1,4,239,
20221008,184,189,대관령,강릉,1685,36,54,3,8,82,1868,1770,32,52,10,9,92,1965,
20221008,184,580,대관령,북강릉,526,3,10,2,2,16,559,403,3,7,1,0,10,424,
20221008,184,583,대관령,동해,140,0,2,1,3,0,146,112,0,3,1,4,3,123,
20221008,184,585,대관령,하조대,168,2,3,0,0,6,179,178,1,3,0,0,5,187,
20221008,184,701,대관령,북양양,173,0,2,1,0,6,182,120,0,1,0,1,4,126,
20221008,184,702,대관령,속초,203,2,5,0,0,7,217,189,2,1,0,0,6,198,
20221008,185,180,평창,원주,154,7,9,2,1,10,183,129,8,13,2,1,6,159,
20221008,185,181,평창,새말,89,3,2,2,4,3,103,103,2,12,4,2,4,127,
20221008,185,184,평창,대관령,563,3,5,6,1,9,587,440,3,6,2,4,10,465,
20221008,185,186,평창,속사,96,1,0,2,1,4,104,99,3,1,3,0,4,110,
20221008,185,187,평창,진부,305,8,24,8,4,11,360,226,4,25,11,4,7,277,
20221008,185,189,평창,강릉,832,16,27,5,25,38,943,577,11,16,7,18,21,650,
20221008,185,580,평창,북강릉,337,5,4,2,8,5,361,199,1,3,2,2,8,215,
20221008,186,185,속사,평창,99,3,1,3,0,4,110,96,1,0,2,1,4,104,
20221008,187,180,진부,원주,162,1,10,2,2,6,183,324,4,10,1,2,7,348,
20221008,187,181,진부,새말,197,2,5,2,1,5,212,318,5,13,4,1,9,350,
20221008,187,183,진부,면온,111,2,4,1,0,0,118,223,1,3,0,0,1,228,
20221008,187,184,진부,대관령,207,5,20,2,1,4,239,241,2,23,1,2,6,275,
20221008,187,185,진부,평창,226,4,25,11,4,7,277,305,8,24,8,4,11,360,
20221008,187,189,진부,강릉,639,19,15,5,3,36,717,636,11,14,6,15,41,723,
20221008,187,580,진부,북강릉,179,2,1,0,1,4,187,157,5,4,1,1,3,171,
20221008,188,128,서충주,금왕꽃동네,223,3,7,8,6,8,255,171,2,5,11,10,9,208,
20221008,188,190,서충주,동서울,116,2,0,0,0,0,118,126,1,1,1,4,2,135,
20221008,188,542,서충주,서안성,217,3,6,4,22,11,263,159,1,6,9,12,11,198,
20221008,188,543,서충주,남안성,548,9,25,21,28,32,663,389,6,19,23,42,22,501,
20221008,188,555,서충주,북진천,129,4,9,10,6,3,161,120,4,6,5,8,4,147,
20221008,189,102,강릉,동수원,141,0,12,0,0,7,160,172,0,9,1,0,6,188,
20221008,189,173,강릉,양지,124,4,2,2,4,1,137,252,6,2,11,3,12,286,
20221008,189,174,강릉,춘천,287,5,7,1,1,16,317,284,4,5,0,0,19,312,
20221008,189,177,강릉,여주,189,2,10,7,6,7,221,153,1,9,9,10,2,184,
20221008,189,178,강릉,문막,148,3,8,18,7,6,190,197,1,3,8,6,6,221,
20221008,189,180,강릉,원주,665,16,38,9,3,27,758,1037,16,27,12,4,46,1142,
20221008,189,181,강릉,새말,282,5,7,4,5,11,314,582,4,26,8,13,19,652,
20221008,189,182,강릉,둔내,125,2,3,3,7,7,147,249,1,2,2,0,6,260,
20221008,189,183,강릉,면온,158,2,2,0,0,6,168,259,3,14,0,0,13,289,
20221008,189,184,강릉,대관령,1770,32,52,10,9,92,1965,1685,36,54,3,8,82,1868,
20221008,189,185,강릉,평창,577,11,16,7,18,21,650,832,16,27,5,25,38,943,
20221008,189,187,강릉,진부,636,11,14,6,15,41,723,639,19,15,5,3,36,717,
20221008,189,218,강릉,남원주,353,3,14,2,5,15,392,310,7,8,4,5,10,344,
20221008,189,284,강릉,남양양,183,4,1,1,3,9,201,141,1,0,0,2,12,156,
20221008,189,510,강릉,양양,227,6,2,0,0,9,244,163,4,4,0,3,9,183,
20221008,189,580,강릉,북강릉,256,3,2,2,2,8,273,178,2,7,0,3,5,195,
20221008,189,581,강릉,옥계,199,3,0,0,3,11,216,214,1,0,0,8,12,235,
20221008,189,582,강릉,망상,525,12,64,4,0,32,637,466,10,47,1,2,30,556,
20221008,189,583,강릉,동해,942,17,13,6,29,54,1061,1041,8,31,2,26,64,1172,
20221008,189,585,강릉,하조대,518,7,17,1,0,23,566,539,6,12,3,1,30,591,
20221008,189,701,강릉,북양양,418,5,6,1,1,32,463,366,10,2,1,7,25,411,
20221008,189,702,강릉,속초,654,11,8,2,8,21,704,541,23,5,3,12,22,606,
20221008,189,703,강릉,삼척,508,4,11,3,1,26,553,519,11,8,1,3,23,565,
20221008,189,704,강릉,근덕,507,10,9,1,3,19,549,618,8,13,5,3,16,663,
20221008,190,112,동서울,남청주,230,1,4,18,20,7,280,327,3,6,9,9,21,375,
20221008,190,113,동서울,신탄진,781,5,7,19,24,33,869,903,10,6,28,31,37,1015,
20221008,190,115,동서울,대전,675,5,8,1,3,30,722,739,9,9,0,0,18,775,
20221008,190,116,동서울,옥천,230,1,4,18,6,6,265,154,2,5,47,19,4,231,
20221008,190,119,동서울,판암,115,0,0,0,0,5,120,122,1,1,1,0,5,130,
20221008,190,123,동서울,구미,133,0,6,0,2,7,148,165,2,13,10,2,6,198,
20221008,190,127,동서울,서대구,430,5,13,17,4,15,484,465,6,17,9,6,12,515,
20221008,190,128,동서울,금왕꽃동네,295,5,5,7,7,17,336,491,9,7,15,14,25,561,
20221008,190,129,동서울,북대구,507,5,4,12,3,9,540,597,2,6,6,1,9,621,
20221008,190,136,동서울,음성,936,5,6,9,10,29,995,587,8,10,11,17,28,661,
20221008,190,151,동서울,북대전,357,2,7,2,0,13,381,526,1,8,1,0,15,551,
20221008,190,152,동서울,유성,341,1,3,6,2,11,364,532,1,5,18,2,22,580,
20221008,190,153,동서울,서대전,220,1,3,1,0,4,229,243,2,0,0,0,12,257,
20221008,190,158,동서울,전주,224,0,1,2,4,3,234,109,0,3,0,0,1,113,
20221008,190,167,동서울,광주,551,5,4,10,5,14,589,218,5,1,6,4,6,240,
20221008,190,173,동서울,양지,313,26,9,16,9,10,383,453,28,14,17,9,21,542,
20221008,190,175,동서울,덕평,688,22,17,30,7,28,792,600,51,23,36,14,15,739,
20221008,190,176,동서울,이천,1175,16,44,28,23,68,1354,1709,35,75,115,39,85,2058,
20221008,190,177,동서울,여주,1048,5,31,24,14,31,1153,1043,9,31,27,16,27,1153,
20221008,190,178,동서울,문막,535,11,16,5,1,24,592,370,4,19,3,21,22,439,
20221008,190,188,동서울,서충주,126,1,1,1,4,2,135,116,2,0,0,0,0,118,
20221008,190,191,동서울,경기광주,8790,278,264,106,108,554,10100,8443,283,281,177,184,501,9869,
20221008,190,192,동서울,곤지암,3688,192,100,86,40,190,4296,4090,245,67,91,36,220,4749,
20221008,190,193,동서울,일죽,2891,51,92,50,58,108,3250,2825,72,114,115,47,109,3282,
20221008,190,194,동서울,서이천,4365,325,198,125,70,190,5273,3600,262,159,104,48,163,4336,
20221008,190,195,동서울,대소,577,17,42,28,13,30,707,629,27,48,40,24,31,799,
20221008,190,196,동서울,진천,734,14,11,16,13,35,823,622,12,13,17,32,24,720,
20221008,190,197,동서울,증평,670,9,6,21,16,24,746,956,8,13,12,16,44,1049,
20221008,190,198,동서울,서청주,1063,11,15,22,12,41,1164,1489,10,21,14,10,59,1603,
20221008,190,199,동서울,오창,1122,9,12,8,22,44,1217,1092,4,7,7,12,55,1177,
20221008,190,211,동서울,풍기,458,0,12,2,3,7,482,102,0,7,2,0,2,113,
20221008,190,218,동서울,남원주,169,0,6,0,0,6,181,95,1,7,0,0,6,109,
20221008,190,225,동서울,서진주,124,0,1,5,0,2,132,93,0,0,1,0,6,100,
20221008,190,239,동서울,칠원,431,4,10,19,7,10,481,492,5,23,15,2,10,547,
20221008,190,240,동서울,제천,535,1,12,1,3,11,563,156,0,6,1,3,3,169,
20221008,190,297,동서울,동충주,95,0,1,1,1,4,102,133,3,0,0,0,5,141,
20221008,190,500,동서울,남여주,460,1,12,6,0,12,491,689,2,2,8,2,16,719,
20221008,190,516,동서울,통영,340,0,5,0,0,8,353,131,0,5,0,0,7,143,
20221008,190,522,동서울,북단양,223,1,2,11,9,3,249,82,0,4,0,27,3,116,
20221008,190,533,동서울,보은,198,2,0,0,0,4,204,125,2,1,0,2,5,135,
20221008,190,555,동서울,북진천,737,13,13,15,4,23,805,666,17,17,12,12,21,745,
20221008,190,560,동서울,감곡,1003,5,7,18,28,31,1092,960,13,12,15,36,27,1063,
20221008,190,561,동서울,북충주,734,4,18,1,0,31,788,780,6,45,4,3,32,870,
20221008,190,562,동서울,충주,532,0,39,6,2,19,598,662,8,13,6,3,31,723,
20221008,190,563,동서울,괴산,164,2,0,0,1,11,178,143,1,0,0,0,8,152,
20221008,190,564,동서울,연풍,362,0,4,2,2,8,378,192,1,5,4,2,5,209,
20221008,190,565,동서울,문경새재,427,3,5,4,4,7,450,252,2,7,2,5,6,274,
20221008,190,566,동서울,점촌함창,391,2,15,2,0,6,416,377,1,30,6,1,13,428,
20221008,190,570,동서울,북상주,284,7,7,15,4,12,329,317,7,6,20,5,6,361,
20221008,190,621,동서울,동대구,114,2,2,5,4,1,128,111,1,1,3,2,5,123,
20221008,190,705,동서울,남이천,1189,31,28,37,76,40,1401,1719,39,31,73,57,53,1972,
20221008,190,736,동서울,삼성,400,9,0,0,0,9,418,412,7,1,0,0,12,432,
20221008,190,772,동서울,북달성,94,1,0,3,1,4,103,91,3,1,2,2,2,101,
20221008,191,190,경기광주,동서울,8443,283,281,177,184,501,9869,8790,278,264,106,108,554,10100,
20221008,191,192,경기광주,곤지암,677,14,10,5,3,32,741,465,9,4,4,0,31,513,
20221008,191,193,경기광주,일죽,188,2,6,3,1,8,208,142,5,1,8,3,3,162,
20221008,191,194,경기광주,서이천,1047,23,9,5,6,36,1126,275,4,3,2,3,13,300,
20221008,191,705,경기광주,남이천,99,2,1,4,0,4,110,110,3,2,5,2,4,126,
20221008,192,113,곤지암,신탄진,128,6,3,8,22,6,173,91,0,1,12,14,7,125,
20221008,192,115,곤지암,대전,104,2,1,0,1,3,111,95,3,5,0,1,4,108,
20221008,192,136,곤지암,음성,129,1,0,1,0,11,142,106,1,2,0,0,5,114,
20221008,192,175,곤지암,덕평,111,3,5,2,2,4,127,90,7,5,5,3,6,116,
20221008,192,176,곤지암,이천,95,5,9,2,2,5,118,133,2,12,9,1,15,172,
20221008,192,177,곤지암,여주,152,3,3,3,0,3,164,167,3,4,7,1,7,189,
20221008,192,190,곤지암,동서울,4090,245,67,91,36,220,4749,3688,192,100,86,40,190,4296,
20221008,192,191,곤지암,경기광주,465,9,4,4,0,31,513,677,14,10,5,3,32,741,
20221008,192,193,곤지암,일죽,662,28,29,24,18,23,784,643,19,22,22,17,28,751,
20221008,192,194,곤지암,서이천,2135,173,80,60,64,115,2627,1242,95,46,46,38,73,1540,
20221008,192,195,곤지암,대소,187,6,5,12,4,7,221,196,8,9,19,8,8,248,
20221008,192,196,곤지암,진천,169,2,5,9,10,9,204,169,6,1,5,13,6,200,
20221008,192,197,곤지암,증평,159,1,4,5,1,4,174,178,3,2,7,3,7,200,
20221008,192,198,곤지암,서청주,191,8,2,7,1,9,218,239,2,6,7,1,7,262,
20221008,192,199,곤지암,오창,213,6,4,5,6,11,245,184,0,3,4,5,5,201,
20221008,192,555,곤지암,북진천,126,3,5,1,1,4,140,146,4,2,1,0,6,159,
20221008,192,560,곤지암,감곡,114,0,4,1,9,2,130,172,0,2,1,20,6,201,
20221008,192,561,곤지암,북충주,101,0,0,1,3,3,108,102,0,0,0,2,4,108,
20221008,192,705,곤지암,남이천,387,13,14,15,16,11,456,622,18,20,16,30,17,723,
20221008,192,736,곤지암,삼성,129,3,0,0,0,1,133,126,1,0,0,0,3,130,
20221008,193,101,일죽,서울,266,9,12,12,2,2,303,374,3,21,6,3,12,419,
20221008,193,102,일죽,동수원,164,1,14,1,1,6,187,124,0,13,0,2,4,143,
20221008,193,176,일죽,이천,117,22,12,12,17,6,186,104,19,9,17,20,6,175,
20221008,193,177,일죽,여주,80,4,15,9,3,4,115,63,3,14,13,6,4,103,
20221008,193,190,일죽,동서울,2825,72,114,115,47,109,3282,2891,51,92,50,58,108,3250,
20221008,193,191,일죽,경기광주,142,5,1,8,3,3,162,188,2,6,3,1,8,208,
20221008,193,192,일죽,곤지암,643,19,22,22,17,28,751,662,28,29,24,18,23,784,
20221008,193,194,일죽,서이천,233,25,22,30,18,10,338,139,8,15,16,10,7,195,
20221008,193,212,일죽,북수원,153,2,6,3,2,3,169,158,4,5,4,0,10,181,
20221008,193,253,일죽,서서울,179,6,5,30,21,16,257,222,3,2,6,14,17,264,
20221008,193,254,일죽,군자,140,8,9,17,25,6,205,145,4,7,11,26,5,198,
20221008,193,705,일죽,남이천,136,4,12,16,7,9,184,198,4,14,21,7,11,255,
20221008,194,190,서이천,동서울,3600,262,159,104,48,163,4336,4365,325,198,125,70,190,5273,
20221008,194,191,서이천,경기광주,275,4,3,2,3,13,300,1047,23,9,5,6,36,1126,
20221008,194,192,서이천,곤지암,1242,95,46,46,38,73,1540,2135,173,80,60,64,115,2627,
20221008,194,193,서이천,일죽,139,8,15,16,10,7,195,233,25,22,30,18,10,338,
20221008,195,101,대소,서울,84,11,26,6,9,4,140,96,7,38,2,1,6,150,
20221008,195,190,대소,동서울,629,27,48,40,24,31,799,577,17,42,28,13,30,707,
20221008,195,192,대소,곤지암,196,8,9,19,8,8,248,187,6,5,12,4,7,221,
20221008,195,198,대소,서청주,185,5,10,8,4,8,220,204,3,19,3,3,16,248,
20221008,195,199,대소,오창,141,8,8,9,3,4,173,77,8,9,3,7,1,105,
20221008,195,543,대소,남안성,261,16,20,46,50,20,413,103,7,9,27,37,7,190,
20221008,196,101,진천,서울,88,3,3,3,6,5,108,120,0,3,2,1,5,131,
20221008,196,112,진천,남청주,97,9,6,6,14,6,138,134,4,9,13,18,5,183,
20221008,196,113,진천,신탄진,322,8,7,14,14,20,385,266,14,7,21,15,16,339,
20221008,196,115,진천,대전,286,12,6,4,7,9,324,225,9,8,3,5,9,259,
20221008,196,151,진천,북대전,109,1,3,1,4,3,121,111,8,6,0,2,3,130,
20221008,196,152,진천,유성,120,5,2,7,4,7,145,140,3,2,1,3,6,155,
20221008,196,167,진천,광주,110,1,1,11,14,2,139,119,0,2,4,1,0,126,
20221008,196,190,진천,동서울,622,12,13,17,32,24,720,734,14,11,16,13,35,823,
20221008,196,192,진천,곤지암,169,6,1,5,13,6,200,169,2,5,9,10,9,204,
20221008,196,197,진천,증평,222,9,7,8,8,12,266,193,8,8,3,13,7,232,
20221008,196,198,진천,서청주,972,20,54,13,12,45,1116,901,17,48,17,15,43,1041,
20221008,196,199,진천,오창,628,16,38,18,29,37,766,372,14,22,14,10,19,451,
20221008,196,543,진천,남안성,78,3,9,8,17,5,120,102,1,5,10,3,9,130,
20221008,197,101,증평,서울,119,2,8,5,4,4,142,142,1,7,4,3,7,164,
20221008,197,112,증평,남청주,103,11,4,17,15,3,153,181,11,4,8,8,8,220,
20221008,197,113,증평,신탄진,347,6,8,14,33,14,422,412,7,7,10,28,24,488,
20221008,197,115,증평,대전,325,1,11,3,3,16,359,397,2,9,0,3,8,419,
20221008,197,151,증평,북대전,122,0,2,1,0,5,130,228,0,0,1,2,10,241,
20221008,197,152,증평,유성,163,2,4,6,2,3,180,237,0,7,4,2,6,256,
20221008,197,167,증평,광주,84,1,4,14,11,2,116,89,0,5,1,7,5,107,
20221008,197,190,증평,동서울,956,8,13,12,16,44,1049,670,9,6,21,16,24,746,
20221008,197,192,증평,곤지암,178,3,2,7,3,7,200,159,1,4,5,1,4,174,
20221008,197,196,증평,진천,193,8,8,3,13,7,232,222,9,7,8,8,12,266,
20221008,197,198,증평,서청주,572,13,12,15,3,30,645,726,11,5,8,4,37,791,
20221008,197,199,증평,오창,269,1,7,2,3,8,290,179,3,2,4,3,7,198,
20221008,197,253,증평,서서울,105,3,3,5,4,1,121,97,3,0,1,1,4,106,
20221008,198,101,서청주,서울,125,1,2,1,0,4,133,112,0,1,1,0,4,118,
20221008,198,112,서청주,남청주,293,12,7,10,9,13,344,136,14,5,7,6,11,179,
20221008,198,113,서청주,신탄진,933,15,7,13,6,42,1016,777,13,14,22,18,48,892,
20221008,198,115,서청주,대전,870,8,4,7,2,67,958,780,10,8,4,1,59,862,
20221008,198,116,서청주,옥천,239,3,5,5,1,11,264,194,3,3,10,2,9,221,
20221008,198,119,서청주,판암,119,1,1,0,2,6,129,158,1,0,0,0,11,170,
20221008,198,151,서청주,북대전,358,2,1,0,0,25,386,439,0,0,1,0,34,474,
20221008,198,152,서청주,유성,312,3,3,4,2,23,347,436,6,4,1,3,25,475,
20221008,198,153,서청주,서대전,172,1,3,0,0,13,189,208,8,2,2,1,14,235,
20221008,198,154,서청주,안영,117,0,1,1,1,2,122,127,3,2,0,0,6,138,
20221008,198,156,서청주,익산,88,1,4,4,10,3,110,96,0,5,1,9,4,115,
20221008,198,176,서청주,이천,79,99,15,1,4,3,201,91,99,19,1,2,3,215,
20221008,198,190,서청주,동서울,1489,10,21,14,10,59,1603,1063,11,15,22,12,41,1164,
20221008,198,192,서청주,곤지암,239,2,6,7,1,7,262,191,8,2,7,1,9,218,
20221008,198,195,서청주,대소,204,3,19,3,3,16,248,185,5,10,8,4,8,220,
20221008,198,196,서청주,진천,901,17,48,17,15,43,1041,972,20,54,13,12,45,1116,
20221008,198,197,서청주,증평,726,11,5,8,4,37,791,572,13,12,15,3,30,645,
20221008,198,199,서청주,오창,777,7,16,12,9,33,854,356,2,9,6,4,14,391,
20221008,198,297,서청주,동충주,323,1,12,2,5,7,350,202,3,13,3,12,11,244,
20221008,198,523,서청주,남제천,162,0,3,0,6,8,179,106,1,3,3,10,9,132,
20221008,198,531,서청주,문의청남대,112,0,0,2,0,6,120,122,0,1,0,2,1,126,
20221008,198,533,서청주,보은,171,2,2,2,10,4,191,178,4,6,4,7,2,201,
20221008,199,101,오창,서울,152,1,2,1,0,5,161,166,1,1,2,0,2,172,
20221008,199,112,오창,남청주,121,8,5,9,11,5,159,187,5,9,10,12,6,229,
20221008,199,113,오창,신탄진,484,5,8,7,23,20,547,791,7,14,21,45,28,906,
20221008,199,115,오창,대전,476,7,7,2,18,27,537,642,7,15,1,31,41,737,
20221008,199,116,오창,옥천,111,2,3,3,5,7,131,114,0,3,6,10,12,145,
20221008,199,119,오창,판암,103,0,1,2,1,3,110,135,4,4,0,1,7,151,
20221008,199,151,오창,북대전,219,1,3,3,2,8,236,408,3,0,0,2,9,422,
20221008,199,152,오창,유성,196,2,11,2,1,8,220,397,3,12,1,0,12,425,
20221008,199,153,오창,서대전,106,1,2,1,2,4,116,204,2,1,2,1,10,220,
20221008,199,167,오창,광주,102,0,4,9,11,2,128,134,1,1,7,1,2,146,
20221008,199,190,오창,동서울,1092,4,7,7,12,55,1177,1122,9,12,8,22,44,1217,
20221008,199,192,오창,곤지암,184,0,3,4,5,5,201,213,6,4,5,6,11,245,
20221008,199,195,오창,대소,77,8,9,3,7,1,105,141,8,8,9,3,4,173,
20221008,199,196,오창,진천,372,14,22,14,10,19,451,628,16,38,18,29,37,766,
20221008,199,197,오창,증평,179,3,2,4,3,7,198,269,1,7,2,3,8,290,
20221008,199,198,오창,서청주,356,2,9,6,4,14,391,777,7,16,12,9,33,854,
20221008,199,297,오창,동충주,238,1,5,5,9,4,262,260,0,3,2,11,1,277,
20221008,199,523,오창,남제천,135,1,1,5,4,2,148,111,1,2,0,11,5,130,
20221008,200,112,금산,남청주,100,5,4,0,1,4,114,141,2,4,1,2,8,158,
20221008,200,113,금산,신탄진,135,4,1,4,5,8,157,134,4,1,3,5,7,154,
20221008,200,114,금산,남대전,420,3,16,0,0,31,470,472,3,18,1,0,30,524,
20221008,200,115,금산,대전,512,0,11,0,2,20,545,517,2,14,0,0,35,568,
20221008,200,119,금산,판암,297,1,24,0,0,19,341,447,1,20,0,1,19,488,
20221008,200,151,금산,북대전,162,0,3,3,2,10,180,168,0,3,1,4,12,188,
20221008,200,152,금산,유성,293,1,5,1,0,16,316,427,1,7,2,0,18,455,
20221008,200,153,금산,서대전,502,4,13,1,1,25,546,690,7,12,2,1,31,743,
20221008,200,154,금산,안영,435,4,4,2,1,20,466,563,4,5,2,3,29,606,
20221008,200,164,금산,무주,205,2,1,0,5,5,218,188,4,2,0,5,8,207,
20221008,200,204,금산,추부,151,2,7,1,11,6,178,157,3,9,0,12,6,187,
20221008,200,579,금산,남세종,164,2,1,0,2,6,175,236,1,5,0,0,12,254,
20221008,201,123,칠곡,구미,163,1,1,1,0,7,173,133,0,0,0,0,12,145,
20221008,201,127,칠곡,서대구,681,12,11,1,16,32,753,1552,11,28,6,16,67,1680,
20221008,201,131,칠곡,경산,287,8,6,5,5,13,324,205,10,6,3,4,6,234,
20221008,201,202,칠곡,다부,165,4,2,1,6,9,187,204,8,2,4,3,14,235,
20221008,201,203,칠곡,가산,849,14,13,9,50,38,973,918,20,21,13,67,46,1085,
20221008,201,205,칠곡,군위,457,1,4,0,10,19,491,486,3,3,0,23,20,535,
20221008,201,206,칠곡,의성,468,2,2,1,1,25,499,442,3,8,1,1,25,480,
20221008,201,207,칠곡,남안동,323,6,1,1,1,17,349,390,2,3,1,0,14,410,
20221008,201,208,칠곡,서안동,181,3,2,1,1,6,194,214,7,17,3,0,8,249,
20221008,201,210,칠곡,영주,195,2,8,2,2,5,214,179,2,16,2,1,7,207,
20221008,201,231,칠곡,화원옥포,587,12,7,1,0,29,636,677,13,6,5,5,38,744,
20221008,201,232,칠곡,달성,157,2,7,3,3,10,182,175,2,6,4,5,11,203,
20221008,201,233,칠곡,현풍,337,7,12,3,6,21,386,474,6,9,7,7,21,524,
20221008,201,239,칠곡,칠원,271,6,3,1,0,6,287,322,0,4,0,1,10,337,
20221008,201,241,칠곡,동고령,259,7,5,3,7,5,286,254,5,3,4,11,8,285,
20221008,201,242,칠곡,고령,263,1,1,1,7,9,282,276,2,2,2,12,11,305,
20221008,201,280,칠곡,거창,134,2,1,0,2,6,145,125,2,3,0,3,6,139,
20221008,201,527,칠곡,포항,287,4,1,0,5,10,307,157,0,1,0,6,2,166,
20221008,201,621,칠곡,동대구,146,3,1,3,1,8,162,123,3,3,1,4,4,138,
20221008,201,730,칠곡,유천,720,3,2,0,1,54,780,827,5,0,0,0,50,882,
20221008,201,731,칠곡,북현풍,171,0,0,0,0,18,189,217,1,0,0,0,14,232,
20221008,202,127,다부,서대구,399,5,9,8,5,14,440,348,6,4,4,19,11,392,
20221008,202,201,다부,칠곡,204,8,2,4,3,14,235,165,4,2,1,6,9,187,
20221008,202,205,다부,군위,248,7,6,7,4,10,282,122,5,7,1,4,8,147,
20221008,202,206,다부,의성,202,7,5,4,3,9,230,137,3,3,2,3,6,154,
20221008,202,207,다부,남안동,278,14,2,3,0,5,302,177,9,7,0,3,10,206,
20221008,202,208,다부,서안동,149,8,4,4,2,9,176,85,6,5,0,3,2,101,
20221008,202,210,다부,영주,214,11,6,6,5,6,248,85,7,14,4,4,4,118,
20221008,202,775,다부,동명동호,480,13,8,3,15,19,538,311,3,4,2,3,14,337,
20221008,203,127,가산,서대구,2255,41,41,24,36,114,2511,2074,32,44,17,21,91,2279,
20221008,203,129,가산,북대구,815,6,6,3,14,32,876,734,5,6,3,13,37,798,
20221008,203,131,가산,경산,106,8,9,10,10,8,151,81,11,5,9,6,6,118,
20221008,203,201,가산,칠곡,918,20,21,13,67,46,1085,849,14,13,9,50,38,973,
20221008,203,205,가산,군위,428,5,6,3,27,27,496,274,6,10,2,14,24,330,
20221008,203,206,가산,의성,413,9,6,1,5,15,449,238,7,6,2,0,8,261,
20221008,203,207,가산,남안동,801,10,8,6,3,35,863,548,13,3,3,0,27,594,
20221008,203,208,가산,서안동,325,11,10,4,5,9,364,203,6,11,4,3,9,236,
20221008,203,210,가산,영주,452,8,6,5,7,19,497,268,2,9,2,5,8,294,
20221008,203,211,가산,풍기,251,0,2,0,1,5,259,115,1,1,0,1,6,124,
20221008,203,231,가산,화원옥포,153,7,8,2,1,9,180,120,3,5,3,4,7,142,
20221008,203,233,가산,현풍,85,0,4,2,11,8,110,82,1,2,4,4,7,100,
20221008,203,239,가산,칠원,240,2,1,0,3,4,250,128,1,3,2,4,3,141,
20221008,203,621,가산,동대구,104,1,1,2,0,4,112,82,2,0,1,12,5,102,
20221008,203,716,가산,청송,197,1,0,0,4,7,209,109,2,1,0,0,2,114,
20221008,203,730,가산,유천,356,4,1,0,2,11,374,269,0,0,0,0,12,281,
20221008,203,749,가산,영덕,458,3,3,2,7,11,484,194,4,3,1,2,7,211,
20221008,203,775,가산,동명동호,2246,34,26,22,212,79,2619,1488,30,15,9,55,53,1650,
20221008,204,113,추부,신탄진,106,3,2,4,2,7,124,124,3,3,5,3,10,148,
20221008,204,115,추부,대전,481,15,5,6,2,41,550,601,11,10,1,3,42,668,
20221008,204,119,추부,판암,185,1,1,0,0,20,207,312,2,4,1,2,33,354,
20221008,204,151,추부,북대전,149,2,2,2,2,3,160,183,1,1,2,2,4,193,
20221008,204,152,추부,유성,345,4,0,1,1,29,380,447,5,2,2,2,41,499,
20221008,204,153,추부,서대전,497,9,9,1,4,33,553,626,11,8,7,5,32,689,
20221008,204,154,추부,안영,244,8,3,0,2,23,280,370,10,3,1,0,27,411,
20221008,204,164,추부,무주,154,5,1,1,3,6,170,115,3,2,0,0,2,122,
20221008,204,200,추부,금산,157,3,9,0,12,6,187,151,2,7,1,11,6,178,
20221008,204,579,추부,남세종,138,1,1,3,0,9,152,204,1,3,1,0,14,223,
20221008,205,127,군위,서대구,688,6,5,0,1,25,725,789,8,3,2,1,31,834,
20221008,205,129,군위,북대구,202,2,2,1,0,3,210,232,2,2,0,1,6,243,
20221008,205,201,군위,칠곡,486,3,3,0,23,20,535,457,1,4,0,10,19,491,
20221008,205,202,군위,다부,122,5,7,1,4,8,147,248,7,6,7,4,10,282,
20221008,205,203,군위,가산,274,6,10,2,14,24,330,428,5,6,3,27,27,496,
20221008,205,207,군위,남안동,151,2,2,1,13,6,175,94,8,1,1,10,6,120,
20221008,205,775,군위,동명동호,793,2,2,2,6,34,839,672,7,3,3,3,20,708,
20221008,206,127,의성,서대구,722,4,6,3,1,26,762,830,4,10,3,2,40,889,
20221008,206,129,의성,북대구,342,0,0,1,0,11,354,362,1,0,0,0,11,374,
20221008,206,201,의성,칠곡,442,3,8,1,1,25,480,468,2,2,1,1,25,499,
20221008,206,202,의성,다부,137,3,3,2,3,6,154,202,7,5,4,3,9,230,
20221008,206,203,의성,가산,238,7,6,2,0,8,261,413,9,6,1,5,15,449,
20221008,206,207,의성,남안동,230,2,0,1,1,6,240,198,3,1,2,0,6,210,
20221008,206,208,의성,서안동,120,1,4,4,2,3,134,98,1,5,2,0,4,110,
20221008,206,775,의성,동명동호,733,3,5,2,7,38,788,619,1,2,0,1,25,648,
20221008,207,127,남안동,서대구,835,10,12,1,3,31,892,805,4,8,5,1,37,860,
20221008,207,129,남안동,북대구,480,0,5,1,2,17,505,498,3,3,0,3,20,527,
20221008,207,201,남안동,칠곡,390,2,3,1,0,14,410,323,6,1,1,1,17,349,
20221008,207,202,남안동,다부,177,9,7,0,3,10,206,278,14,2,3,0,5,302,
20221008,207,203,남안동,가산,548,13,3,3,0,27,594,801,10,8,6,3,35,863,
20221008,207,205,남안동,군위,94,8,1,1,10,6,120,151,2,2,1,13,6,175,
20221008,207,206,남안동,의성,198,3,1,2,0,6,210,230,2,0,1,1,6,240,
20221008,207,208,남안동,서안동,116,1,2,1,1,7,128,126,0,4,1,2,9,142,
20221008,207,239,남안동,칠원,138,0,3,0,0,4,145,132,0,0,0,3,4,139,
20221008,207,531,남안동,문의청남대,124,2,2,1,7,5,141,162,0,2,3,7,5,179,
20221008,207,536,남안동,남상주,107,0,4,0,2,4,117,103,2,4,2,2,5,118,
20221008,207,712,남안동,동상주,286,10,12,7,8,16,339,389,5,8,5,7,12,426,
20221008,207,713,남안동,서의성,133,2,7,3,3,6,154,135,2,9,3,7,5,161,
20221008,207,775,남안동,동명동호,1109,7,7,1,1,38,1163,1034,13,6,1,2,35,1091,
20221008,208,127,서안동,서대구,438,2,5,1,1,14,461,422,3,15,2,0,22,464,
20221008,208,129,서안동,북대구,273,1,34,1,0,9,318,262,0,30,0,0,12,304,
20221008,208,201,서안동,칠곡,214,7,17,3,0,8,249,181,3,2,1,1,6,194,
20221008,208,202,서안동,다부,85,6,5,0,3,2,101,149,8,4,4,2,9,176,
20221008,208,203,서안동,가산,203,6,11,4,3,9,236,325,11,10,4,5,9,364,
20221008,208,206,서안동,의성,98,1,5,2,0,4,110,120,1,4,4,2,3,134,
20221008,208,207,서안동,남안동,126,0,4,1,2,9,142,116,1,2,1,1,7,128,
20221008,208,209,서안동,예천,108,1,0,0,0,8,117,100,2,1,0,1,7,111,
20221008,208,210,서안동,영주,161,4,8,1,5,9,188,167,8,8,2,3,8,196,
20221008,208,211,서안동,풍기,180,2,4,4,2,6,198,220,2,7,4,0,8,241,
20221008,208,521,서안동,단양,140,1,3,3,16,5,168,143,1,0,1,24,1,170,
20221008,208,523,서안동,남제천,152,0,2,0,3,10,167,102,1,3,0,5,8,119,
20221008,208,714,서안동,북의성,102,1,2,0,5,3,113,96,5,1,1,5,3,111,
20221008,208,775,서안동,동명동호,657,5,5,3,7,19,696,553,2,4,6,1,18,584,
20221008,209,208,예천,서안동,100,2,1,0,1,7,111,108,1,0,0,0,8,117,
20221008,210,127,영주,서대구,445,5,5,1,1,17,474,518,5,16,1,5,19,564,
20221008,210,129,영주,북대구,213,0,15,0,0,4,232,274,2,16,1,1,6,300,
20221008,210,201,영주,칠곡,179,2,16,2,1,7,207,195,2,8,2,2,5,214,
20221008,210,202,영주,다부,85,7,14,4,4,4,118,214,11,6,6,5,6,248,
20221008,210,203,영주,가산,268,2,9,2,5,8,294,452,8,6,5,7,19,497,
20221008,210,208,영주,서안동,167,8,8,2,3,8,196,161,4,8,1,5,9,188,
20221008,210,211,영주,풍기,204,2,3,0,0,8,217,140,0,1,1,1,7,150,
20221008,210,239,영주,칠원,123,1,1,1,3,0,129,155,1,1,0,2,4,163,
20221008,210,521,영주,단양,124,1,1,1,15,2,144,120,2,1,2,17,2,144,
20221008,210,775,영주,동명동호,569,6,5,2,4,19,605,585,4,7,0,1,12,609,
20221008,211,101,풍기,서울,87,1,36,1,0,1,126,241,1,50,1,1,6,300,
20221008,211,102,풍기,동수원,98,1,9,0,0,0,108,109,1,9,0,0,0,119,
20221008,211,127,풍기,서대구,162,0,1,0,0,2,165,204,1,2,0,0,7,214,
20221008,211,174,풍기,춘천,94,2,2,0,0,4,102,137,0,0,0,0,7,144,
20221008,211,190,풍기,동서울,102,0,7,2,0,2,113,458,0,12,2,3,7,482,
20221008,211,203,풍기,가산,115,1,1,0,1,6,124,251,0,2,0,1,5,259,
20221008,211,208,풍기,서안동,220,2,7,4,0,8,241,180,2,4,4,2,6,198,
20221008,211,210,풍기,영주,140,0,1,1,1,7,150,204,2,3,0,0,8,217,
20221008,211,218,풍기,남원주,289,0,8,1,1,8,307,369,2,7,0,2,16,396,
20221008,211,219,풍기,신림,144,0,0,1,1,2,148,176,1,0,0,1,7,185,
20221008,211,240,풍기,제천,162,0,12,4,1,6,185,256,0,11,4,6,5,282,
20221008,211,297,풍기,동충주,225,1,4,1,26,8,265,570,2,3,6,9,9,599,
20221008,211,521,풍기,단양,743,4,7,4,9,36,803,784,5,8,0,19,33,849,
20221008,211,522,풍기,북단양,207,2,3,3,12,11,238,286,5,3,2,18,11,325,
20221008,211,523,풍기,남제천,380,6,0,5,7,20,418,312,3,2,2,1,12,332,
20221008,211,543,풍기,남안성,151,0,0,3,3,9,166,271,0,3,1,7,11,293,
20221008,211,775,풍기,동명동호,176,0,2,0,1,4,183,176,2,1,0,0,6,185,
20221008,212,102,북수원,동수원,3890,25,160,8,8,183,4274,3407,20,143,7,15,181,3773,
20221008,212,103,북수원,수원신갈,1559,55,22,29,20,66,1751,751,29,13,9,12,43,857,
20221008,212,105,북수원,기흥,837,16,7,5,3,44,912,631,12,3,2,4,36,688,
20221008,212,106,북수원,오산,323,13,7,10,2,20,375,297,12,7,8,2,21,347,
20221008,212,107,북수원,안성,332,3,4,1,1,20,361,285,5,7,0,0,19,316,
20221008,212,108,북수원,천안,381,0,0,0,4,13,398,276,3,0,1,0,11,291,
20221008,212,111,북수원,청주,114,0,8,2,2,4,130,126,0,6,0,1,5,138,
20221008,212,171,북수원,마성,1327,15,7,3,1,53,1406,691,5,3,0,2,31,732,
20221008,212,172,북수원,용인,676,22,8,5,11,34,756,699,23,5,6,19,40,792,
20221008,212,173,북수원,양지,769,40,24,17,6,26,882,1434,49,21,15,9,57,1585,
20221008,212,175,북수원,덕평,223,18,11,10,25,10,297,204,13,6,6,48,9,286,
20221008,212,176,북수원,이천,188,4,8,2,2,10,214,301,6,8,16,2,9,342,
20221008,212,177,북수원,여주,207,0,7,0,1,9,224,203,4,4,2,4,5,222,
20221008,212,178,북수원,문막,257,3,14,2,1,6,283,134,1,13,1,2,4,155,
20221008,212,193,북수원,일죽,158,4,5,4,0,10,181,153,2,6,3,2,3,169,
20221008,212,214,북수원,동군포,687,12,5,6,7,27,744,320,7,1,4,0,18,350,
20221008,212,215,북수원,군포,146,0,2,1,1,11,161,238,2,4,3,1,6,254,
20221008,212,240,북수원,제천,272,1,1,0,0,8,282,116,1,0,0,0,5,122,
20221008,212,253,북수원,서서울,2550,32,22,11,11,112,2738,1236,19,12,5,4,70,1346,
20221008,212,254,북수원,군자,2158,24,32,12,19,111,2356,1839,20,25,15,10,91,2000,
20221008,212,255,북수원,서안산,570,11,4,9,2,40,636,484,2,3,10,3,31,533,
20221008,212,256,북수원,안산,125,1,1,0,1,6,134,100,1,1,0,0,6,108,
20221008,212,528,북수원,기흥동탄,623,4,5,3,2,30,667,421,0,8,0,1,25,455,
20221008,212,542,북수원,서안성,75,2,7,17,1,1,103,101,0,6,5,3,5,120,
20221008,212,543,북수원,남안성,138,6,1,2,0,6,153,156,2,1,3,1,6,169,
20221008,212,560,북수원,감곡,170,1,4,1,10,7,193,201,2,5,0,14,3,225,
20221008,212,561,북수원,북충주,105,1,3,3,0,3,115,116,1,4,3,0,2,126,
20221008,212,705,북수원,남이천,99,4,1,3,4,0,111,131,1,3,2,9,6,152,
20221008,213,102,부곡,동수원,725,12,8,1,3,40,789,815,10,7,5,6,30,873,
20221008,213,103,부곡,수원신갈,233,22,5,5,9,18,292,211,24,5,3,15,12,270,
20221008,213,105,부곡,기흥,90,1,1,0,1,7,100,89,3,0,2,5,8,107,
20221008,213,171,부곡,마성,143,2,5,0,1,10,161,110,0,1,0,0,4,115,
20221008,213,173,부곡,양지,73,4,3,2,17,6,105,157,13,3,4,29,13,219,
20221008,213,214,부곡,동군포,133,6,0,7,5,12,163,102,1,1,4,6,4,118,
20221008,213,253,부곡,서서울,1239,68,34,19,47,71,1478,1180,57,28,24,40,73,1402,
20221008,213,254,부곡,군자,862,23,9,11,169,51,1125,1082,21,14,12,137,62,1328,
20221008,213,255,부곡,서안산,397,15,9,8,38,19,486,389,17,4,7,46,27,490,
20221008,214,102,동군포,동수원,1478,20,6,3,0,75,1582,1711,25,7,7,2,96,1848,
20221008,214,103,동군포,수원신갈,575,16,5,20,5,28,649,607,27,7,11,4,31,687,
20221008,214,105,동군포,기흥,187,4,4,4,0,12,211,199,3,3,6,4,10,225,
20221008,214,171,동군포,마성,381,7,2,2,1,17,410,288,1,1,0,1,13,304,
20221008,214,172,동군포,용인,143,3,2,9,1,11,169,219,5,1,6,3,16,250,
20221008,214,173,동군포,양지,183,12,6,19,2,9,231,429,8,11,18,5,20,491,
20221008,214,212,동군포,북수원,320,7,1,4,0,18,350,687,12,5,6,7,27,744,
20221008,214,213,동군포,부곡,102,1,1,4,6,4,118,133,6,0,7,5,12,163,
20221008,214,528,동군포,기흥동탄,144,3,0,1,0,4,152,160,0,2,0,0,11,173,
20221008,215,102,군포,동수원,1836,15,7,6,3,99,1966,1169,11,10,3,5,74,1272,
20221008,215,103,군포,수원신갈,404,10,14,0,1,30,459,299,12,7,1,0,13,332,
20221008,215,171,군포,마성,297,3,4,0,0,26,330,173,2,0,0,2,15,192,
20221008,215,172,군포,용인,236,5,3,0,2,11,257,272,4,1,1,1,18,297,
20221008,215,173,군포,양지,196,13,9,4,0,6,228,304,22,8,7,2,15,358,
20221008,215,212,군포,북수원,238,2,4,3,1,6,254,146,0,2,1,1,11,161,
20221008,215,253,군포,서서울,3676,36,50,24,43,214,4043,5117,90,88,70,88,284,5737,
20221008,215,254,군포,군자,2401,42,30,22,45,148,2688,3453,58,56,49,103,201,3920,
20221008,215,255,군포,서안산,822,16,8,6,10,61,923,984,27,17,26,27,83,1164,
20221008,215,256,군포,안산,116,3,0,0,0,9,128,147,4,2,0,2,12,167,
20221008,216,174,횡성,춘천,1123,34,16,11,13,74,1271,1424,41,19,11,20,62,1577,
20221008,216,178,횡성,문막,133,13,3,7,17,12,185,364,14,8,8,32,11,437,
20221008,216,179,횡성,홍천,153,17,6,3,82,6,267,186,9,8,4,34,12,253,
20221008,216,217,횡성,북원주,86,2,3,3,14,5,113,129,2,3,5,22,11,172,
20221008,216,218,횡성,남원주,289,3,3,5,3,7,310,634,4,13,3,9,22,685,
20221008,216,240,횡성,제천,110,3,1,2,6,4,126,212,1,2,0,5,9,229,
20221008,217,174,북원주,춘천,560,16,6,7,8,38,635,705,22,12,4,31,42,816,
20221008,217,179,북원주,홍천,125,14,3,9,6,3,160,185,12,7,5,19,11,239,
20221008,217,216,북원주,횡성,129,2,3,5,22,11,172,86,2,3,3,14,5,113,
20221008,218,101,남원주,서울,64,0,69,0,0,2,135,116,0,54,0,1,3,174,
20221008,218,102,남원주,동수원,149,0,0,0,0,4,153,130,0,0,0,1,6,137,
20221008,218,173,남원주,양지,125,5,2,2,2,11,147,251,7,1,5,2,21,287,
20221008,218,174,남원주,춘천,1520,20,60,10,4,91,1705,1541,29,60,5,2,73,1710,
20221008,218,176,남원주,이천,116,4,3,1,0,12,136,209,6,2,3,0,10,230,
20221008,218,177,남원주,여주,227,4,17,5,0,16,269,270,2,12,2,0,17,303,
20221008,218,178,남원주,문막,126,5,6,1,0,16,154,161,8,3,2,4,12,190,
20221008,218,179,남원주,홍천,671,7,23,2,10,22,735,698,7,15,7,13,24,764,
20221008,218,181,남원주,새말,131,1,9,7,3,8,159,194,5,6,5,4,3,217,
20221008,218,182,남원주,둔내,169,3,10,1,1,4,188,113,2,2,8,0,5,130,
20221008,218,189,남원주,강릉,310,7,8,4,5,10,344,353,3,14,2,5,15,392,
20221008,218,190,남원주,동서울,95,1,7,0,0,6,109,169,0,6,0,0,6,181,
20221008,218,211,남원주,풍기,369,2,7,0,2,16,396,289,0,8,1,1,8,307,
20221008,218,216,남원주,횡성,634,4,13,3,9,22,685,289,3,3,5,3,7,310,
20221008,218,219,남원주,신림,648,5,6,3,10,32,704,435,11,6,3,10,18,483,
20221008,218,240,남원주,제천,2285,28,47,11,46,122,2539,2337,54,42,17,31,128,2609,
20221008,218,522,남원주,북단양,215,4,1,2,23,8,253,236,1,3,1,25,8,274,
20221008,218,523,남원주,남제천,141,1,0,0,0,6,148,132,3,2,0,1,4,142,
20221008,218,580,남원주,북강릉,135,1,1,1,0,3,141,133,1,2,0,1,5,142,
20221008,219,211,신림,풍기,176,1,0,0,1,7,185,144,0,0,1,1,2,148,
20221008,219,218,신림,남원주,435,11,6,3,10,18,483,648,5,6,3,10,32,704,
20221008,219,240,신림,제천,819,8,7,5,37,34,910,799,12,7,5,23,29,875,
20221008,219,522,신림,북단양,144,0,2,2,10,5,163,125,2,2,0,5,2,136,
20221008,221,145,생초,산인,128,0,3,0,0,3,134,390,0,1,0,1,14,406,
20221008,221,225,생초,서진주,93,1,1,1,1,3,100,117,0,1,0,1,1,120,
20221008,221,291,생초,사천,121,7,4,1,3,5,141,127,6,5,1,5,5,149,
20221008,222,145,산청,산인,348,3,2,0,0,15,368,599,2,0,1,0,22,624,
20221008,222,223,산청,단성,161,0,6,0,0,7,174,147,1,2,0,4,3,157,
20221008,222,225,산청,서진주,172,1,1,0,0,4,178,182,0,1,0,1,7,191,
20221008,222,291,산청,사천,204,3,1,3,6,11,228,228,2,3,1,3,17,254,
20221008,222,292,산청,진주,102,2,1,0,0,7,112,108,1,0,0,1,5,115,
20221008,222,516,산청,통영,140,0,1,0,0,7,148,187,3,2,0,0,11,203,
20221008,223,145,단성,산인,320,1,8,1,0,19,349,708,1,5,1,6,34,755,
20221008,223,222,단성,산청,147,1,2,0,4,3,157,161,0,6,0,0,7,174,
20221008,223,291,단성,사천,330,2,4,2,2,20,360,334,0,8,7,2,20,371,
20221008,223,292,단성,진주,88,3,2,2,5,4,104,170,2,2,1,2,5,182,
20221008,223,516,단성,통영,155,0,6,1,0,9,171,276,1,2,2,1,10,292,
20221008,224,145,함양,산인,165,0,7,0,9,11,192,347,0,5,0,3,15,370,
20221008,224,170,함양,서상,166,2,5,0,0,12,185,131,3,5,0,3,7,149,
20221008,224,225,함양,서진주,180,2,1,0,1,11,195,144,3,2,0,0,6,155,
20221008,224,247,함양,남원,147,0,0,0,1,2,150,157,4,3,2,2,8,176,
20221008,224,261,함양,동광주,82,0,1,1,15,2,101,105,1,3,0,22,3,134,
20221008,224,280,함양,거창,128,5,28,0,1,8,170,159,7,22,4,1,7,200,
20221008,224,291,함양,사천,102,0,1,0,0,4,107,99,1,2,0,2,5,109,
20221008,224,519,함양,남대구,181,2,3,1,0,4,191,217,3,4,0,0,6,230,
20221008,225,101,서진주,서울,103,0,12,2,0,1,118,178,1,5,2,0,3,189,
20221008,225,145,서진주,산인,559,13,2,1,1,27,603,632,10,4,4,1,26,677,
20221008,225,190,서진주,동서울,93,0,0,1,0,6,100,124,0,1,5,0,2,132,
20221008,225,221,서진주,생초,117,0,1,0,1,1,120,93,1,1,1,1,3,100,
20221008,225,222,서진주,산청,182,0,1,0,1,7,191,172,1,1,0,0,4,178,
20221008,225,224,서진주,함양,144,3,2,0,0,6,155,180,2,1,0,1,11,195,
20221008,225,272,서진주,광양,255,4,8,7,19,11,304,192,6,5,2,6,6,217,
20221008,225,275,서진주,옥곡,123,1,7,3,34,5,173,149,5,11,1,67,4,237,
20221008,225,277,서진주,하동,139,2,4,6,38,7,196,125,2,3,0,48,6,184,
20221008,225,278,서진주,진교,316,1,6,4,5,17,349,310,6,4,2,7,16,345,
20221008,225,279,서진주,곤양,129,1,3,0,4,5,142,148,1,2,1,6,8,166,
20221008,225,280,서진주,거창,100,2,8,0,0,6,116,109,0,13,1,0,8,131,
20221008,225,291,서진주,사천,933,21,16,10,27,48,1055,833,18,14,7,22,57,951,
20221008,225,513,서진주,고성,246,2,4,1,3,18,274,269,4,1,0,2,19,295,
20221008,225,515,서진주,북통영,259,2,1,0,0,15,277,268,2,1,1,1,19,292,
20221008,225,516,서진주,통영,712,7,4,2,5,51,781,701,11,3,2,4,47,768,
20221008,227,151,군산,북대전,97,0,0,0,0,4,101,134,0,0,0,3,3,140,
20221008,227,167,군산,광주,201,3,2,2,7,6,221,251,3,2,0,4,6,266,
20221008,227,253,군산,서서울,430,0,5,3,10,12,460,404,2,4,1,3,16,430,
20221008,227,257,군산,홍성,153,0,2,5,2,4,166,194,0,4,3,4,2,207,
20221008,227,258,군산,광천,115,2,10,3,9,3,142,146,1,11,3,10,6,177,
20221008,227,259,군산,대천,473,0,12,0,0,9,494,460,3,12,2,3,11,491,
20221008,227,298,군산,서산,88,2,1,1,10,3,105,171,2,4,2,13,2,194,
20221008,227,299,군산,해미,143,0,4,2,5,1,155,180,2,3,2,2,9,198,
20221008,227,509,군산,목포,108,1,1,4,1,1,116,101,1,3,5,3,3,116,
20221008,227,511,군산,무창포,500,5,5,2,7,20,539,544,4,9,3,7,14,581,
20221008,227,575,군산,유구,240,0,5,1,0,10,256,582,2,3,2,1,26,616,
20221008,227,577,군산,공주,99,0,2,0,0,1,102,95,0,1,0,1,3,100,
20221008,227,578,군산,서세종,491,1,2,2,9,19,524,775,8,3,2,4,22,814,
20221008,227,579,군산,남세종,106,0,0,0,4,0,110,148,0,1,0,0,4,153,
20221008,227,592,군산,서부여,187,1,5,2,5,12,212,258,3,5,1,2,6,275,
20221008,227,593,군산,부여,314,0,2,1,1,12,330,261,0,4,2,5,10,282,
20221008,227,595,군산,서공주,230,1,5,0,0,5,241,544,2,5,2,3,18,574,
20221008,227,603,군산,정안,169,0,1,0,3,7,180,276,2,12,0,4,9,303,
20221008,227,613,군산,남풍세,177,4,4,2,9,5,201,404,0,3,2,6,17,432,
20221008,228,167,동군산,광주,884,20,12,7,23,18,964,898,21,14,9,29,20,991,
20221008,228,234,동군산,서천,142,0,2,1,4,3,152,132,2,6,2,5,0,147,
20221008,228,253,동군산,서서울,185,4,1,1,1,4,196,197,2,2,1,3,10,215,
20221008,228,257,동군산,홍성,348,6,11,9,4,5,383,171,1,7,4,5,1,189,
20221008,228,258,동군산,광천,212,0,6,7,10,7,242,139,1,8,7,11,5,171,
20221008,228,259,동군산,대천,812,8,9,4,4,20,857,487,8,10,3,4,11,523,
20221008,228,298,동군산,서산,103,4,2,3,15,5,132,166,0,2,1,15,3,187,
20221008,228,299,동군산,해미,234,1,4,2,4,8,253,217,2,2,2,5,6,234,
20221008,228,502,동군산,부안,156,4,1,1,7,7,176,188,4,8,2,8,5,215,
20221008,228,503,동군산,줄포,104,3,5,1,1,3,117,101,2,1,1,0,2,107,
20221008,228,504,동군산,선운산,340,0,7,7,6,14,374,272,1,13,2,4,10,302,
20221008,228,505,동군산,고창,290,5,6,3,1,8,313,240,1,8,1,0,14,264,
20221008,228,506,동군산,영광,146,1,9,2,18,6,182,123,1,10,2,12,2,150,
20221008,228,509,동군산,목포,447,0,4,9,28,12,500,377,2,9,5,15,9,417,
20221008,228,511,동군산,무창포,1020,8,30,3,18,17,1096,502,3,24,1,20,6,556,
20221008,228,568,동군산,장성물류,109,4,7,6,28,2,156,103,4,14,7,23,0,151,
20221008,228,569,동군산,북광주,161,2,1,1,1,7,173,162,0,2,3,5,2,174,
20221008,229,101,북천안,서울,742,24,35,31,11,30,873,1597,21,87,38,15,55,1813,
20221008,229,103,북천안,수원신갈,160,3,3,5,5,11,187,259,1,3,2,0,9,274,
20221008,229,106,북천안,오산,168,9,6,7,5,13,208,803,13,7,15,11,27,876,
20221008,229,107,북천안,안성,355,3,3,2,6,23,392,707,10,6,4,5,30,762,
20221008,229,108,북천안,천안,1917,55,82,22,38,111,2225,2112,28,81,18,17,100,2356,
20221008,229,110,북천안,목천,159,6,8,22,8,10,213,251,14,11,22,21,18,337,
20221008,229,111,북천안,청주,158,9,7,7,8,7,196,242,7,9,16,6,14,294,
20221008,229,113,북천안,신탄진,99,3,6,4,5,5,122,117,1,2,4,10,4,138,
20221008,229,115,북천안,대전,125,1,4,2,1,10,143,122,2,4,0,0,8,136,
20221008,229,253,북천안,서서울,110,2,1,4,2,8,127,246,5,1,4,1,8,265,
20221008,229,528,북천안,기흥동탄,113,3,0,1,4,6,127,207,4,1,2,9,7,230,
20221008,229,541,북천안,송탄,104,12,10,11,12,8,157,370,16,12,12,11,25,446,
20221008,229,542,북천안,서안성,89,1,6,3,9,2,110,360,2,13,11,5,12,403,
20221008,229,601,북천안,남천안,466,2,10,16,24,24,542,222,6,20,18,27,9,302,
20221008,229,673,북천안,북오산,103,3,6,3,1,8,124,170,4,5,0,2,9,190,
20221008,229,742,북천안,남사진위,152,6,2,3,2,11,176,1176,8,6,18,13,51,1272,
20221008,230,123,팔공산,구미,258,4,1,0,0,19,282,315,4,1,1,0,14,335,
20221008,230,125,팔공산,남구미,241,3,4,0,1,16,265,236,2,4,1,1,16,260,
20221008,230,126,팔공산,왜관,412,10,8,2,3,24,459,405,18,7,1,7,21,459,
20221008,230,127,팔공산,서대구,778,14,11,3,1,44,851,1201,17,23,5,1,63,1310,
20221008,230,129,팔공산,북대구,295,11,4,2,5,10,327,233,2,3,2,0,16,256,
20221008,230,130,팔공산,동김천,96,0,3,0,0,6,105,94,0,1,1,0,6,102,
20221008,230,131,팔공산,경산,1179,38,34,15,16,74,1356,1018,41,25,7,11,73,1175,
20221008,230,132,팔공산,영천,467,4,13,5,6,24,519,371,9,7,3,8,10,408,
20221008,230,133,팔공산,건천,161,1,2,0,1,7,172,114,1,0,0,1,0,116,
20221008,230,135,팔공산,경주,459,3,3,2,2,18,487,486,4,1,1,1,20,513,
20221008,230,231,팔공산,화원옥포,215,4,4,0,1,14,238,177,2,3,1,1,10,194,
20221008,230,233,팔공산,현풍,111,1,4,0,0,3,119,142,0,2,1,0,4,149,
20221008,230,242,팔공산,고령,128,1,2,1,1,6,139,99,3,0,8,1,5,116,
20221008,230,518,팔공산,칠곡물류,70,17,14,17,0,2,120,81,9,14,23,3,6,136,
20221008,230,524,팔공산,청통와촌,1210,25,27,9,13,59,1343,934,23,21,9,11,50,1048,
20221008,230,525,팔공산,북영천,1017,6,5,2,5,36,1071,775,6,3,3,13,30,830,
20221008,230,526,팔공산,서포항,218,1,1,2,1,9,232,118,1,2,1,0,2,124,
20221008,230,527,팔공산,포항,3015,21,18,9,23,116,3202,2396,21,17,2,40,90,2566,
20221008,230,621,팔공산,동대구,205,5,7,5,4,9,235,152,3,4,7,1,5,172,
20221008,230,641,팔공산,울산,172,3,4,3,6,15,203,197,2,6,1,19,9,234,
20221008,230,725,팔공산,임고,216,0,0,0,8,6,230,146,0,0,0,0,3,149,
20221008,230,730,팔공산,유천,305,3,0,0,0,10,318,245,0,0,0,0,9,254,
20221008,230,772,팔공산,북달성,122,3,4,0,1,9,139,186,4,3,1,0,15,209,
20221008,231,123,화원옥포,구미,127,4,2,1,0,6,140,96,4,2,1,0,6,109,
20221008,231,125,화원옥포,남구미,84,4,4,3,6,5,106,86,2,2,4,2,4,100,
20221008,231,126,화원옥포,왜관,139,10,4,3,2,8,166,105,9,3,3,2,2,124,
20221008,231,129,화원옥포,북대구,292,18,3,4,2,11,330,440,18,4,4,3,15,484,
20221008,231,131,화원옥포,경산,182,7,6,7,11,10,223,181,9,12,3,14,8,227,
20221008,231,201,화원옥포,칠곡,677,13,6,5,5,38,744,587,12,7,1,0,29,636,
20221008,231,203,화원옥포,가산,120,3,5,3,4,7,142,153,7,8,2,1,9,180,
20221008,231,230,화원옥포,팔공산,177,2,3,1,1,10,194,215,4,4,0,1,14,238,
20221008,231,232,화원옥포,달성,105,13,15,3,0,6,142,103,9,15,4,3,5,139,
20221008,231,233,화원옥포,현풍,388,21,10,7,7,15,448,397,19,11,6,11,26,470,
20221008,231,235,화원옥포,창녕,130,5,1,1,0,6,143,118,3,2,0,0,3,126,
20221008,231,239,화원옥포,칠원,499,5,5,1,1,13,524,355,3,3,5,2,11,379,
20221008,231,241,화원옥포,동고령,428,5,5,2,6,19,465,308,6,9,4,13,19,359,
20221008,231,242,화원옥포,고령,490,5,4,2,3,21,525,391,4,3,0,18,16,432,
20221008,231,243,화원옥포,해인사,288,3,1,0,0,18,310,247,1,1,0,1,16,266,
20221008,231,274,화원옥포,가조,158,1,4,0,0,8,171,128,2,3,0,0,6,139,
20221008,231,280,화원옥포,거창,438,8,10,1,1,14,472,340,6,6,0,0,17,369,
20221008,231,519,화원옥포,남대구,5512,92,65,36,224,389,6318,5662,88,69,24,156,397,6396,
20221008,231,527,화원옥포,포항,176,2,4,2,5,15,204,198,2,5,5,8,14,232,
20221008,231,538,화원옥포,성주,142,1,2,1,0,5,151,87,3,4,1,2,6,103,
20221008,231,621,화원옥포,동대구,156,4,4,0,2,12,178,178,5,2,1,5,9,200,
20221008,232,201,달성,칠곡,175,2,6,4,5,11,203,157,2,7,3,3,10,182,
20221008,232,231,달성,화원옥포,103,9,15,4,3,5,139,105,13,15,3,0,6,142,
20221008,232,519,달성,남대구,2006,53,62,24,21,134,2300,2061,49,54,23,7,151,2345,
20221008,233,129,현풍,북대구,209,2,13,2,9,11,246,253,7,19,0,8,14,301,
20221008,233,131,현풍,경산,116,8,10,14,8,5,161,95,12,17,4,15,5,148,
20221008,233,201,현풍,칠곡,474,6,9,7,7,21,524,337,7,12,3,6,21,386,
20221008,233,203,현풍,가산,82,1,2,4,4,7,100,85,0,4,2,11,8,110,
20221008,233,230,현풍,팔공산,142,0,2,1,0,4,149,111,1,4,0,0,3,119,
20221008,233,231,현풍,화원옥포,397,19,11,6,11,26,470,388,21,10,7,7,15,448,
20221008,233,236,현풍,영산,99,2,1,5,0,8,115,188,4,3,1,8,7,211,
20221008,233,239,현풍,칠원,811,21,20,7,17,36,912,636,20,19,8,23,27,733,
20221008,233,241,현풍,동고령,223,13,9,9,10,9,273,125,10,7,11,5,4,162,
20221008,233,242,현풍,고령,135,1,6,3,6,5,156,91,2,2,1,1,4,101,
20221008,233,244,현풍,서부산,120,3,10,5,16,4,158,108,2,9,7,19,6,151,
20221008,233,280,현풍,거창,164,4,6,3,4,11,192,140,3,4,6,5,9,167,
20221008,233,519,현풍,남대구,3943,93,100,41,91,251,4519,3687,66,81,45,87,247,4213,
20221008,233,527,현풍,포항,123,0,2,1,18,7,151,88,2,4,4,10,4,112,
20221008,233,537,현풍,남김천,222,6,12,6,14,11,271,183,6,12,8,11,6,226,
20221008,233,538,현풍,성주,240,7,16,5,15,13,296,184,6,10,7,15,16,238,
20221008,233,539,현풍,남성주,238,8,11,8,19,10,294,186,9,8,9,6,7,225,
20221008,233,621,현풍,동대구,127,0,2,1,2,7,139,111,0,3,2,2,4,122,
20221008,234,228,서천,동군산,132,2,6,2,5,0,147,142,0,2,1,4,3,152,
20221008,234,253,서천,서서울,726,0,9,3,16,25,779,849,2,2,7,10,28,898,
20221008,234,257,서천,홍성,213,2,4,2,16,8,245,198,4,8,1,12,5,228,
20221008,234,258,서천,광천,222,1,4,12,37,9,285,225,3,7,7,33,8,283,
20221008,234,259,서천,대천,470,6,8,2,9,22,517,392,3,9,4,5,19,432,
20221008,234,282,서천,비봉,98,1,2,1,1,4,107,143,0,1,1,2,5,152,
20221008,234,288,서천,당진,90,1,1,1,17,1,111,272,1,1,5,30,7,316,
20221008,234,298,서천,서산,166,1,0,4,30,6,207,251,1,2,0,29,7,290,
20221008,234,299,서천,해미,170,2,3,1,5,3,184,199,2,1,1,1,4,208,
20221008,234,511,서천,무창포,663,3,18,1,54,21,760,583,10,20,5,48,18,684,
20221008,234,578,서천,서세종,120,0,5,0,0,2,127,101,0,5,0,0,3,109,
20221008,235,150,창녕,북부산,125,4,3,1,0,6,139,134,2,2,1,0,8,147,
20221008,235,231,창녕,화원옥포,118,3,2,0,0,3,126,130,5,1,1,0,6,143,
20221008,235,236,창녕,영산,124,2,2,2,4,5,139,186,0,3,0,4,2,195,
20221008,235,239,창녕,칠원,653,14,14,4,17,27,729,712,12,10,2,22,45,803,
20221008,235,244,창녕,서부산,132,4,0,3,2,7,148,129,1,1,1,16,8,156,
20221008,235,519,창녕,남대구,780,10,27,3,4,35,859,840,4,25,4,1,27,901,
20221008,236,233,영산,현풍,188,4,3,1,8,7,211,99,2,1,5,0,8,115,
20221008,236,235,영산,창녕,186,0,3,0,4,2,195,124,2,2,2,4,5,139,
20221008,236,239,영산,칠원,454,11,8,3,17,22,515,453,12,12,2,15,10,504,
20221008,236,244,영산,서부산,91,4,0,1,4,15,115,95,2,3,2,5,8,115,
20221008,236,280,영산,거창,299,3,8,2,2,12,326,97,0,1,1,2,3,104,
20221008,236,519,영산,남대구,467,10,10,5,20,14,526,421,10,2,5,24,25,487,
20221008,237,150,남지,북부산,102,4,0,2,7,5,120,117,2,0,0,6,8,133,
20221008,237,239,남지,칠원,990,13,42,13,70,51,1179,1017,13,45,13,63,58,1209,
20221008,237,244,남지,서부산,132,2,10,4,7,10,165,143,3,9,5,7,10,177,
20221008,237,519,남지,남대구,175,7,11,15,16,5,229,197,4,11,10,23,9,254,
20221008,238,142,칠서,군북,104,3,2,2,19,6,136,71,4,2,6,41,2,126,
20221008,238,150,칠서,북부산,152,6,6,14,17,5,200,128,3,1,6,2,5,145,
20221008,238,239,칠서,칠원,1200,40,57,113,290,71,1771,1263,37,52,89,176,85,1702,
20221008,238,244,칠서,서부산,170,11,19,16,46,12,274,141,8,16,13,38,8,224,
20221008,238,294,칠서,북창원,72,2,5,3,74,5,161,203,6,11,3,85,8,316,
20221008,238,519,칠서,남대구,100,0,3,3,6,7,119,103,1,0,1,5,6,116,
20221008,238,757,칠서,진영,32,4,5,6,76,0,123,17,3,5,3,97,0,125,
20221008,239,101,칠원,서울,199,2,124,8,1,3,337,255,1,127,1,2,10,396,
20221008,239,115,칠원,대전,153,0,14,1,2,6,176,190,0,15,4,0,4,213,
20221008,239,123,칠원,구미,170,0,2,3,0,4,179,246,0,3,1,3,9,262,
20221008,239,125,칠원,남구미,148,2,10,2,10,7,179,223,4,9,6,5,16,263,
20221008,239,129,칠원,북대구,129,0,2,0,10,4,145,219,1,4,0,3,4,231,
20221008,239,190,칠원,동서울,492,5,23,15,2,10,547,431,4,10,19,7,10,481,
20221008,239,201,칠원,칠곡,322,0,4,0,1,10,337,271,6,3,1,0,6,287,
20221008,239,203,칠원,가산,128,1,3,2,4,3,141,240,2,1,0,3,4,250,
20221008,239,207,칠원,남안동,132,0,0,0,3,4,139,138,0,3,0,0,4,145,
20221008,239,210,칠원,영주,155,1,1,0,2,4,163,123,1,1,1,3,0,129,
20221008,239,231,칠원,화원옥포,355,3,3,5,2,11,379,499,5,5,1,1,13,524,
20221008,239,233,칠원,현풍,636,20,19,8,23,27,733,811,21,20,7,17,36,912,
20221008,239,235,칠원,창녕,712,12,10,2,22,45,803,653,14,14,4,17,27,729,
20221008,239,236,칠원,영산,453,12,12,2,15,10,504,454,11,8,3,17,22,515,
20221008,239,237,칠원,남지,1017,13,45,13,63,58,1209,990,13,42,13,70,51,1179,
20221008,239,238,칠원,칠서,1263,37,52,89,176,85,1702,1200,40,57,113,290,71,1771,
20221008,239,241,칠원,동고령,160,2,2,2,7,4,177,163,2,3,6,15,4,193,
20221008,239,243,칠원,해인사,201,1,2,2,1,6,213,139,0,1,0,2,6,148,
20221008,239,253,칠원,서서울,113,2,4,11,6,4,140,113,3,0,7,1,2,126,
20221008,239,254,칠원,군자,92,1,6,6,5,3,113,76,2,7,10,5,0,100,
20221008,239,274,칠원,가조,180,3,1,0,0,5,189,121,1,1,0,1,6,130,
20221008,239,280,칠원,거창,622,5,10,0,4,22,663,401,3,12,3,1,15,435,
20221008,239,519,칠원,남대구,2359,22,80,18,43,106,2628,2850,22,75,35,21,101,3104,
20221008,239,537,칠원,남김천,383,3,3,3,20,8,420,315,7,3,3,6,7,341,
20221008,239,538,칠원,성주,161,0,2,1,4,1,169,134,3,1,1,5,6,150,
20221008,239,565,칠원,문경새재,95,0,2,1,2,2,102,419,0,6,4,3,9,441,
20221008,240,101,제천,서울,90,1,53,1,0,3,148,250,1,69,0,0,4,324,
20221008,240,102,제천,동수원,236,1,9,0,1,2,249,228,0,7,0,0,7,242,
20221008,240,128,제천,금왕꽃동네,126,1,0,1,2,3,133,111,1,0,3,0,4,119,
20221008,240,136,제천,음성,93,1,1,1,1,4,101,98,0,3,1,1,4,107,
20221008,240,173,제천,양지,95,3,1,0,0,1,100,282,1,0,1,0,1,285,
20221008,240,174,제천,춘천,429,2,6,3,18,23,481,530,1,7,3,23,17,581,
20221008,240,176,제천,이천,116,1,2,2,4,4,129,368,1,5,0,12,9,395,
20221008,240,177,제천,여주,190,2,9,2,2,5,210,163,3,11,4,3,6,190,
20221008,240,178,제천,문막,264,19,9,9,16,22,339,424,22,6,13,31,12,508,
20221008,240,179,제천,홍천,129,2,2,0,7,3,143,146,2,2,3,6,4,163,
20221008,240,180,제천,원주,108,7,3,1,12,4,135,132,16,2,9,14,3,176,
20221008,240,190,제천,동서울,156,0,6,1,3,3,169,535,1,12,1,3,11,563,
20221008,240,211,제천,풍기,256,0,11,4,6,5,282,162,0,12,4,1,6,185,
20221008,240,212,제천,북수원,116,1,0,0,0,5,122,272,1,1,0,0,8,282,
20221008,240,216,제천,횡성,212,1,2,0,5,9,229,110,3,1,2,6,4,126,
20221008,240,218,제천,남원주,2337,54,42,17,31,128,2609,2285,28,47,11,46,122,2539,
20221008,240,219,제천,신림,799,12,7,5,23,29,875,819,8,7,5,37,34,910,
20221008,240,253,제천,서서울,117,2,4,1,0,1,125,230,1,0,0,0,11,242,
20221008,240,254,제천,군자,145,2,8,1,8,4,168,417,4,7,1,8,13,450,
20221008,240,522,제천,북단양,167,6,5,7,42,2,229,132,2,1,4,14,6,159,
20221008,240,523,제천,남제천,323,2,7,0,6,7,345,210,1,2,0,1,7,221,
20221008,241,129,동고령,북대구,146,5,11,6,4,4,176,222,4,7,6,10,11,260,
20221008,241,131,동고령,경산,79,1,10,10,4,1,105,80,3,10,4,3,4,104,
20221008,241,201,동고령,칠곡,254,5,3,4,11,8,285,259,7,5,3,7,5,286,
20221008,241,231,동고령,화원옥포,308,6,9,4,13,19,359,428,5,5,2,6,19,465,
20221008,241,233,동고령,현풍,125,10,7,11,5,4,162,223,13,9,9,10,9,273,
20221008,241,239,동고령,칠원,163,2,3,6,15,4,193,160,2,2,2,7,4,177,
20221008,241,280,동고령,거창,92,1,2,1,15,3,114,79,1,5,2,14,3,104,
20221008,241,519,동고령,남대구,3127,46,70,31,56,170,3500,3510,52,55,23,51,163,3854,
20221008,241,537,동고령,남김천,73,6,9,2,9,5,104,89,2,5,3,4,5,108,
20221008,241,538,동고령,성주,80,4,10,5,1,4,104,80,4,7,6,1,5,103,
20221008,241,621,동고령,동대구,100,4,3,0,10,2,119,124,2,6,1,4,8,145,
20221008,242,129,고령,북대구,153,2,2,0,25,6,188,238,4,3,2,4,10,261,
20221008,242,131,고령,경산,87,0,9,5,7,1,109,126,3,12,5,14,5,165,
20221008,242,201,고령,칠곡,276,2,2,2,12,11,305,263,1,1,1,7,9,282,
20221008,242,230,고령,팔공산,99,3,0,8,1,5,116,128,1,2,1,1,6,139,
20221008,242,231,고령,화원옥포,391,4,3,0,18,16,432,490,5,4,2,3,21,525,
20221008,242,233,고령,현풍,91,2,2,1,1,4,101,135,1,6,3,6,5,156,
20221008,242,243,고령,해인사,549,8,7,3,5,41,613,555,8,6,2,4,40,615,
20221008,242,274,고령,가조,221,3,3,1,1,8,237,170,4,4,0,2,6,186,
20221008,242,280,고령,거창,391,14,16,3,17,13,454,303,7,17,2,38,11,378,
20221008,242,519,고령,남대구,2646,16,42,11,115,133,2963,3279,13,39,13,106,131,3581,
20221008,242,527,고령,포항,135,0,1,0,4,6,146,204,0,1,0,7,2,214,
20221008,242,537,고령,남김천,107,0,0,0,3,2,112,118,1,3,2,4,2,130,
20221008,242,621,고령,동대구,122,1,2,0,4,5,134,205,2,1,1,6,6,221,
20221008,243,231,해인사,화원옥포,247,1,1,0,1,16,266,288,3,1,0,0,18,310,
20221008,243,239,해인사,칠원,139,0,1,0,2,6,148,201,1,2,2,1,6,213,
20221008,243,242,해인사,고령,555,8,6,2,4,40,615,549,8,7,3,5,41,613,
20221008,243,280,해인사,거창,131,1,1,0,1,11,145,135,3,0,0,1,11,150,
20221008,243,519,해인사,남대구,892,4,5,1,0,35,937,1098,4,5,0,1,47,1155,
20221008,244,142,서부산,군북,581,4,3,3,15,25,631,428,3,5,0,11,24,471,
20221008,244,144,서부산,함안,215,4,5,0,6,12,242,184,3,3,0,21,11,222,
20221008,244,146,서부산,동창원,2407,19,31,9,45,121,2632,1345,8,21,8,16,93,1491,
20221008,244,147,서부산,진례,1201,47,24,23,65,88,1448,1058,35,22,29,64,68,1276,
20221008,244,233,서부산,현풍,108,2,9,7,19,6,151,120,3,10,5,16,4,158,
20221008,244,235,서부산,창녕,129,1,1,1,16,8,156,132,4,0,3,2,7,148,
20221008,244,236,서부산,영산,95,2,3,2,5,8,115,91,4,0,1,4,15,115,
20221008,244,237,서부산,남지,143,3,9,5,7,10,177,132,2,10,4,7,10,165,
20221008,244,238,서부산,칠서,141,8,16,13,38,8,224,170,11,19,16,46,12,274,
20221008,244,245,서부산,장유,14694,109,275,65,106,928,16177,13947,109,283,57,148,941,15485,
20221008,244,261,서부산,동광주,191,1,15,12,9,7,235,253,3,15,4,7,4,286,
20221008,244,272,서부산,광양,530,9,17,12,14,12,594,334,3,10,6,15,9,377,
20221008,244,275,서부산,옥곡,180,1,5,11,41,4,242,198,1,8,3,38,6,254,
20221008,244,277,서부산,하동,210,2,0,1,7,10,230,182,0,0,1,3,12,198,
20221008,244,278,서부산,진교,233,1,3,0,1,7,245,134,0,8,0,0,8,150,
20221008,244,280,서부산,거창,137,1,4,2,1,5,150,112,2,2,1,1,6,124,
20221008,244,289,서부산,마산,5973,29,303,16,39,238,6598,5093,39,306,17,32,222,5709,
20221008,244,291,서부산,사천,555,2,8,3,12,23,603,423,5,8,2,8,22,468,
20221008,244,292,서부산,진주,309,1,13,4,4,21,352,393,2,16,4,3,15,433,
20221008,244,293,서부산,문산,307,4,4,1,3,14,333,274,2,6,2,2,9,295,
20221008,244,294,서부산,북창원,473,1,4,1,6,29,514,491,7,7,2,6,30,543,
20221008,244,295,서부산,진성,207,0,1,1,6,5,220,151,0,1,0,1,6,159,
20221008,244,544,서부산,완주,104,0,5,7,32,5,153,116,1,4,4,17,1,143,
20221008,245,135,장유,경주,495,2,2,0,9,20,528,527,2,11,3,11,27,581,
20221008,245,138,장유,양산,192,21,9,9,5,15,251,191,30,10,25,3,17,276,
20221008,245,139,장유,서울산,168,2,6,0,2,5,183,177,1,1,0,1,7,187,
20221008,245,140,장유,부산,123,0,0,1,0,9,133,102,1,0,0,0,7,110,
20221008,245,142,장유,군북,142,0,2,2,2,8,156,128,2,1,4,1,6,142,
20221008,245,146,장유,동창원,1174,7,12,5,2,86,1286,903,9,2,2,1,82,999,
20221008,245,147,장유,진례,816,19,38,21,13,77,984,737,25,32,24,14,63,895,
20221008,245,149,장유,동김해,552,22,27,8,2,37,648,770,19,38,9,10,55,901,
20221008,245,150,장유,북부산,3726,33,81,4,12,228,4084,4282,35,69,15,23,252,4676,
20221008,245,244,장유,서부산,13947,109,283,57,148,941,15485,14694,109,275,65,106,928,16177,
20221008,245,245,장유,장유,362,1,2,3,0,18,386,362,1,2,3,0,18,386,
20221008,245,250,장유,남양산,617,26,26,7,0,37,713,601,17,29,1,3,23,674,
20221008,245,251,장유,물금,595,39,10,5,5,34,688,572,39,3,16,13,41,684,
20221008,245,289,장유,마산,1853,14,36,9,9,105,2026,1893,16,39,26,10,118,2102,
20221008,245,291,장유,사천,124,0,3,3,1,4,135,124,1,3,2,2,7,139,
20221008,245,294,장유,북창원,229,0,1,1,0,23,254,368,4,4,0,0,35,411,
20221008,245,529,장유,노포,192,2,3,6,5,14,222,340,2,3,5,4,15,369,
20221008,245,641,장유,울산,560,7,25,8,12,29,641,755,5,26,6,10,44,846,
20221008,247,145,남원,산인,112,0,2,0,0,3,117,208,0,5,0,0,5,218,
20221008,247,224,남원,함양,157,4,3,2,2,8,176,147,0,0,0,1,2,150,
20221008,247,248,남원,순창,336,11,5,1,19,11,383,351,16,4,1,21,16,409,
20221008,247,261,남원,동광주,777,8,23,4,22,30,864,925,7,20,5,20,39,1016,
20221008,247,264,남원,동남원,256,8,8,2,2,20,296,243,4,7,3,1,19,277,
20221008,247,269,남원,지리산,928,7,16,9,7,34,1001,786,7,21,7,7,41,869,
20221008,247,519,남원,남대구,168,1,5,0,0,6,180,229,1,6,3,0,5,244,
20221008,247,569,남원,북광주,286,9,2,4,46,7,354,303,3,6,4,35,8,359,
20221008,248,247,순창,남원,351,16,4,1,21,16,409,336,11,5,1,19,11,383,
20221008,248,261,순창,동광주,1925,18,18,1,25,66,2053,1939,15,29,2,20,74,2079,
20221008,248,556,순창,동순천,140,2,4,1,1,4,152,133,0,1,0,1,3,138,
20221008,248,558,순창,구례화엄사,127,3,0,2,0,1,133,116,0,1,2,0,2,121,
20221008,248,569,순창,북광주,636,8,6,6,10,26,692,586,3,5,6,12,26,638,
20221008,249,261,담양,동광주,2998,21,98,10,30,106,3263,2767,23,100,11,28,101,3030,
20221008,249,271,담양,순천,282,3,8,3,1,9,306,339,0,5,2,1,10,357,
20221008,249,569,담양,북광주,454,8,6,12,7,17,504,434,9,3,10,7,4,467,
20221008,250,135,남양산,경주,678,3,18,1,4,30,734,587,6,17,2,3,27,642,
20221008,250,137,남양산,통도사,415,14,15,3,73,32,552,337,12,10,4,77,15,455,
20221008,250,138,남양산,양산,384,11,5,2,21,19,442,192,8,3,8,26,16,253,
20221008,250,139,남양산,서울산,764,6,9,6,6,43,834,716,10,9,2,4,44,785,
20221008,250,140,남양산,부산,7838,96,158,16,19,533,8660,7989,109,175,19,19,536,8847,
20221008,250,146,남양산,동창원,256,6,3,1,2,11,279,192,6,2,1,0,9,210,
20221008,250,148,남양산,서김해,852,21,17,3,4,52,949,999,17,15,13,7,65,1116,
20221008,250,149,남양산,동김해,904,11,41,7,3,69,1035,1003,11,51,5,6,92,1168,
20221008,250,245,남양산,장유,601,17,29,1,3,23,674,617,26,26,7,0,37,713,
20221008,250,252,남양산,대동,2867,93,56,30,58,191,3295,3568,91,78,58,71,239,4105,
20221008,250,286,남양산,통도사휴게소,325,6,0,0,0,25,356,286,3,0,0,0,12,301,
20221008,250,289,남양산,마산,764,12,28,3,6,29,842,683,16,33,1,10,20,763,
20221008,250,529,남양산,노포,249,15,3,2,2,17,288,257,3,3,4,1,21,289,
20221008,250,641,남양산,울산,668,14,51,4,2,39,778,652,28,34,6,7,37,764,
20221008,250,752,남양산,기장철마,281,3,3,2,3,19,311,352,4,2,2,6,24,390,
20221008,250,755,남양산,광재,311,5,9,1,12,25,363,356,4,5,2,11,18,396,
20221008,250,756,남양산,한림,83,6,6,1,45,3,144,90,4,8,3,33,5,143,
20221008,250,757,남양산,진영,216,1,6,6,4,8,241,190,5,8,7,5,6,221,
20221008,251,135,물금,경주,138,4,3,1,3,4,153,118,4,2,1,4,2,131,
20221008,251,138,물금,양산,109,18,7,9,15,8,166,110,11,5,17,14,5,162,
20221008,251,139,물금,서울산,162,8,8,9,3,9,199,161,13,6,9,5,13,207,
20221008,251,140,물금,부산,1047,85,13,28,28,48,1249,869,107,17,22,29,39,1083,
20221008,251,146,물금,동창원,245,7,4,3,5,13,277,172,10,4,1,0,13,200,
20221008,251,148,물금,서김해,946,32,12,31,10,62,1093,1004,33,14,18,12,66,1147,
20221008,251,149,물금,동김해,972,36,12,8,3,102,1133,1076,39,11,10,1,107,1244,
20221008,251,245,물금,장유,572,39,3,16,13,41,684,595,39,10,5,5,34,688,
20221008,251,252,물금,대동,2690,150,48,65,301,196,3450,3475,160,48,44,313,246,4286,
20221008,251,286,물금,통도사휴게소,87,7,0,0,0,9,103,97,0,0,0,0,8,105,
20221008,251,289,물금,마산,773,31,9,19,4,30,866,615,29,12,11,6,33,706,
20221008,251,641,물금,울산,153,39,7,6,5,9,219,177,31,8,7,2,11,236,
20221008,251,752,물금,기장철마,99,8,0,2,4,9,122,107,11,4,1,1,7,131,
20221008,251,755,물금,광재,377,14,5,8,8,29,441,403,14,11,3,12,27,470,
20221008,251,756,물금,한림,83,6,4,5,5,6,109,97,8,4,2,6,8,125,
20221008,251,757,물금,진영,229,12,4,8,5,14,272,233,11,5,4,5,14,272,
20221008,252,132,대동,영천,177,3,3,9,21,12,225,120,4,1,7,7,14,153,
20221008,252,133,대동,건천,292,7,14,7,11,10,341,193,7,6,3,19,9,237,
20221008,252,135,대동,경주,2340,12,66,10,30,81,2539,1871,8,64,17,54,86,2100,
20221008,252,137,대동,통도사,602,15,17,13,22,41,710,485,23,20,15,22,27,592,
20221008,252,138,대동,양산,1973,162,51,69,97,83,2435,1746,176,77,63,91,75,2228,
20221008,252,139,대동,서울산,1287,20,16,14,20,68,1425,1282,19,18,14,38,76,1447,
20221008,252,140,대동,부산,1036,20,26,19,87,65,1253,1115,25,32,23,36,80,1311,
20221008,252,250,대동,남양산,3568,91,78,58,71,239,4105,2867,93,56,30,58,191,3295,
20221008,252,251,대동,물금,3475,160,48,44,313,246,4286,2690,150,48,65,301,196,3450,
20221008,252,286,대동,통도사휴게소,510,6,2,0,0,24,542,466,7,0,0,0,23,496,
20221008,252,529,대동,노포,237,5,5,2,4,18,271,1073,15,17,13,25,67,1210,
20221008,252,641,대동,울산,2005,32,54,6,29,111,2237,2102,31,50,19,25,110,2337,
20221008,252,707,대동,남포항,286,2,10,4,16,20,338,123,4,3,0,23,6,159,
20221008,252,722,대동,활천,347,13,4,4,15,7,390,193,8,9,2,20,6,238,
20221008,252,752,대동,기장철마,1625,21,24,17,48,112,1847,1939,24,22,8,40,125,2158,
20221008,252,753,대동,금정,1610,37,46,32,129,85,1939,903,25,17,23,66,48,1082,
20221008,252,755,대동,광재,1867,26,37,27,143,118,2218,1750,30,33,30,173,98,2114,
20221008,252,756,대동,한림,492,21,10,9,30,23,585,573,19,20,5,108,23,748,
20221008,252,757,대동,진영,571,10,5,7,6,29,628,650,18,3,10,39,39,759,
20221008,252,771,대동,배내골,309,0,0,0,0,16,325,174,0,1,0,0,11,186,
20221008,253,102,서서울,동수원,5595,31,37,15,10,325,6013,5457,42,32,19,19,298,5867,
20221008,253,103,서서울,수원신갈,2477,76,58,35,35,112,2793,2235,107,54,44,28,105,2573,
20221008,253,105,서서울,기흥,856,9,7,9,6,37,924,836,14,7,12,9,34,912,
20221008,253,106,서서울,오산,383,27,23,14,10,19,476,441,32,15,15,7,18,528,
20221008,253,107,서서울,안성,425,9,3,5,4,27,473,547,3,2,3,7,23,585,
20221008,253,108,서서울,천안,715,10,8,4,4,33,774,646,5,2,5,0,28,686,
20221008,253,110,서서울,목천,88,1,2,7,5,4,107,145,1,7,11,8,5,177,
20221008,253,111,서서울,청주,252,2,4,5,2,7,272,379,7,3,4,1,16,410,
20221008,253,113,서서울,신탄진,166,4,3,6,10,4,193,208,4,2,11,25,6,256,
20221008,253,115,서서울,대전,195,0,3,0,1,7,206,191,2,2,0,3,13,211,
20221008,253,127,서서울,서대구,129,2,2,14,1,5,153,89,1,4,5,2,0,101,
20221008,253,129,서서울,북대구,114,0,1,7,0,6,128,128,1,0,4,2,5,140,
20221008,253,136,서서울,음성,282,1,3,8,4,12,310,159,4,5,4,0,4,176,
20221008,253,167,서서울,광주,668,6,7,12,7,13,713,466,3,3,22,13,7,514,
20221008,253,171,서서울,마성,1216,13,8,4,4,70,1315,1302,6,12,3,2,72,1397,
20221008,253,172,서서울,용인,748,28,7,14,11,37,845,898,26,10,21,12,60,1027,
20221008,253,173,서서울,양지,711,42,24,32,18,32,859,1299,78,39,70,28,54,1568,
20221008,253,175,서서울,덕평,213,15,8,16,4,5,261,214,24,11,15,2,10,276,
20221008,253,176,서서울,이천,166,1,6,37,12,12,234,268,4,5,37,20,19,353,
20221008,253,177,서서울,여주,168,2,1,7,5,12,195,217,0,0,6,5,8,236,
20221008,253,178,서서울,문막,171,0,2,4,2,10,189,126,2,4,3,10,5,150,
20221008,253,193,서서울,일죽,222,3,2,6,14,17,264,179,6,5,30,21,16,257,
20221008,253,197,서서울,증평,97,3,0,1,1,4,106,105,3,3,5,4,1,121,
20221008,253,212,서서울,북수원,1236,19,12,5,4,70,1346,2550,32,22,11,11,112,2738,
20221008,253,213,서서울,부곡,1180,57,28,24,40,73,1402,1239,68,34,19,47,71,1478,
20221008,253,215,서서울,군포,5117,90,88,70,88,284,5737,3676,36,50,24,43,214,4043,
20221008,253,227,서서울,군산,404,2,4,1,3,16,430,430,0,5,3,10,12,460,
20221008,253,228,서서울,동군산,197,2,2,1,3,10,215,185,4,1,1,1,4,196,
20221008,253,229,서서울,북천안,246,5,1,4,1,8,265,110,2,1,4,2,8,127,
20221008,253,234,서서울,서천,849,2,2,7,10,28,898,726,0,9,3,16,25,779,
20221008,253,239,서서울,칠원,113,3,0,7,1,2,126,113,2,4,11,6,4,140,
20221008,253,240,서서울,제천,230,1,0,0,0,11,242,117,2,4,1,0,1,125,
20221008,253,254,서서울,군자,243,4,3,3,4,11,268,1046,6,8,9,7,43,1119,
20221008,253,255,서서울,서안산,11414,217,131,158,213,688,12821,11425,221,112,108,207,689,12762,
20221008,253,256,서서울,안산,9444,103,52,37,38,609,10283,6382,81,46,17,47,405,6978,
20221008,253,257,서서울,홍성,1607,9,6,6,2,47,1677,1078,4,8,6,1,41,1138,
20221008,253,258,서서울,광천,812,7,9,4,8,22,862,670,5,10,9,12,17,723,
20221008,253,259,서서울,대천,1431,4,15,5,0,56,1511,964,3,8,4,2,31,1012,
20221008,253,260,서서울,춘장대,379,0,1,2,0,13,395,241,0,3,1,0,8,253,
20221008,253,281,서서울,매송,3901,36,27,11,32,209,4216,4794,44,25,17,60,253,5193,
20221008,253,282,서서울,비봉,5207,96,88,60,372,253,6076,5128,125,99,88,439,293,6172,
20221008,253,283,서서울,발안,5424,62,37,51,131,252,5957,4140,101,46,68,152,242,4749,
20221008,253,285,서서울,서평택,1453,11,29,46,91,75,1705,1334,20,33,75,168,81,1711,
20221008,253,287,서서울,송악,1972,17,14,26,93,88,2210,3048,24,27,48,223,132,3502,
20221008,253,288,서서울,당진,1438,5,22,12,17,66,1560,1981,9,33,19,36,86,2164,
20221008,253,298,서서울,서산,3627,21,32,21,8,139,3848,3500,17,32,18,26,145,3738,
20221008,253,299,서서울,해미,347,1,4,7,6,17,382,400,3,7,7,13,17,447,
20221008,253,502,서서울,부안,422,3,1,0,1,9,436,206,1,3,1,1,10,222,
20221008,253,506,서서울,영광,232,2,0,1,1,6,242,94,1,1,3,1,5,105,
20221008,253,509,서서울,목포,1143,5,5,3,2,18,1176,553,9,4,18,7,16,607,
20221008,253,511,서서울,무창포,350,1,3,0,0,10,364,203,1,0,0,0,5,209,
20221008,253,520,서서울,평택,3159,25,40,55,57,117,3453,2923,30,41,58,44,117,3213,
20221008,253,528,서서울,기흥동탄,797,4,10,4,5,47,867,731,3,18,3,6,39,800,
20221008,253,540,서서울,청북,1536,16,15,32,29,58,1686,871,32,23,49,53,53,1081,
20221008,253,541,서서울,송탄,245,6,6,11,5,14,287,374,10,13,16,4,13,430,
20221008,253,542,서서울,서안성,98,3,16,16,5,3,141,163,6,19,37,10,5,240,
20221008,253,543,서서울,남안성,381,7,9,17,8,12,434,522,16,9,13,9,24,593,
20221008,253,555,서서울,북진천,241,0,7,6,7,7,268,279,6,4,6,10,11,316,
20221008,253,560,서서울,감곡,270,3,0,4,9,5,291,251,1,1,2,30,5,290,
20221008,253,561,서서울,북충주,204,2,1,0,1,7,215,189,1,0,1,1,10,202,
20221008,253,562,서서울,충주,146,2,0,1,2,11,162,167,0,1,2,3,5,178,
20221008,253,566,서서울,점촌함창,116,0,0,0,0,4,120,111,0,0,1,3,8,123,
20221008,253,572,서서울,고덕,411,4,3,1,2,14,435,633,5,4,13,4,29,688,
20221008,253,573,서서울,예산수덕사,439,3,2,2,4,8,458,741,7,4,7,2,29,790,
20221008,253,574,서서울,신양,191,0,0,3,0,6,200,187,1,1,1,4,6,200,
20221008,253,705,서서울,남이천,81,3,2,14,20,3,123,153,4,4,15,28,7,211,
20221008,253,741,서서울,평택고덕,1231,12,7,8,5,76,1339,1640,18,10,14,8,117,1807,
20221008,254,102,군자,동수원,5597,41,52,27,28,248,5993,4381,31,42,11,13,181,4659,
20221008,254,103,군자,수원신갈,2326,71,43,71,49,98,2658,1877,66,43,39,39,90,2154,
20221008,254,105,군자,기흥,788,12,5,12,12,31,860,625,9,7,15,10,34,700,
20221008,254,106,군자,오산,340,20,22,18,9,24,433,299,27,22,23,11,16,398,
20221008,254,107,군자,안성,164,5,8,6,5,6,194,156,4,4,0,1,10,175,
20221008,254,108,군자,천안,337,4,6,1,1,13,362,188,3,1,2,2,10,206,
20221008,254,111,군자,청주,109,5,16,4,10,9,153,95,0,10,0,2,4,111,
20221008,254,127,군자,서대구,86,5,7,9,8,4,119,100,2,7,6,2,3,120,
20221008,254,171,군자,마성,1139,8,11,6,6,70,1240,811,5,6,2,5,45,874,
20221008,254,172,군자,용인,624,14,11,15,29,31,724,671,13,5,17,27,30,763,
20221008,254,173,군자,양지,619,28,42,58,81,26,854,901,49,36,83,69,47,1185,
20221008,254,175,군자,덕평,194,16,19,22,18,4,273,162,11,12,17,12,4,218,
20221008,254,176,군자,이천,212,8,11,12,37,15,295,305,1,13,15,20,16,370,
20221008,254,177,군자,여주,215,3,5,6,28,10,267,193,6,4,12,20,11,246,
20221008,254,178,군자,문막,287,7,21,7,13,7,342,191,2,15,2,32,5,247,
20221008,254,193,군자,일죽,145,4,7,11,26,5,198,140,8,9,17,25,6,205,
20221008,254,212,군자,북수원,1839,20,25,15,10,91,2000,2158,24,32,12,19,111,2356,
20221008,254,213,군자,부곡,1082,21,14,12,137,62,1328,862,23,9,11,169,51,1125,
20221008,254,215,군자,군포,3453,58,56,49,103,201,3920,2401,42,30,22,45,148,2688,
20221008,254,239,군자,칠원,76,2,7,10,5,0,100,92,1,6,6,5,3,113,
20221008,254,240,군자,제천,417,4,7,1,8,13,450,145,2,8,1,8,4,168,
20221008,254,253,군자,서서울,1046,6,8,9,7,43,1119,243,4,3,3,4,11,268,
20221008,254,255,군자,서안산,9768,204,138,121,178,544,10953,7422,202,99,109,187,445,8464,
20221008,254,256,군자,안산,5113,93,118,32,53,328,5737,5419,88,113,35,41,383,6079,
20221008,254,281,군자,매송,1238,13,9,9,19,66,1354,1248,14,5,8,18,78,1371,
20221008,254,282,군자,비봉,1271,42,32,31,101,76,1553,972,44,23,24,91,61,1215,
20221008,254,283,군자,발안,2019,18,31,31,76,112,2287,1149,20,31,23,42,55,1320,
20221008,254,285,군자,서평택,154,6,4,10,14,7,195,105,1,4,10,10,4,134,
20221008,254,287,군자,송악,160,1,1,9,25,3,199,310,2,2,3,40,14,371,
20221008,254,288,군자,당진,97,2,8,1,2,7,117,191,1,6,3,3,9,213,
20221008,254,298,군자,서산,293,0,10,2,5,11,321,335,0,6,2,3,16,362,
20221008,254,520,군자,평택,639,8,8,9,28,28,720,457,6,8,7,16,20,514,
20221008,254,528,군자,기흥동탄,727,13,4,4,6,37,791,550,5,6,4,3,34,602,
20221008,254,540,군자,청북,245,4,4,5,10,16,284,81,2,4,6,3,4,100,
20221008,254,543,군자,남안성,135,3,2,5,5,3,153,88,1,2,8,2,7,108,
20221008,254,560,군자,감곡,246,2,3,11,28,10,300,199,4,3,8,61,5,280,
20221008,254,561,군자,북충주,138,1,10,4,3,12,168,142,3,10,2,6,6,169,
20221008,254,562,군자,충주,129,1,1,1,3,5,140,125,2,4,1,3,4,139,
20221008,254,705,군자,남이천,88,1,4,10,10,4,117,99,4,8,16,15,5,147,
20221008,254,741,군자,평택고덕,196,6,1,3,4,9,219,208,1,0,6,2,14,231,
20221008,255,102,서안산,동수원,1534,34,12,8,6,84,1678,1310,26,9,6,2,70,1423,
20221008,255,103,서안산,수원신갈,619,48,18,16,21,27,749,497,38,15,15,10,24,599,
20221008,255,105,서안산,기흥,192,9,4,4,1,5,215,145,5,3,7,2,3,165,
20221008,255,171,서안산,마성,267,8,4,6,4,14,303,188,6,2,0,1,12,209,
20221008,255,172,서안산,용인,270,11,4,6,6,11,308,246,8,8,6,9,16,293,
20221008,255,173,서안산,양지,179,19,22,27,3,4,254,280,26,27,46,15,16,410,
20221008,255,175,서안산,덕평,71,3,15,17,6,5,117,73,3,12,23,3,1,115,
20221008,255,176,서안산,이천,90,6,3,5,19,4,127,128,3,7,16,17,6,177,
20221008,255,212,서안산,북수원,484,2,3,10,3,31,533,570,11,4,9,2,40,636,
20221008,255,213,서안산,부곡,389,17,4,7,46,27,490,397,15,9,8,38,19,486,
20221008,255,215,서안산,군포,984,27,17,26,27,83,1164,822,16,8,6,10,61,923,
20221008,255,253,서안산,서서울,11425,221,112,108,207,689,12762,11414,217,131,158,213,688,12821,
20221008,255,254,서안산,군자,7422,202,99,109,187,445,8464,9768,204,138,121,178,544,10953,
20221008,255,256,서안산,안산,491,22,14,9,12,57,605,697,25,17,11,10,72,832,
20221008,255,281,서안산,매송,141,1,2,2,2,7,155,158,1,2,0,2,10,173,
20221008,255,282,서안산,비봉,145,5,3,2,19,6,180,141,12,8,3,14,3,181,
20221008,255,283,서안산,발안,300,5,5,1,1,10,322,210,3,2,2,3,11,231,
20221008,255,520,서안산,평택,169,2,0,1,1,4,177,94,1,3,1,0,4,103,
20221008,255,528,서안산,기흥동탄,141,1,2,2,7,6,159,116,2,0,2,7,8,135,
20221008,256,102,안산,동수원,483,8,2,1,0,28,522,438,10,1,0,0,22,471,
20221008,256,103,안산,수원신갈,179,8,4,4,0,11,206,147,9,6,0,0,8,170,
20221008,256,172,안산,용인,101,0,2,1,1,2,107,92,1,0,0,1,6,100,
20221008,256,212,안산,북수원,100,1,1,0,0,6,108,125,1,1,0,1,6,134,
20221008,256,215,안산,군포,147,4,2,0,2,12,167,116,3,0,0,0,9,128,
20221008,256,253,안산,서서울,6382,81,46,17,47,405,6978,9444,103,52,37,38,609,10283,
20221008,256,254,안산,군자,5419,88,113,35,41,383,6079,5113,93,118,32,53,328,5737,
20221008,256,255,안산,서안산,697,25,17,11,10,72,832,491,22,14,9,12,57,605,
20221008,257,227,홍성,군산,194,0,4,3,4,2,207,153,0,2,5,2,4,166,
20221008,257,228,홍성,동군산,171,1,7,4,5,1,189,348,6,11,9,4,5,383,
20221008,257,234,홍성,서천,198,4,8,1,12,5,228,213,2,4,2,16,8,245,
20221008,257,253,홍성,서서울,1078,4,8,6,1,41,1138,1607,9,6,6,2,47,1677,
20221008,257,258,홍성,광천,179,4,8,2,7,7,207,206,2,8,3,11,2,232,
20221008,257,259,홍성,대천,562,7,13,1,9,17,609,337,7,6,0,8,8,366,
20221008,257,281,홍성,매송,99,3,2,2,0,0,106,110,0,1,2,0,3,116,
20221008,257,282,홍성,비봉,243,1,1,4,0,6,255,274,0,2,0,1,4,281,
20221008,257,283,홍성,발안,175,1,0,0,0,5,181,135,3,1,0,0,4,143,
20221008,257,285,홍성,서평택,134,2,3,2,3,3,147,909,1,3,0,3,42,958,
20221008,257,288,홍성,당진,452,3,5,4,3,25,492,1004,1,3,3,2,24,1037,
20221008,257,298,홍성,서산,258,3,11,4,25,8,309,298,4,5,3,13,16,339,
20221008,257,299,홍성,해미,136,3,0,0,4,3,146,125,0,1,1,3,2,132,
20221008,257,520,홍성,평택,373,2,6,2,0,17,400,503,4,5,1,0,16,529,
20221008,257,540,홍성,청북,157,1,3,1,2,6,170,166,0,4,1,2,4,177,
20221008,258,227,광천,군산,146,1,11,3,10,6,177,115,2,10,3,9,3,142,
20221008,258,228,광천,동군산,139,1,8,7,11,5,171,212,0,6,7,10,7,242,
20221008,258,234,광천,서천,225,3,7,7,33,8,283,222,1,4,12,37,9,285,
20221008,258,253,광천,서서울,670,5,10,9,12,17,723,812,7,9,4,8,22,862,
20221008,258,257,광천,홍성,206,2,8,3,11,2,232,179,4,8,2,7,7,207,
20221008,258,259,광천,대천,1054,14,8,1,10,33,1120,693,11,12,0,14,21,751,
20221008,258,260,광천,춘장대,135,1,2,1,7,5,151,95,2,4,0,10,2,113,
20221008,258,282,광천,비봉,105,0,0,1,0,3,109,136,1,1,0,1,5,144,
20221008,258,288,광천,당진,252,3,6,6,32,9,308,303,4,7,6,30,5,355,
20221008,258,298,광천,서산,246,1,5,4,48,9,313,285,5,4,6,47,9,356,
20221008,258,299,광천,해미,224,1,2,0,2,8,237,200,1,0,3,2,10,216,
20221008,258,520,광천,평택,171,3,4,6,2,8,194,211,6,8,2,0,9,236,
20221008,259,227,대천,군산,460,3,12,2,3,11,491,473,0,12,0,0,9,494,
20221008,259,228,대천,동군산,487,8,10,3,4,11,523,812,8,9,4,4,20,857,
20221008,259,234,대천,서천,392,3,9,4,5,19,432,470,6,8,2,9,22,517,
20221008,259,253,대천,서서울,964,3,8,4,2,31,1012,1431,4,15,5,0,56,1511,
20221008,259,257,대천,홍성,337,7,6,0,8,8,366,562,7,13,1,9,17,609,
20221008,259,258,대천,광천,693,11,12,0,14,21,751,1054,14,8,1,10,33,1120,
20221008,259,260,대천,춘장대,105,4,9,0,0,5,123,104,6,4,0,0,3,117,
20221008,259,282,대천,비봉,158,0,0,0,0,9,167,243,0,2,1,0,10,256,
20221008,259,283,대천,발안,118,0,0,0,0,5,123,135,1,1,1,0,5,143,
20221008,259,288,대천,당진,373,2,12,2,3,16,408,991,2,15,7,3,22,1040,
20221008,259,298,대천,서산,285,1,2,3,11,8,310,416,1,0,1,7,19,444,
20221008,259,299,대천,해미,256,6,9,1,0,16,288,433,5,6,0,1,17,462,
20221008,259,520,대천,평택,286,3,11,2,0,10,312,511,4,17,2,0,18,552,
20221008,259,540,대천,청북,122,0,1,2,0,6,131,133,0,0,1,0,4,138,
20221008,260,253,춘장대,서서울,241,0,3,1,0,8,253,379,0,1,2,0,13,395,
20221008,260,258,춘장대,광천,95,2,4,0,10,2,113,135,1,2,1,7,5,151,
20221008,260,259,춘장대,대천,104,6,4,0,0,3,117,105,4,9,0,0,5,123,
20221008,260,511,춘장대,무창포,269,0,1,0,5,8,283,123,1,3,0,0,5,132,
20221008,261,135,동광주,경주,295,1,8,1,2,8,315,123,1,4,1,2,5,136,
20221008,261,145,동광주,산인,721,2,67,8,9,11,818,619,5,76,10,6,11,727,
20221008,261,150,동광주,북부산,235,1,2,3,1,3,245,140,2,3,1,0,3,149,
20221008,261,224,동광주,함양,105,1,3,0,22,3,134,82,0,1,1,15,2,101,
20221008,261,244,동광주,서부산,253,3,15,4,7,4,286,191,1,15,12,9,7,235,
20221008,261,247,동광주,남원,925,7,20,5,20,39,1016,777,8,23,4,22,30,864,
20221008,261,248,동광주,순창,1939,15,29,2,20,74,2079,1925,18,18,1,25,66,2053,
20221008,261,249,동광주,담양,2767,23,100,11,28,101,3030,2998,21,98,10,30,106,3263,
20221008,261,262,동광주,창평,1925,64,26,17,22,60,2114,1899,56,31,28,32,61,2107,
20221008,261,263,동광주,옥과,3051,14,90,12,16,125,3308,2591,15,84,8,16,118,2832,
20221008,261,264,동광주,동남원,241,1,3,4,1,5,255,130,3,3,4,0,4,144,
20221008,261,265,동광주,곡성,2112,17,33,14,25,70,2271,1656,13,34,8,19,63,1793,
20221008,261,266,동광주,석곡,600,4,2,2,9,23,640,436,2,5,2,1,16,462,
20221008,261,267,동광주,주암송광사,242,2,1,0,1,7,253,155,0,0,1,1,7,164,
20221008,261,268,동광주,승주,187,1,2,0,0,5,195,128,3,1,1,2,5,140,
20221008,261,269,동광주,지리산,291,0,2,4,1,7,305,176,1,0,1,0,5,183,
20221008,261,270,동광주,서순천,1333,17,55,3,4,38,1450,1332,18,57,10,9,29,1455,
20221008,261,271,동광주,순천,5236,58,90,18,46,153,5601,4873,69,80,18,52,156,5248,
20221008,261,272,동광주,광양,426,3,20,4,19,15,487,301,3,20,7,9,6,346,
20221008,261,273,동광주,동광양,602,4,5,5,27,18,661,673,6,7,0,12,22,720,
20221008,261,275,동광주,옥곡,178,2,0,3,1,9,193,165,1,3,0,3,8,180,
20221008,261,277,동광주,하동,394,0,2,2,0,9,407,156,0,1,1,1,4,163,
20221008,261,280,동광주,거창,124,5,8,3,1,3,144,100,2,7,0,1,2,112,
20221008,261,292,동광주,진주,88,1,9,2,0,2,102,92,0,9,2,1,7,111,
20221008,261,516,동광주,통영,429,2,6,0,0,5,442,186,1,4,0,0,4,195,
20221008,261,519,동광주,남대구,610,8,62,9,3,17,709,596,5,67,16,0,21,705,
20221008,261,527,동광주,포항,197,1,5,0,1,5,209,164,1,6,2,4,3,180,
20221008,261,558,동광주,구례화엄사,888,5,9,1,10,20,933,673,12,10,2,15,15,727,
20221008,261,559,동광주,서남원,203,3,6,3,5,7,227,186,2,3,4,7,10,212,
20221008,261,567,동광주,남고창,115,1,0,0,0,1,117,137,0,1,0,0,4,142,
20221008,261,586,동광주,북남원,133,1,2,1,0,5,142,175,0,2,2,0,7,186,
20221008,261,587,동광주,오수,382,0,1,0,1,9,393,323,3,0,0,1,9,336,
20221008,261,588,동광주,임실,351,2,2,0,0,13,368,263,3,5,0,0,13,284,
20221008,261,589,동광주,상관,101,0,1,0,0,2,104,113,1,0,0,0,5,119,
20221008,261,590,동광주,동전주,105,0,0,0,0,7,112,128,0,1,0,1,3,133,
20221008,262,261,창평,동광주,1899,56,31,28,32,61,2107,1925,64,26,17,22,60,2114,
20221008,262,263,창평,옥과,181,2,0,1,0,9,193,192,0,0,1,0,5,198,
20221008,262,265,창평,곡성,158,1,0,0,1,8,168,132,0,2,1,1,6,142,
20221008,262,271,창평,순천,208,3,7,0,3,5,226,207,3,3,1,4,15,233,
20221008,263,261,옥과,동광주,2591,15,84,8,16,118,2832,3051,14,90,12,16,125,3308,
20221008,263,262,옥과,창평,192,0,0,1,0,5,198,181,2,0,1,0,9,193,
20221008,263,271,옥과,순천,240,8,2,2,7,10,269,243,3,3,3,9,11,272,
20221008,263,569,옥과,북광주,770,7,6,13,16,24,836,892,6,5,11,12,34,960,
20221008,264,247,동남원,남원,243,4,7,3,1,19,277,256,8,8,2,2,20,296,
20221008,264,261,동남원,동광주,130,3,3,4,0,4,144,241,1,3,4,1,5,255,
20221008,265,261,곡성,동광주,1656,13,34,8,19,63,1793,2112,17,33,14,25,70,2271,
20221008,265,262,곡성,창평,132,0,2,1,1,6,142,158,1,0,0,1,8,168,
20221008,265,266,곡성,석곡,99,2,4,1,0,1,107,106,1,2,1,0,2,112,
20221008,265,267,곡성,주암송광사,271,2,4,1,7,9,294,187,1,2,2,1,7,200,
20221008,265,271,곡성,순천,186,3,2,2,11,13,217,189,2,2,3,20,4,220,
20221008,265,569,곡성,북광주,477,5,8,9,13,14,526,614,2,2,7,13,13,651,
20221008,266,261,석곡,동광주,436,2,5,2,1,16,462,600,4,2,2,9,23,640,
20221008,266,265,석곡,곡성,106,1,2,1,0,2,112,99,2,4,1,0,1,107,
20221008,266,271,석곡,순천,109,2,1,1,0,11,124,135,3,3,0,1,8,150,
20221008,266,569,석곡,북광주,160,2,1,1,3,7,174,194,2,0,1,2,2,201,
20221008,267,145,주암송광사,산인,116,0,1,1,0,1,119,153,0,0,0,0,4,157,
20221008,267,261,주암송광사,동광주,155,0,0,1,1,7,164,242,2,1,0,1,7,253,
20221008,267,265,주암송광사,곡성,187,1,2,2,1,7,200,271,2,4,1,7,9,294,
20221008,267,270,주암송광사,서순천,463,9,9,1,4,19,505,461,4,10,1,2,27,505,
20221008,267,271,주암송광사,순천,950,6,12,7,20,27,1022,927,5,7,7,21,26,993,
20221008,267,273,주암송광사,동광양,131,0,0,0,3,5,139,147,1,0,1,0,4,153,
20221008,267,569,주암송광사,북광주,112,5,2,2,1,4,126,126,2,0,1,1,4,134,
20221008,268,261,승주,동광주,128,3,1,1,2,5,140,187,1,2,0,0,5,195,
20221008,268,270,승주,서순천,182,4,3,0,1,7,197,173,4,2,0,1,4,184,
20221008,268,271,승주,순천,521,1,6,0,1,22,551,543,5,8,1,1,26,584,
20221008,269,247,지리산,남원,786,7,21,7,7,41,869,928,7,16,9,7,34,1001,
20221008,269,261,지리산,동광주,176,1,0,1,0,5,183,291,0,2,4,1,7,305,
20221008,269,589,지리산,상관,109,2,4,0,4,4,123,135,1,3,1,3,4,147,
20221008,270,261,서순천,동광주,1332,18,57,10,9,29,1455,1333,17,55,3,4,38,1450,
20221008,270,267,서순천,주암송광사,461,4,10,1,2,27,505,463,9,9,1,4,19,505,
20221008,270,268,서순천,승주,173,4,2,0,1,4,184,182,4,3,0,1,7,197,
20221008,270,271,서순천,순천,166,1,1,7,13,4,192,183,0,1,5,11,14,214,
20221008,270,273,서순천,동광양,95,0,0,2,6,7,110,121,1,0,1,2,6,131,
20221008,270,569,서순천,북광주,266,11,6,3,7,7,300,344,14,1,3,5,8,375,
20221008,271,145,순천,산인,266,0,4,1,1,8,280,278,0,5,0,3,8,294,
20221008,271,166,순천,장성,126,3,6,0,3,4,142,142,6,6,2,4,2,162,
20221008,271,249,순천,담양,339,0,5,2,1,10,357,282,3,8,3,1,9,306,
20221008,271,261,순천,동광주,4873,69,80,18,52,156,5248,5236,58,90,18,46,153,5601,
20221008,271,262,순천,창평,207,3,3,1,4,15,233,208,3,7,0,3,5,226,
20221008,271,263,순천,옥과,243,3,3,3,9,11,272,240,8,2,2,7,10,269,
20221008,271,265,순천,곡성,189,2,2,3,20,4,220,186,3,2,2,11,13,217,
20221008,271,266,순천,석곡,135,3,3,0,1,8,150,109,2,1,1,0,11,124,
20221008,271,267,순천,주암송광사,927,5,7,7,21,26,993,950,6,12,7,20,27,1022,
20221008,271,268,순천,승주,543,5,8,1,1,26,584,521,1,6,0,1,22,551,
20221008,271,270,순천,서순천,183,0,1,5,11,14,214,166,1,1,7,13,4,192,
20221008,271,273,순천,동광양,327,1,5,0,10,12,355,377,1,1,0,3,11,393,
20221008,271,275,순천,옥곡,154,1,2,0,4,6,167,119,1,2,0,4,2,128,
20221008,271,276,순천,진월,109,1,1,0,10,3,124,115,1,3,0,17,6,142,
20221008,271,277,순천,하동,245,3,1,0,0,11,260,180,0,0,1,0,9,190,
20221008,271,292,순천,진주,97,2,0,1,0,2,102,95,0,1,0,1,4,101,
20221008,271,557,순천,황전,539,8,4,1,32,28,612,408,2,5,0,16,19,450,
20221008,271,558,순천,구례화엄사,162,4,3,1,2,9,181,126,2,2,2,1,2,135,
20221008,271,559,순천,서남원,141,1,4,1,6,8,161,116,1,3,2,5,3,130,
20221008,271,567,순천,남고창,99,2,0,0,4,1,106,101,1,1,2,3,1,109,
20221008,271,569,순천,북광주,1213,45,20,11,70,28,1387,1342,41,20,23,29,30,1485,
20221008,271,589,순천,상관,283,4,2,0,12,10,311,291,2,2,0,5,8,308,
20221008,271,590,순천,동전주,158,4,1,0,0,3,166,117,0,1,0,0,5,123,
20221008,272,145,광양,산인,1201,7,43,18,4,34,1307,2091,9,54,14,12,54,2234,
20221008,272,150,광양,북부산,281,0,3,1,2,7,294,409,2,3,0,1,16,431,
20221008,272,225,광양,서진주,192,6,5,2,6,6,217,255,4,8,7,19,11,304,
20221008,272,244,광양,서부산,334,3,10,6,15,9,377,530,9,17,12,14,12,594,
20221008,272,261,광양,동광주,301,3,20,7,9,6,346,426,3,20,4,19,15,487,
20221008,272,275,광양,옥곡,165,3,2,0,4,13,187,187,4,4,0,3,9,207,
20221008,272,276,광양,진월,217,0,6,3,52,15,293,245,2,4,1,55,15,322,
20221008,272,277,광양,하동,604,1,11,2,9,25,652,525,2,10,2,15,24,578,
20221008,272,278,광양,진교,119,2,6,1,2,6,136,93,0,5,0,3,4,105,
20221008,272,279,광양,곤양,187,1,5,3,9,10,215,271,1,3,5,11,11,302,
20221008,272,291,광양,사천,281,7,10,5,16,9,328,364,10,13,3,26,11,427,
20221008,272,292,광양,진주,264,2,4,3,7,5,285,355,7,9,0,13,17,401,
20221008,272,295,광양,진성,149,0,5,4,3,0,161,276,3,5,1,9,7,301,
20221008,272,513,광양,고성,89,0,2,7,2,1,101,110,0,4,3,7,3,127,
20221008,272,515,광양,북통영,106,2,1,0,1,8,118,111,0,7,2,1,4,125,
20221008,272,516,광양,통영,474,2,15,4,5,22,522,381,1,10,4,4,22,422,
20221008,272,519,광양,남대구,120,0,6,3,1,2,132,189,2,11,5,0,5,212,
20221008,272,557,광양,황전,115,1,2,7,25,4,154,109,0,2,8,26,5,150,
20221008,272,569,광양,북광주,90,3,0,6,20,1,120,100,4,2,5,16,2,129,
20221008,272,589,광양,상관,60,0,3,0,51,2,116,90,0,2,11,122,3,228,
20221008,273,145,동광양,산인,127,1,0,0,8,2,138,86,0,0,0,25,3,114,
20221008,273,261,동광양,동광주,673,6,7,0,12,22,720,602,4,5,5,27,18,661,
20221008,273,267,동광양,주암송광사,147,1,0,1,0,4,153,131,0,0,0,3,5,139,
20221008,273,270,동광양,서순천,121,1,0,1,2,6,131,95,0,0,2,6,7,110,
20221008,273,271,동광양,순천,377,1,1,0,3,11,393,327,1,5,0,10,12,355,
20221008,273,557,동광양,황전,220,0,4,1,5,9,239,153,0,3,1,8,7,172,
20221008,273,569,동광양,북광주,193,7,0,1,22,6,229,161,3,1,3,36,3,207,
20221008,273,589,동광양,상관,142,1,2,1,11,3,160,125,0,2,12,49,2,190,
20221008,274,231,가조,화원옥포,128,2,3,0,0,6,139,158,1,4,0,0,8,171,
20221008,274,239,가조,칠원,121,1,1,0,1,6,130,180,3,1,0,0,5,189,
20221008,274,242,가조,고령,170,4,4,0,2,6,186,221,3,3,1,1,8,237,
20221008,274,280,가조,거창,568,12,21,4,2,26,633,629,11,16,5,1,31,693,
20221008,274,519,가조,남대구,407,0,4,0,0,16,427,486,2,4,0,0,16,508,
20221008,275,145,옥곡,산인,613,0,31,10,32,12,698,526,1,30,6,34,13,610,
20221008,275,150,옥곡,북부산,146,2,2,1,30,3,184,95,0,2,2,10,2,111,
20221008,275,225,옥곡,서진주,149,5,11,1,67,4,237,123,1,7,3,34,5,173,
20221008,275,244,옥곡,서부산,198,1,8,3,38,6,254,180,1,5,11,41,4,242,
20221008,275,261,옥곡,동광주,165,1,3,0,3,8,180,178,2,0,3,1,9,193,
20221008,275,271,옥곡,순천,119,1,2,0,4,2,128,154,1,2,0,4,6,167,
20221008,275,272,옥곡,광양,187,4,4,0,3,9,207,165,3,2,0,4,13,187,
20221008,275,277,옥곡,하동,301,4,6,6,27,13,357,222,4,8,3,17,6,260,
20221008,275,279,옥곡,곤양,163,3,0,0,9,9,184,133,2,3,3,19,4,164,
20221008,275,291,옥곡,사천,189,8,3,4,17,10,231,157,10,3,3,22,8,203,
20221008,275,292,옥곡,진주,183,6,3,1,15,10,218,160,8,2,1,18,4,193,
20221008,275,516,옥곡,통영,214,0,7,5,10,12,248,120,0,4,0,6,4,134,
20221008,275,519,옥곡,남대구,123,1,4,1,9,4,142,94,2,4,0,2,4,106,
20221008,276,271,진월,순천,115,1,3,0,17,6,142,109,1,1,0,10,3,124,
20221008,276,272,진월,광양,245,2,4,1,55,15,322,217,0,6,3,52,15,293,
20221008,277,145,하동,산인,717,5,5,1,13,27,768,1133,1,2,6,11,40,1193,
20221008,277,150,하동,북부산,162,0,0,0,2,4,168,181,0,1,3,2,10,197,
20221008,277,225,하동,서진주,125,2,3,0,48,6,184,139,2,4,6,38,7,196,
20221008,277,244,하동,서부산,182,0,0,1,3,12,198,210,2,0,1,7,10,230,
20221008,277,261,하동,동광주,156,0,1,1,1,4,163,394,0,2,2,0,9,407,
20221008,277,271,하동,순천,180,0,0,1,0,9,190,245,3,1,0,0,11,260,
20221008,277,272,하동,광양,525,2,10,2,15,24,578,604,1,11,2,9,25,652,
20221008,277,275,하동,옥곡,222,4,8,3,17,6,260,301,4,6,6,27,13,357,
20221008,277,278,하동,진교,160,2,15,0,11,6,194,139,6,15,1,12,10,183,
20221008,277,279,하동,곤양,163,4,6,1,20,5,199,144,2,9,1,32,8,196,
20221008,277,291,하동,사천,284,6,3,2,20,12,327,259,7,1,3,27,17,314,
20221008,277,292,하동,진주,355,4,3,1,33,12,408,351,4,3,9,38,14,419,
20221008,277,295,하동,진성,77,0,1,0,28,4,110,103,2,2,6,35,8,156,
20221008,277,516,하동,통영,211,0,4,0,16,4,235,181,0,5,4,8,8,206,
20221008,277,556,하동,동순천,98,1,0,0,0,5,104,151,2,7,2,1,10,173,
20221008,278,145,진교,산인,590,2,13,0,1,18,624,1147,3,17,1,2,40,1210,
20221008,278,150,진교,북부산,131,1,1,0,0,5,138,178,0,1,0,0,7,186,
20221008,278,225,진교,서진주,310,6,4,2,7,16,345,316,1,6,4,5,17,349,
20221008,278,244,진교,서부산,134,0,8,0,0,8,150,233,1,3,0,1,7,245,
20221008,278,272,진교,광양,93,0,5,0,3,4,105,119,2,6,1,2,6,136,
20221008,278,277,진교,하동,139,6,15,1,12,10,183,160,2,15,0,11,6,194,
20221008,278,291,진교,사천,446,6,5,1,6,30,494,475,7,6,2,0,33,523,
20221008,278,292,진교,진주,794,7,38,8,4,46,897,851,9,41,9,2,38,950,
20221008,278,293,진교,문산,122,0,0,0,2,5,129,166,0,2,0,0,7,175,
20221008,278,516,진교,통영,125,1,1,0,0,9,136,135,1,1,0,0,11,148,
20221008,279,145,곤양,산인,223,0,9,2,2,6,242,385,0,10,1,0,16,412,
20221008,279,225,곤양,서진주,148,1,2,1,6,8,166,129,1,3,0,4,5,142,
20221008,279,272,곤양,광양,271,1,3,5,11,11,302,187,1,5,3,9,10,215,
20221008,279,275,곤양,옥곡,133,2,3,3,19,4,164,163,3,0,0,9,9,184,
20221008,279,277,곤양,하동,144,2,9,1,32,8,196,163,4,6,1,20,5,199,
20221008,279,291,곤양,사천,338,8,3,5,8,19,381,299,6,5,3,3,11,327,
20221008,279,292,곤양,진주,516,5,19,4,2,26,572,492,6,14,3,0,20,535,
20221008,280,150,거창,북부산,103,2,1,0,1,5,112,112,3,1,0,0,8,124,
20221008,280,201,거창,칠곡,125,2,3,0,3,6,139,134,2,1,0,2,6,145,
20221008,280,224,거창,함양,159,7,22,4,1,7,200,128,5,28,0,1,8,170,
20221008,280,225,거창,서진주,109,0,13,1,0,8,131,100,2,8,0,0,6,116,
20221008,280,231,거창,화원옥포,340,6,6,0,0,17,369,438,8,10,1,1,14,472,
20221008,280,233,거창,현풍,140,3,4,6,5,9,167,164,4,6,3,4,11,192,
20221008,280,236,거창,영산,97,0,1,1,2,3,104,299,3,8,2,2,12,326,
20221008,280,239,거창,칠원,401,3,12,3,1,15,435,622,5,10,0,4,22,663,
20221008,280,241,거창,동고령,79,1,5,2,14,3,104,92,1,2,1,15,3,114,
20221008,280,242,거창,고령,303,7,17,2,38,11,378,391,14,16,3,17,13,454,
20221008,280,243,거창,해인사,135,3,0,0,1,11,150,131,1,1,0,1,11,145,
20221008,280,244,거창,서부산,112,2,2,1,1,6,124,137,1,4,2,1,5,150,
20221008,280,261,거창,동광주,100,2,7,0,1,2,112,124,5,8,3,1,3,144,
20221008,280,274,거창,가조,629,11,16,5,1,31,693,568,12,21,4,2,26,633,
20221008,280,291,거창,사천,109,1,3,1,2,2,118,93,2,4,1,0,1,101,
20221008,280,519,거창,남대구,1689,10,41,5,7,79,1831,1979,15,39,5,9,107,2154,
20221008,281,102,매송,동수원,298,2,0,1,0,13,314,299,2,1,0,0,16,318,
20221008,281,103,매송,수원신갈,101,3,2,0,0,5,111,93,2,0,1,0,9,105,
20221008,281,253,매송,서서울,4794,44,25,17,60,253,5193,3901,36,27,11,32,209,4216,
20221008,281,254,매송,군자,1248,14,5,8,18,78,1371,1238,13,9,9,19,66,1354,
20221008,281,255,매송,서안산,158,1,2,0,2,10,173,141,1,2,2,2,7,155,
20221008,281,257,매송,홍성,110,0,1,2,0,3,116,99,3,2,2,0,0,106,
20221008,281,282,매송,비봉,307,10,9,4,7,22,359,317,15,6,9,12,19,378,
20221008,281,283,매송,발안,513,7,0,3,10,32,565,419,14,6,1,10,22,472,
20221008,281,285,매송,서평택,184,1,13,3,5,12,218,145,6,10,2,4,11,178,
20221008,281,287,매송,송악,232,3,10,3,5,11,264,347,6,11,2,6,19,391,
20221008,281,288,매송,당진,118,2,1,0,2,10,133,173,0,1,0,1,6,181,
20221008,281,298,매송,서산,264,4,2,1,1,10,282,291,4,2,2,0,16,315,
20221008,281,520,매송,평택,297,5,3,5,9,12,331,264,2,2,4,4,8,284,
20221008,281,540,매송,청북,155,4,3,0,1,6,169,107,2,1,0,2,5,117,
20221008,281,741,매송,평택고덕,196,2,0,2,0,19,219,204,0,2,0,0,17,223,
20221008,282,234,비봉,서천,143,0,1,1,2,5,152,98,1,2,1,1,4,107,
20221008,282,253,비봉,서서울,5128,125,99,88,439,293,6172,5207,96,88,60,372,253,6076,
20221008,282,254,비봉,군자,972,44,23,24,91,61,1215,1271,42,32,31,101,76,1553,
20221008,282,255,비봉,서안산,141,12,8,3,14,3,181,145,5,3,2,19,6,180,
20221008,282,257,비봉,홍성,274,0,2,0,1,4,281,243,1,1,4,0,6,255,
20221008,282,258,비봉,광천,136,1,1,0,1,5,144,105,0,0,1,0,3,109,
20221008,282,259,비봉,대천,243,0,2,1,0,10,256,158,0,0,0,0,9,167,
20221008,282,281,비봉,매송,317,15,6,9,12,19,378,307,10,9,4,7,22,359,
20221008,282,283,비봉,발안,929,8,4,4,5,35,985,562,6,7,2,13,24,614,
20221008,282,285,비봉,서평택,207,5,7,10,9,10,248,169,4,8,10,13,15,219,
20221008,282,287,비봉,송악,403,5,4,5,18,20,455,679,3,7,11,21,48,769,
20221008,282,288,비봉,당진,227,4,0,1,2,9,243,322,4,2,2,5,16,351,
20221008,282,298,비봉,서산,646,7,2,2,2,19,678,610,1,2,6,5,21,645,
20221008,282,520,비봉,평택,357,2,4,2,2,9,376,150,1,6,5,10,10,182,
20221008,282,741,비봉,평택고덕,117,2,1,3,1,5,129,149,0,3,2,2,12,168,
20221008,283,253,발안,서서울,4140,101,46,68,152,242,4749,5424,62,37,51,131,252,5957,
20221008,283,254,발안,군자,1149,20,31,23,42,55,1320,2019,18,31,31,76,112,2287,
20221008,283,255,발안,서안산,210,3,2,2,3,11,231,300,5,5,1,1,10,322,
20221008,283,257,발안,홍성,135,3,1,0,0,4,143,175,1,0,0,0,5,181,
20221008,283,259,발안,대천,135,1,1,1,0,5,143,118,0,0,0,0,5,123,
20221008,283,281,발안,매송,419,14,6,1,10,22,472,513,7,0,3,10,32,565,
20221008,283,282,발안,비봉,562,6,7,2,13,24,614,929,8,4,4,5,35,985,
20221008,283,285,발안,서평택,220,7,4,8,12,11,262,225,8,9,5,5,14,266,
20221008,283,287,발안,송악,257,6,3,1,15,14,296,467,9,8,13,31,21,549,
20221008,283,288,발안,당진,121,0,1,3,6,8,139,275,3,6,5,13,15,317,
20221008,283,298,발안,서산,337,3,6,3,9,16,374,419,5,8,4,4,13,453,
20221008,283,520,발안,평택,171,2,1,4,9,2,189,134,1,1,2,13,6,157,
20221008,284,174,남양양,춘천,150,1,1,1,0,5,158,193,2,1,0,3,7,206,
20221008,284,189,남양양,강릉,141,1,0,0,2,12,156,183,4,1,1,3,9,201,
20221008,284,510,남양양,양양,182,3,4,1,0,5,195,151,4,10,0,2,7,174,
20221008,284,585,남양양,하조대,244,5,2,1,4,12,268,324,4,4,0,1,15,348,
20221008,284,701,남양양,북양양,280,5,2,0,1,8,296,310,2,2,2,1,7,324,
20221008,284,702,남양양,속초,396,4,3,2,2,18,425,414,4,4,3,4,11,440,
20221008,285,253,서평택,서서울,1334,20,33,75,168,81,1711,1453,11,29,46,91,75,1705,
20221008,285,254,서평택,군자,105,1,4,10,10,4,134,154,6,4,10,14,7,195,
20221008,285,257,서평택,홍성,909,1,3,0,3,42,958,134,2,3,2,3,3,147,
20221008,285,281,서평택,매송,145,6,10,2,4,11,178,184,1,13,3,5,12,218,
20221008,285,282,서평택,비봉,169,4,8,10,13,15,219,207,5,7,10,9,10,248,
20221008,285,283,서평택,발안,225,8,9,5,5,14,266,220,7,4,8,12,11,262,
20221008,285,287,서평택,송악,1079,21,19,14,219,54,1406,640,20,15,7,171,34,887,
20221008,285,288,서평택,당진,541,9,8,3,25,24,610,203,8,9,6,38,13,277,
20221008,285,298,서평택,서산,2442,13,15,23,26,95,2614,275,10,11,14,14,18,342,
20221008,285,520,서평택,평택,300,14,17,14,55,17,417,428,6,13,11,27,30,515,
20221008,285,540,서평택,청북,204,3,18,17,18,12,272,204,7,10,12,16,15,264,
20221008,285,541,서평택,송탄,58,4,5,11,23,9,110,63,6,4,8,35,3,119,
20221008,285,741,서평택,평택고덕,157,2,3,0,17,15,194,129,1,5,3,21,13,172,
20221008,286,138,통도사휴게소,양산,284,5,1,0,0,14,304,239,5,0,0,0,13,257,
20221008,286,140,통도사휴게소,부산,1124,3,3,0,0,27,1157,1042,4,4,0,0,34,1084,
20221008,286,250,통도사휴게소,남양산,286,3,0,0,0,12,301,325,6,0,0,0,25,356,
20221008,286,251,통도사휴게소,물금,97,0,0,0,0,8,105,87,7,0,0,0,9,103,
20221008,286,252,통도사휴게소,대동,466,7,0,0,0,23,496,510,6,2,0,0,24,542,
20221008,286,529,통도사휴게소,노포,129,1,31,0,0,5,166,80,0,30,0,0,4,114,
20221008,287,253,송악,서서울,3048,24,27,48,223,132,3502,1972,17,14,26,93,88,2210,
20221008,287,254,송악,군자,310,2,2,3,40,14,371,160,1,1,9,25,3,199,
20221008,287,281,송악,매송,347,6,11,2,6,19,391,232,3,10,3,5,11,264,
20221008,287,282,송악,비봉,679,3,7,11,21,48,769,403,5,4,5,18,20,455,
20221008,287,283,송악,발안,467,9,8,13,31,21,549,257,6,3,1,15,14,296,
20221008,287,285,송악,서평택,640,20,15,7,171,34,887,1079,21,19,14,219,54,1406,
20221008,287,288,송악,당진,614,9,10,4,19,37,693,547,12,10,5,3,33,610,
20221008,287,298,송악,서산,824,2,8,11,39,24,908,284,4,10,10,26,20,354,
20221008,287,520,송악,평택,809,4,11,9,64,39,936,653,5,10,3,46,21,738,
20221008,287,540,송악,청북,454,4,8,7,51,18,542,191,4,4,10,41,7,257,
20221008,287,732,송악,행담도,380,7,4,2,1,27,421,319,5,3,1,0,22,350,
20221008,287,741,송악,평택고덕,258,2,6,0,47,23,336,117,0,0,2,18,15,152,
20221008,288,234,당진,서천,272,1,1,5,30,7,316,90,1,1,1,17,1,111,
20221008,288,253,당진,서서울,1981,9,33,19,36,86,2164,1438,5,22,12,17,66,1560,
20221008,288,254,당진,군자,191,1,6,3,3,9,213,97,2,8,1,2,7,117,
20221008,288,257,당진,홍성,1004,1,3,3,2,24,1037,452,3,5,4,3,25,492,
20221008,288,258,당진,광천,303,4,7,6,30,5,355,252,3,6,6,32,9,308,
20221008,288,259,당진,대천,991,2,15,7,3,22,1040,373,2,12,2,3,16,408,
20221008,288,281,당진,매송,173,0,1,0,1,6,181,118,2,1,0,2,10,133,
20221008,288,282,당진,비봉,322,4,2,2,5,16,351,227,4,0,1,2,9,243,
20221008,288,283,당진,발안,275,3,6,5,13,15,317,121,0,1,3,6,8,139,
20221008,288,285,당진,서평택,203,8,9,6,38,13,277,541,9,8,3,25,24,610,
20221008,288,287,당진,송악,547,12,10,5,3,33,610,614,9,10,4,19,37,693,
20221008,288,298,당진,서산,2102,24,20,8,27,81,2262,636,8,22,15,20,25,726,
20221008,288,299,당진,해미,465,2,13,2,26,19,527,294,3,8,0,11,7,323,
20221008,288,511,당진,무창포,214,5,3,2,2,3,229,91,4,2,0,1,4,102,
20221008,288,520,당진,평택,421,6,39,7,5,20,498,327,4,24,2,2,13,372,
20221008,288,540,당진,청북,143,3,4,4,26,15,195,124,2,3,4,7,9,149,
20221008,288,573,당진,예산수덕사,112,1,2,4,6,5,130,121,3,1,2,11,6,144,
20221008,288,732,당진,행담도,179,2,0,1,0,13,195,188,4,1,0,0,9,202,
20221008,289,135,마산,경주,462,2,9,1,2,17,493,339,0,9,1,3,19,371,
20221008,289,138,마산,양산,161,10,10,4,10,7,202,216,20,11,14,11,9,281,
20221008,289,139,마산,서울산,158,1,0,2,3,5,169,239,2,5,0,2,5,253,
20221008,289,140,마산,부산,1404,14,9,3,4,54,1488,1692,7,12,4,5,52,1772,
20221008,289,146,마산,동창원,2417,55,38,15,37,178,2740,2682,51,41,20,41,205,3040,
20221008,289,147,마산,진례,759,47,31,26,59,51,973,678,38,35,23,55,46,875,
20221008,289,148,마산,서김해,1859,22,48,5,11,100,2045,1958,13,46,3,5,97,2122,
20221008,289,149,마산,동김해,1093,14,27,13,8,57,1212,1046,18,32,14,5,61,1176,
20221008,289,150,마산,북부산,4986,23,98,13,28,204,5352,5155,22,109,6,12,187,5491,
20221008,289,244,마산,서부산,5093,39,306,17,32,222,5709,5973,29,303,16,39,238,6598,
20221008,289,245,마산,장유,1893,16,39,26,10,118,2102,1853,14,36,9,9,105,2026,
20221008,289,250,마산,남양산,683,16,33,1,10,20,763,764,12,28,3,6,29,842,
20221008,289,251,마산,물금,615,29,12,11,6,33,706,773,31,9,19,4,30,866,
20221008,289,529,마산,노포,83,1,27,0,0,3,114,232,0,28,0,0,11,271,
20221008,289,641,마산,울산,586,3,25,2,4,23,643,859,3,28,3,2,31,926,
20221008,289,752,마산,기장철마,352,2,3,1,5,10,373,483,3,0,3,3,25,517,
20221008,289,753,마산,금정,370,3,16,4,9,21,423,307,1,17,5,8,15,353,
20221008,289,755,마산,광재,444,18,23,13,26,22,546,460,22,17,23,23,21,566,
20221008,289,757,마산,진영,619,12,32,24,107,39,833,772,23,22,21,64,40,942,
20221008,290,291,축동,사천,108,5,2,20,8,3,146,142,3,1,7,6,9,168,
20221008,290,292,축동,진주,219,3,1,91,19,14,347,265,9,3,69,7,18,371,
20221008,291,101,사천,서울,72,1,22,3,1,2,101,201,1,30,2,2,3,239,
20221008,291,140,사천,부산,100,0,1,0,0,4,105,116,0,1,2,0,4,123,
20221008,291,142,사천,군북,163,13,14,4,5,10,209,166,5,11,5,16,4,207,
20221008,291,144,사천,함안,217,4,6,5,6,11,249,295,5,6,6,7,10,329,
20221008,291,145,사천,산인,2331,44,45,13,17,94,2544,3059,27,49,12,22,114,3283,
20221008,291,148,사천,서김해,108,2,1,0,1,6,118,124,1,0,0,0,6,131,
20221008,291,150,사천,북부산,421,2,4,0,8,13,448,456,2,2,0,1,16,477,
20221008,291,221,사천,생초,127,6,5,1,5,5,149,121,7,4,1,3,5,141,
20221008,291,222,사천,산청,228,2,3,1,3,17,254,204,3,1,3,6,11,228,
20221008,291,223,사천,단성,334,0,8,7,2,20,371,330,2,4,2,2,20,360,
20221008,291,224,사천,함양,99,1,2,0,2,5,109,102,0,1,0,0,4,107,
20221008,291,225,사천,서진주,833,18,14,7,22,57,951,933,21,16,10,27,48,1055,
20221008,291,244,사천,서부산,423,5,8,2,8,22,468,555,2,8,3,12,23,603,
20221008,291,245,사천,장유,124,1,3,2,2,7,139,124,0,3,3,1,4,135,
20221008,291,272,사천,광양,364,10,13,3,26,11,427,281,7,10,5,16,9,328,
20221008,291,275,사천,옥곡,157,10,3,3,22,8,203,189,8,3,4,17,10,231,
20221008,291,277,사천,하동,259,7,1,3,27,17,314,284,6,3,2,20,12,327,
20221008,291,278,사천,진교,475,7,6,2,0,33,523,446,6,5,1,6,30,494,
20221008,291,279,사천,곤양,299,6,5,3,3,11,327,338,8,3,5,8,19,381,
20221008,291,280,사천,거창,93,2,4,1,0,1,101,109,1,3,1,2,2,118,
20221008,291,290,사천,축동,142,3,1,7,6,9,168,108,5,2,20,8,3,146,
20221008,291,292,사천,진주,2132,51,52,35,22,162,2454,2858,66,65,54,36,209,3288,
20221008,291,293,사천,문산,426,4,6,6,3,32,477,717,5,9,3,1,40,775,
20221008,291,294,사천,북창원,231,7,5,1,5,11,260,549,5,4,3,5,23,589,
20221008,291,295,사천,진성,131,2,1,9,15,6,164,222,5,5,4,26,8,270,
20221008,291,513,사천,고성,99,5,2,1,1,9,117,104,3,2,0,1,4,114,
20221008,291,515,사천,북통영,103,8,2,1,2,6,122,121,10,1,0,2,6,140,
20221008,291,516,사천,통영,453,33,7,3,7,33,536,450,19,9,3,12,24,517,
20221008,291,519,사천,남대구,291,4,10,2,2,15,324,533,3,10,2,2,12,562,
20221008,292,101,진주,서울,45,0,51,0,3,3,102,60,1,53,0,1,2,117,
20221008,292,142,진주,군북,146,3,5,2,6,5,167,156,7,6,2,18,3,192,
20221008,292,144,진주,함안,271,4,2,3,11,20,311,293,8,2,4,7,20,334,
20221008,292,145,진주,산인,2225,20,150,10,19,85,2509,1979,20,143,3,16,108,2269,
20221008,292,148,진주,서김해,91,0,2,0,1,6,100,91,1,1,1,2,8,104,
20221008,292,150,진주,북부산,363,3,5,4,2,15,392,220,2,11,1,0,8,242,
20221008,292,222,진주,산청,108,1,0,0,1,5,115,102,2,1,0,0,7,112,
20221008,292,223,진주,단성,170,2,2,1,2,5,182,88,3,2,2,5,4,104,
20221008,292,244,진주,서부산,393,2,16,4,3,15,433,309,1,13,4,4,21,352,
20221008,292,261,진주,동광주,92,0,9,2,1,7,111,88,1,9,2,0,2,102,
20221008,292,271,진주,순천,95,0,1,0,1,4,101,97,2,0,1,0,2,102,
20221008,292,272,진주,광양,355,7,9,0,13,17,401,264,2,4,3,7,5,285,
20221008,292,275,진주,옥곡,160,8,2,1,18,4,193,183,6,3,1,15,10,218,
20221008,292,277,진주,하동,351,4,3,9,38,14,419,355,4,3,1,33,12,408,
20221008,292,278,진주,진교,851,9,41,9,2,38,950,794,7,38,8,4,46,897,
20221008,292,279,진주,곤양,492,6,14,3,0,20,535,516,5,19,4,2,26,572,
20221008,292,290,진주,축동,265,9,3,69,7,18,371,219,3,1,91,19,14,347,
20221008,292,291,진주,사천,2858,66,65,54,36,209,3288,2132,51,52,35,22,162,2454,
20221008,292,294,진주,북창원,221,3,1,0,1,11,237,343,7,3,2,2,15,372,
20221008,292,296,진주,지수,169,3,2,0,6,12,192,150,2,3,0,9,8,172,
20221008,292,513,진주,고성,445,8,24,3,2,34,516,484,10,26,3,2,31,556,
20221008,292,514,진주,동고성,88,2,4,0,3,5,102,90,1,2,0,2,8,103,
20221008,292,515,진주,북통영,389,9,4,1,2,31,436,431,10,7,0,2,34,484,
20221008,292,516,진주,통영,1026,8,27,5,4,51,1121,948,20,22,4,6,83,1083,
20221008,293,142,문산,군북,160,4,3,2,3,9,181,179,8,7,2,3,8,207,
20221008,293,144,문산,함안,230,3,2,3,2,11,251,274,8,1,4,6,20,313,
20221008,293,145,문산,산인,1601,23,16,5,11,81,1737,1741,18,20,10,9,73,1871,
20221008,293,150,문산,북부산,281,1,1,0,1,16,300,246,2,2,2,0,11,263,
20221008,293,244,문산,서부산,274,2,6,2,2,9,295,307,4,4,1,3,14,333,
20221008,293,278,문산,진교,166,0,2,0,0,7,175,122,0,0,0,2,5,129,
20221008,293,291,문산,사천,717,5,9,3,1,40,775,426,4,6,6,3,32,477,
20221008,293,294,문산,북창원,165,3,5,1,1,12,187,296,6,2,3,1,15,323,
20221008,293,296,문산,지수,151,1,1,1,3,14,171,168,0,0,0,7,15,190,
20221008,293,516,문산,통영,213,1,2,1,0,20,237,143,3,3,1,1,5,156,
20221008,294,142,북창원,군북,594,8,4,2,12,31,651,264,7,3,2,6,18,300,
20221008,294,144,북창원,함안,338,9,13,4,2,23,389,225,8,9,3,6,24,275,
20221008,294,146,북창원,동창원,155,1,4,0,3,13,176,97,3,3,1,2,4,110,
20221008,294,147,북창원,진례,126,1,4,3,0,13,147,94,3,2,1,2,11,113,
20221008,294,148,북창원,서김해,246,4,0,1,7,24,282,219,0,3,0,3,23,248,
20221008,294,149,북창원,동김해,122,0,1,1,1,12,137,105,0,0,0,1,10,116,
20221008,294,150,북창원,북부산,468,5,2,1,4,11,491,355,0,1,0,3,12,371,
20221008,294,238,북창원,칠서,203,6,11,3,85,8,316,72,2,5,3,74,5,161,
20221008,294,244,북창원,서부산,491,7,7,2,6,30,543,473,1,4,1,6,29,514,
20221008,294,245,북창원,장유,368,4,4,0,0,35,411,229,0,1,1,0,23,254,
20221008,294,291,북창원,사천,549,5,4,3,5,23,589,231,7,5,1,5,11,260,
20221008,294,292,북창원,진주,343,7,3,2,2,15,372,221,3,1,0,1,11,237,
20221008,294,293,북창원,문산,296,6,2,3,1,15,323,165,3,5,1,1,12,187,
20221008,294,295,북창원,진성,208,2,2,1,5,12,230,130,2,0,3,4,4,143,
20221008,294,519,북창원,남대구,231,1,3,1,0,17,253,125,0,2,2,0,10,139,
20221008,295,142,진성,군북,117,1,4,2,3,6,133,118,0,6,1,17,5,147,
20221008,295,144,진성,함안,187,9,4,3,2,18,223,192,5,9,7,6,11,230,
20221008,295,145,진성,산인,1135,11,15,6,9,42,1218,1290,13,10,5,9,59,1386,
20221008,295,150,진성,북부산,167,1,0,0,2,3,173,167,0,1,0,0,8,176,
20221008,295,244,진성,서부산,151,0,1,0,1,6,159,207,0,1,1,6,5,220,
20221008,295,272,진성,광양,276,3,5,1,9,7,301,149,0,5,4,3,0,161,
20221008,295,277,진성,하동,103,2,2,6,35,8,156,77,0,1,0,28,4,110,
20221008,295,291,진성,사천,222,5,5,4,26,8,270,131,2,1,9,15,6,164,
20221008,295,294,진성,북창원,130,2,0,3,4,4,143,208,2,2,1,5,12,230,
20221008,295,296,진성,지수,90,1,6,1,7,5,110,86,3,3,2,3,6,103,
20221008,296,145,지수,산인,175,6,3,3,5,7,199,296,3,6,3,5,11,324,
20221008,296,292,지수,진주,150,2,3,0,9,8,172,169,3,2,0,6,12,192,
20221008,296,293,지수,문산,168,0,0,0,7,15,190,151,1,1,1,3,14,171,
20221008,296,295,지수,진성,86,3,3,2,3,6,103,90,1,6,1,7,5,110,
20221008,297,113,동충주,신탄진,144,2,4,0,1,11,162,174,1,2,7,4,4,192,
20221008,297,115,동충주,대전,106,0,3,0,2,5,116,153,0,8,0,0,5,166,
20221008,297,128,동충주,금왕꽃동네,667,4,11,7,17,13,719,865,2,14,11,51,24,967,
20221008,297,136,동충주,음성,418,6,12,4,51,14,505,481,7,13,13,88,21,623,
20221008,297,190,동충주,동서울,133,3,0,0,0,5,141,95,0,1,1,1,4,102,
20221008,297,198,동충주,서청주,202,3,13,3,12,11,244,323,1,12,2,5,7,350,
20221008,297,199,동충주,오창,260,0,3,2,11,1,277,238,1,5,5,9,4,262,
20221008,297,211,동충주,풍기,570,2,3,6,9,9,599,225,1,4,1,26,8,265,
20221008,297,522,동충주,북단양,612,6,4,16,70,17,725,377,4,2,0,81,11,475,
20221008,297,523,동충주,남제천,446,6,9,7,12,11,491,363,5,4,7,23,17,419,
20221008,297,542,동충주,서안성,162,0,1,7,20,4,194,166,0,2,3,13,6,190,
20221008,297,543,동충주,남안성,788,7,12,17,80,26,930,389,6,5,29,63,19,511,
20221008,297,555,동충주,북진천,287,0,6,9,30,8,340,268,1,4,6,20,7,306,
20221008,297,561,동충주,북충주,83,3,2,3,64,3,158,100,1,0,3,58,4,166,
20221008,298,115,서산,대전,236,2,24,1,0,13,276,233,0,21,0,1,7,262,
20221008,298,151,서산,북대전,170,0,2,4,7,3,186,200,1,4,3,6,9,223,
20221008,298,152,서산,유성,364,2,2,4,2,19,393,401,2,0,1,0,17,421,
20221008,298,153,서산,서대전,123,1,1,1,1,5,132,165,0,1,0,1,6,173,
20221008,298,167,서산,광주,139,1,0,2,4,3,149,95,3,2,4,2,0,106,
20221008,298,227,서산,군산,171,2,4,2,13,2,194,88,2,1,1,10,3,105,
20221008,298,228,서산,동군산,166,0,2,1,15,3,187,103,4,2,3,15,5,132,
20221008,298,234,서산,서천,251,1,2,0,29,7,290,166,1,0,4,30,6,207,
20221008,298,253,서산,서서울,3500,17,32,18,26,145,3738,3627,21,32,21,8,139,3848,
20221008,298,254,서산,군자,335,0,6,2,3,16,362,293,0,10,2,5,11,321,
20221008,298,257,서산,홍성,298,4,5,3,13,16,339,258,3,11,4,25,8,309,
20221008,298,258,서산,광천,285,5,4,6,47,9,356,246,1,5,4,48,9,313,
20221008,298,259,서산,대천,416,1,0,1,7,19,444,285,1,2,3,11,8,310,
20221008,298,281,서산,매송,291,4,2,2,0,16,315,264,4,2,1,1,10,282,
20221008,298,282,서산,비봉,610,1,2,6,5,21,645,646,7,2,2,2,19,678,
20221008,298,283,서산,발안,419,5,8,4,4,13,453,337,3,6,3,9,16,374,
20221008,298,285,서산,서평택,275,10,11,14,14,18,342,2442,13,15,23,26,95,2614,
20221008,298,287,서산,송악,284,4,10,10,26,20,354,824,2,8,11,39,24,908,
20221008,298,288,서산,당진,636,8,22,15,20,25,726,2102,24,20,8,27,81,2262,
20221008,298,299,서산,해미,583,7,12,3,10,25,640,498,7,11,4,52,17,589,
20221008,298,520,서산,평택,740,5,53,2,10,22,832,1014,9,40,5,2,40,1110,
20221008,298,540,서산,청북,312,3,8,4,27,12,366,352,2,3,4,14,9,384,
20221008,298,542,서산,서안성,165,4,4,0,4,3,180,99,3,1,0,1,2,106,
20221008,298,571,서산,면천,262,4,10,3,5,11,295,626,3,11,3,9,21,673,
20221008,298,573,서산,예산수덕사,187,3,4,5,49,12,260,177,2,7,3,9,8,206,
20221008,298,577,서산,공주,324,3,5,6,3,13,354,246,1,6,1,10,10,274,
20221008,298,578,서산,서세종,520,5,1,1,10,31,568,666,9,1,7,5,29,717,
20221008,298,579,서산,남세종,262,0,0,0,1,14,277,353,0,1,0,1,7,362,
20221008,298,732,서산,행담도,100,1,0,3,1,2,107,119,1,0,1,0,0,121,
20221008,298,741,서산,평택고덕,136,1,2,3,1,7,150,91,1,0,0,1,8,101,
20221008,299,167,해미,광주,113,0,6,0,0,3,122,136,0,5,0,1,4,146,
20221008,299,227,해미,군산,180,2,3,2,2,9,198,143,0,4,2,5,1,155,
20221008,299,228,해미,동군산,217,2,2,2,5,6,234,234,1,4,2,4,8,253,
20221008,299,234,해미,서천,199,2,1,1,1,4,208,170,2,3,1,5,3,184,
20221008,299,253,해미,서서울,400,3,7,7,13,17,447,347,1,4,7,6,17,382,
20221008,299,257,해미,홍성,125,0,1,1,3,2,132,136,3,0,0,4,3,146,
20221008,299,258,해미,광천,200,1,0,3,2,10,216,224,1,2,0,2,8,237,
20221008,299,259,해미,대천,433,5,6,0,1,17,462,256,6,9,1,0,16,288,
20221008,299,288,해미,당진,294,3,8,0,11,7,323,465,2,13,2,26,19,527,
20221008,299,298,해미,서산,498,7,11,4,52,17,589,583,7,12,3,10,25,640,
20221008,299,520,해미,평택,86,0,10,1,2,6,105,90,0,4,2,2,10,108,
20221008,500,101,남여주,서울,252,1,5,2,2,4,266,241,1,1,1,0,1,245,
20221008,500,102,남여주,동수원,275,2,5,0,0,5,287,158,1,8,0,4,3,174,
20221008,500,173,남여주,양지,252,5,14,18,42,10,341,252,4,22,21,34,7,340,
20221008,500,175,남여주,덕평,143,4,8,22,4,1,182,68,4,4,19,3,3,101,
20221008,500,176,남여주,이천,218,1,7,5,1,14,246,219,3,15,7,3,12,259,
20221008,500,190,남여주,동서울,689,2,2,8,2,16,719,460,1,12,6,0,12,491,
20221008,500,517,남여주,양평,409,4,2,7,29,13,464,545,7,13,13,48,21,647,
20221008,500,597,남여주,서여주,406,2,1,3,6,8,426,468,1,8,6,2,16,501,
20221008,500,598,남여주,북여주,348,9,5,4,8,13,387,409,6,6,2,7,14,444,
20221008,500,735,남여주,남양평,166,1,0,0,0,6,173,206,1,0,0,0,7,214,
20221008,501,167,서김제,광주,154,1,1,0,3,6,165,182,5,4,5,2,2,200,
20221008,501,504,서김제,선운산,128,2,1,4,0,4,139,147,3,6,3,3,5,167,
20221008,501,505,서김제,고창,112,3,7,4,1,4,131,156,2,3,2,0,6,169,
20221008,501,509,서김제,목포,141,3,4,4,6,5,163,229,3,10,3,4,6,255,
20221008,502,167,부안,광주,599,10,6,4,1,16,636,813,8,3,6,1,18,849,
20221008,502,228,부안,동군산,188,4,8,2,8,5,215,156,4,1,1,7,7,176,
20221008,502,253,부안,서서울,206,1,3,1,1,10,222,422,3,1,0,1,9,436,
20221008,502,504,부안,선운산,174,1,4,4,66,5,254,187,2,6,2,64,5,266,
20221008,502,505,부안,고창,192,5,4,4,0,6,211,203,8,11,2,2,8,234,
20221008,502,506,부안,영광,94,3,11,16,1,1,126,80,2,28,11,5,3,129,
20221008,502,509,부안,목포,212,1,14,11,8,11,257,199,4,29,7,7,2,248,
20221008,502,569,부안,북광주,107,0,1,0,1,4,113,158,0,4,3,1,4,170,
20221008,503,167,줄포,광주,452,5,5,2,3,13,480,670,3,2,2,1,16,694,
20221008,503,228,줄포,동군산,101,2,1,1,0,2,107,104,3,5,1,1,3,117,
20221008,503,509,줄포,목포,111,2,7,0,1,1,122,142,1,4,1,0,2,150,
20221008,503,569,줄포,북광주,117,0,1,0,0,3,121,145,2,0,0,0,1,148,
20221008,504,167,선운산,광주,445,6,3,0,10,16,480,609,7,1,1,17,18,653,
20221008,504,228,선운산,동군산,272,1,13,2,4,10,302,340,0,7,7,6,14,374,
20221008,504,501,선운산,서김제,147,3,6,3,3,5,167,128,2,1,4,0,4,139,
20221008,504,502,선운산,부안,187,2,6,2,64,5,266,174,1,4,4,66,5,254,
20221008,504,506,선운산,영광,226,1,5,14,5,5,256,297,2,10,7,5,10,331,
20221008,504,508,선운산,무안,137,0,6,7,5,4,159,95,1,4,3,2,4,109,
20221008,504,509,선운산,목포,466,6,36,47,32,11,598,886,6,24,26,31,24,997,
20221008,504,569,선운산,북광주,134,1,1,2,2,2,142,140,0,1,1,0,1,143,
20221008,505,167,고창,광주,654,9,5,4,2,19,693,825,5,10,8,2,20,870,
20221008,505,228,고창,동군산,240,1,8,1,0,14,264,290,5,6,3,1,8,313,
20221008,505,501,고창,서김제,156,2,3,2,0,6,169,112,3,7,4,1,4,131,
20221008,505,502,고창,부안,203,8,11,2,2,8,234,192,5,4,4,0,6,211,
20221008,505,509,고창,목포,207,3,8,3,23,3,247,256,2,10,0,22,4,294,
20221008,505,569,고창,북광주,169,2,1,1,1,6,180,239,1,1,1,1,7,250,
20221008,506,228,영광,동군산,123,1,10,2,12,2,150,146,1,9,2,18,6,182,
20221008,506,253,영광,서서울,94,1,1,3,1,5,105,232,2,0,1,1,6,242,
20221008,506,502,영광,부안,80,2,28,11,5,3,129,94,3,11,16,1,1,126,
20221008,506,504,영광,선운산,297,2,10,7,5,10,331,226,1,5,14,5,5,256,
20221008,506,509,영광,목포,209,5,5,2,8,7,236,361,7,8,4,2,12,394,
20221008,506,569,영광,북광주,133,1,0,0,0,1,135,98,0,2,2,2,2,106,
20221008,507,508,함평,무안,109,1,7,3,33,2,155,112,2,1,1,0,1,117,
20221008,507,509,함평,목포,453,4,20,7,72,13,569,900,9,21,17,121,32,1100,
20221008,508,504,무안,선운산,95,1,4,3,2,4,109,137,0,6,7,5,4,159,
20221008,508,507,무안,함평,112,2,1,1,0,1,117,109,1,7,3,33,2,155,
20221008,508,509,무안,목포,971,26,27,18,29,43,1114,1397,29,30,12,43,51,1562,
20221008,508,553,무안,동광산,1598,16,27,16,14,58,1729,2671,27,30,13,32,91,2864,
20221008,509,227,목포,군산,101,1,3,5,3,3,116,108,1,1,4,1,1,116,
20221008,509,228,목포,동군산,377,2,9,5,15,9,417,447,0,4,9,28,12,500,
20221008,509,253,목포,서서울,553,9,4,18,7,16,607,1143,5,5,3,2,18,1176,
20221008,509,501,목포,서김제,229,3,10,3,4,6,255,141,3,4,4,6,5,163,
20221008,509,502,목포,부안,199,4,29,7,7,2,248,212,1,14,11,8,11,257,
20221008,509,503,목포,줄포,142,1,4,1,0,2,150,111,2,7,0,1,1,122,
20221008,509,504,목포,선운산,886,6,24,26,31,24,997,466,6,36,47,32,11,598,
20221008,509,505,목포,고창,256,2,10,0,22,4,294,207,3,8,3,23,3,247,
20221008,509,506,목포,영광,361,7,8,4,2,12,394,209,5,5,2,8,7,236,
20221008,509,507,목포,함평,900,9,21,17,121,32,1100,453,4,20,7,72,13,569,
20221008,509,508,목포,무안,1397,29,30,12,43,51,1562,971,26,27,18,29,43,1114,
20221008,509,548,목포,북무안,475,10,7,7,14,10,523,287,9,3,5,10,2,316,
20221008,509,549,목포,동함평,350,4,12,5,92,7,470,260,6,4,6,76,5,357,
20221008,509,550,목포,문평,147,3,6,3,20,8,187,99,3,2,2,16,7,129,
20221008,509,552,목포,서광산,491,20,21,12,21,11,576,395,17,20,13,14,11,470,
20221008,509,553,목포,동광산,10943,154,205,72,206,357,11937,10018,138,189,121,189,315,10970,
20221008,509,578,목포,서세종,116,0,1,2,2,3,124,186,0,3,3,7,9,208,
20221008,509,613,목포,남풍세,95,0,2,2,1,1,101,248,1,1,6,1,8,265,
20221008,510,174,양양,춘천,342,1,11,0,0,15,369,606,3,14,1,1,30,655,
20221008,510,189,양양,강릉,163,4,4,0,3,9,183,227,6,2,0,0,9,244,
20221008,510,284,양양,남양양,151,4,10,0,2,7,174,182,3,4,1,0,5,195,
20221008,510,554,양양,동홍천,613,5,12,5,1,20,656,1505,8,24,11,6,43,1597,
20221008,510,580,양양,북강릉,214,5,1,0,0,6,226,265,4,2,2,0,14,287,
20221008,510,701,양양,북양양,639,2,54,0,0,14,709,271,1,4,0,0,6,282,
20221008,510,702,양양,속초,756,6,13,2,1,18,796,488,4,6,0,0,15,513,
20221008,510,766,양양,인제,148,3,5,0,1,5,162,167,2,1,0,0,6,176,
20221008,511,167,무창포,광주,143,0,1,2,1,4,151,270,2,5,0,0,7,284,
20221008,511,227,무창포,군산,544,4,9,3,7,14,581,500,5,5,2,7,20,539,
20221008,511,228,무창포,동군산,502,3,24,1,20,6,556,1020,8,30,3,18,17,1096,
20221008,511,234,무창포,서천,583,10,20,5,48,18,684,663,3,18,1,54,21,760,
20221008,511,253,무창포,서서울,203,1,0,0,0,5,209,350,1,3,0,0,10,364,
20221008,511,260,무창포,춘장대,123,1,3,0,0,5,132,269,0,1,0,5,8,283,
20221008,511,288,무창포,당진,91,4,2,0,1,4,102,214,5,3,2,2,3,229,
20221008,512,513,연화산,고성,168,5,0,3,3,8,187,185,2,1,2,4,12,206,
20221008,512,516,연화산,통영,203,3,3,0,2,8,219,218,3,1,1,4,11,238,
20221008,513,225,고성,서진주,269,4,1,0,2,19,295,246,2,4,1,3,18,274,
20221008,513,272,고성,광양,110,0,4,3,7,3,127,89,0,2,7,2,1,101,
20221008,513,291,고성,사천,104,3,2,0,1,4,114,99,5,2,1,1,9,117,
20221008,513,292,고성,진주,484,10,26,3,2,31,556,445,8,24,3,2,34,516,
20221008,513,512,고성,연화산,185,2,1,2,4,12,206,168,5,0,3,3,8,187,
20221008,513,514,고성,동고성,288,6,9,12,16,21,352,305,9,2,12,24,18,370,
20221008,513,515,고성,북통영,2656,24,63,11,19,162,2935,2550,18,71,8,15,156,2818,
20221008,513,516,고성,통영,6127,47,84,34,78,327,6697,4925,54,76,33,77,323,5488,
20221008,514,292,동고성,진주,90,1,2,0,2,8,103,88,2,4,0,3,5,102,
20221008,514,513,동고성,고성,305,9,2,12,24,18,370,288,6,9,12,16,21,352,
20221008,514,515,동고성,북통영,115,3,4,0,4,12,138,140,5,5,0,5,16,171,
20221008,514,516,동고성,통영,1283,14,22,19,31,120,1489,1254,7,30,23,38,130,1482,
20221008,515,225,북통영,서진주,268,2,1,1,1,19,292,259,2,1,0,0,15,277,
20221008,515,272,북통영,광양,111,0,7,2,1,4,125,106,2,1,0,1,8,118,
20221008,515,291,북통영,사천,121,10,1,0,2,6,140,103,8,2,1,2,6,122,
20221008,515,292,북통영,진주,431,10,7,0,2,34,484,389,9,4,1,2,31,436,
20221008,515,513,북통영,고성,2550,18,71,8,15,156,2818,2656,24,63,11,19,162,2935,
20221008,515,514,북통영,동고성,140,5,5,0,5,16,171,115,3,4,0,4,12,138,
20221008,516,101,통영,서울,133,0,31,0,0,7,171,309,3,49,0,0,10,371,
20221008,516,190,통영,동서울,131,0,5,0,0,7,143,340,0,5,0,0,8,353,
20221008,516,222,통영,산청,187,3,2,0,0,11,203,140,0,1,0,0,7,148,
20221008,516,223,통영,단성,276,1,2,2,1,10,292,155,0,6,1,0,9,171,
20221008,516,225,통영,서진주,701,11,3,2,4,47,768,712,7,4,2,5,51,781,
20221008,516,261,통영,동광주,186,1,4,0,0,4,195,429,2,6,0,0,5,442,
20221008,516,272,통영,광양,381,1,10,4,4,22,422,474,2,15,4,5,22,522,
20221008,516,275,통영,옥곡,120,0,4,0,6,4,134,214,0,7,5,10,12,248,
20221008,516,277,통영,하동,181,0,5,4,8,8,206,211,0,4,0,16,4,235,
20221008,516,278,통영,진교,135,1,1,0,0,11,148,125,1,1,0,0,9,136,
20221008,516,291,통영,사천,450,19,9,3,12,24,517,453,33,7,3,7,33,536,
20221008,516,292,통영,진주,948,20,22,4,6,83,1083,1026,8,27,5,4,51,1121,
20221008,516,293,통영,문산,143,3,3,1,1,5,156,213,1,2,1,0,20,237,
20221008,516,512,통영,연화산,218,3,1,1,4,11,238,203,3,3,0,2,8,219,
20221008,516,513,통영,고성,4925,54,76,33,77,323,5488,6127,47,84,34,78,327,6697,
20221008,516,514,통영,동고성,1254,7,30,23,38,130,1482,1283,14,22,19,31,120,1489,
20221008,516,544,통영,완주,126,0,8,0,0,6,140,271,0,7,2,1,10,291,
20221008,516,545,통영,소양,128,1,3,0,0,6,138,208,0,2,0,0,4,214,
20221008,517,177,양평,여주,180,1,1,5,4,9,200,114,2,2,2,3,1,124,
20221008,517,500,양평,남여주,545,7,13,13,48,21,647,409,4,2,7,29,13,464,
20221008,517,560,양평,감곡,265,2,3,9,14,9,302,308,4,3,2,33,8,358,
20221008,517,561,양평,북충주,151,2,3,0,3,12,171,152,2,0,0,0,1,155,
20221008,517,562,양평,충주,117,2,4,0,11,7,141,112,0,0,0,1,6,119,
20221008,517,597,양평,서여주,922,15,25,32,13,49,1056,1095,24,28,25,15,56,1243,
20221008,517,598,양평,북여주,3423,18,12,17,32,107,3609,2199,17,8,14,18,62,2318,
20221008,517,735,양평,남양평,258,1,1,0,0,8,268,554,2,0,0,0,24,580,
20221008,518,125,칠곡물류,남구미,46,4,18,43,9,6,126,55,7,8,26,6,6,108,
20221008,518,127,칠곡물류,서대구,411,58,50,75,30,29,653,438,66,59,76,20,28,687,
20221008,518,129,칠곡물류,북대구,305,32,33,12,8,24,414,398,43,32,19,13,31,536,
20221008,518,131,칠곡물류,경산,106,32,19,32,15,3,207,118,34,28,22,9,3,214,
20221008,518,230,칠곡물류,팔공산,81,9,14,23,3,6,136,70,17,14,17,0,2,120,
20221008,518,621,칠곡물류,동대구,79,15,9,12,9,4,128,76,15,15,9,1,1,117,
20221008,518,772,칠곡물류,북달성,122,10,18,36,6,6,198,110,7,22,37,7,5,188,
20221008,518,774,칠곡물류,남칠곡,116,13,27,20,5,14,195,100,15,25,14,7,9,170,
20221008,519,224,남대구,함양,217,3,4,0,0,6,230,181,2,3,1,0,4,191,
20221008,519,231,남대구,화원옥포,5662,88,69,24,156,397,6396,5512,92,65,36,224,389,6318,
20221008,519,232,남대구,달성,2061,49,54,23,7,151,2345,2006,53,62,24,21,134,2300,
20221008,519,233,남대구,현풍,3687,66,81,45,87,247,4213,3943,93,100,41,91,251,4519,
20221008,519,235,남대구,창녕,840,4,25,4,1,27,901,780,10,27,3,4,35,859,
20221008,519,236,남대구,영산,421,10,2,5,24,25,487,467,10,10,5,20,14,526,
20221008,519,237,남대구,남지,197,4,11,10,23,9,254,175,7,11,15,16,5,229,
20221008,519,238,남대구,칠서,103,1,0,1,5,6,116,100,0,3,3,6,7,119,
20221008,519,239,남대구,칠원,2850,22,75,35,21,101,3104,2359,22,80,18,43,106,2628,
20221008,519,241,남대구,동고령,3510,52,55,23,51,163,3854,3127,46,70,31,56,170,3500,
20221008,519,242,남대구,고령,3279,13,39,13,106,131,3581,2646,16,42,11,115,133,2963,
20221008,519,243,남대구,해인사,1098,4,5,0,1,47,1155,892,4,5,1,0,35,937,
20221008,519,247,남대구,남원,229,1,6,3,0,5,244,168,1,5,0,0,6,180,
20221008,519,261,남대구,동광주,596,5,67,16,0,21,705,610,8,62,9,3,17,709,
20221008,519,272,남대구,광양,189,2,11,5,0,5,212,120,0,6,3,1,2,132,
20221008,519,274,남대구,가조,486,2,4,0,0,16,508,407,0,4,0,0,16,427,
20221008,519,275,남대구,옥곡,94,2,4,0,2,4,106,123,1,4,1,9,4,142,
20221008,519,280,남대구,거창,1979,15,39,5,9,107,2154,1689,10,41,5,7,79,1831,
20221008,519,291,남대구,사천,533,3,10,2,2,12,562,291,4,10,2,2,15,324,
20221008,519,294,남대구,북창원,125,0,2,2,0,10,139,231,1,3,1,0,17,253,
20221008,519,538,남대구,성주,422,0,1,1,0,6,430,192,1,1,0,1,9,204,
20221008,519,539,남대구,남성주,244,1,5,3,64,18,335,175,5,1,3,48,12,244,
20221008,519,544,남대구,완주,277,6,7,5,16,6,317,238,5,7,3,6,7,266,
20221008,519,545,남대구,소양,327,1,25,2,0,3,358,246,3,23,1,1,4,278,
20221008,519,569,남대구,북광주,141,2,8,9,3,6,169,154,4,12,10,1,6,187,
20221008,519,730,남대구,유천,2213,19,9,1,8,122,2372,2527,30,4,0,0,165,2726,
20221008,519,731,남대구,북현풍,1638,16,16,0,0,92,1762,1514,11,2,0,0,90,1617,
20221008,520,107,평택,안성,420,8,4,5,1,21,459,288,7,0,2,0,14,311,
20221008,520,108,평택,천안,418,4,4,0,0,16,442,173,2,0,0,1,6,182,
20221008,520,136,평택,음성,332,1,0,1,1,8,343,171,1,1,0,0,4,177,
20221008,520,253,평택,서서울,2923,30,41,58,44,117,3213,3159,25,40,55,57,117,3453,
20221008,520,254,평택,군자,457,6,8,7,16,20,514,639,8,8,9,28,28,720,
20221008,520,255,평택,서안산,94,1,3,1,0,4,103,169,2,0,1,1,4,177,
20221008,520,257,평택,홍성,503,4,5,1,0,16,529,373,2,6,2,0,17,400,
20221008,520,258,평택,광천,211,6,8,2,0,9,236,171,3,4,6,2,8,194,
20221008,520,259,평택,대천,511,4,17,2,0,18,552,286,3,11,2,0,10,312,
20221008,520,281,평택,매송,264,2,2,4,4,8,284,297,5,3,5,9,12,331,
20221008,520,282,평택,비봉,150,1,6,5,10,10,182,357,2,4,2,2,9,376,
20221008,520,283,평택,발안,134,1,1,2,13,6,157,171,2,1,4,9,2,189,
20221008,520,285,평택,서평택,428,6,13,11,27,30,515,300,14,17,14,55,17,417,
20221008,520,287,평택,송악,653,5,10,3,46,21,738,809,4,11,9,64,39,936,
20221008,520,288,평택,당진,327,4,24,2,2,13,372,421,6,39,7,5,20,498,
20221008,520,298,평택,서산,1014,9,40,5,2,40,1110,740,5,53,2,10,22,832,
20221008,520,299,평택,해미,90,0,4,2,2,10,108,86,0,10,1,2,6,105,
20221008,520,540,평택,청북,1667,30,70,34,31,68,1900,2062,28,63,83,42,61,2339,
20221008,520,541,평택,송탄,361,7,9,7,11,14,409,330,15,13,11,15,12,396,
20221008,520,542,평택,서안성,219,9,6,7,4,8,253,183,5,13,5,11,6,223,
20221008,520,543,평택,남안성,359,18,11,8,9,20,425,368,15,9,13,8,16,429,
20221008,520,555,평택,북진천,192,7,4,3,3,8,217,193,5,5,2,4,4,213,
20221008,520,572,평택,고덕,97,2,7,0,0,9,115,116,0,12,4,0,5,137,
20221008,520,685,평택,서시흥,3507,51,99,99,136,136,4028,87,2,2,2,2,5,100,
20221008,520,741,평택,평택고덕,1145,12,47,7,6,69,1286,1008,15,63,8,9,78,1181,
20221008,520,742,평택,남사진위,108,2,5,1,3,6,125,191,4,6,12,3,8,224,
20221008,521,208,단양,서안동,143,1,0,1,24,1,170,140,1,3,3,16,5,168,
20221008,521,210,단양,영주,120,2,1,2,17,2,144,124,1,1,1,15,2,144,
20221008,521,211,단양,풍기,784,5,8,0,19,33,849,743,4,7,4,9,36,803,
20221008,522,128,북단양,금왕꽃동네,117,1,0,1,12,4,135,280,1,0,5,13,13,312,
20221008,522,136,북단양,음성,92,0,1,2,16,1,112,144,0,3,6,27,5,185,
20221008,522,190,북단양,동서울,82,0,4,0,27,3,116,223,1,2,11,9,3,249,
20221008,522,211,북단양,풍기,286,5,3,2,18,11,325,207,2,3,3,12,11,238,
20221008,522,218,북단양,남원주,236,1,3,1,25,8,274,215,4,1,2,23,8,253,
20221008,522,219,북단양,신림,125,2,2,0,5,2,136,144,0,2,2,10,5,163,
20221008,522,240,북단양,제천,132,2,1,4,14,6,159,167,6,5,7,42,2,229,
20221008,522,297,북단양,동충주,377,4,2,0,81,11,475,612,6,4,16,70,17,725,
20221008,522,543,북단양,남안성,147,1,3,5,79,3,238,219,3,1,17,49,10,299,
20221008,523,128,남제천,금왕꽃동네,196,1,4,4,19,2,226,436,2,5,10,26,6,485,
20221008,523,136,남제천,음성,160,5,8,2,78,6,259,248,2,4,7,32,7,300,
20221008,523,198,남제천,서청주,106,1,3,3,10,9,132,162,0,3,0,6,8,179,
20221008,523,199,남제천,오창,111,1,2,0,11,5,130,135,1,1,5,4,2,148,
20221008,523,208,남제천,서안동,102,1,3,0,5,8,119,152,0,2,0,3,10,167,
20221008,523,211,남제천,풍기,312,3,2,2,1,12,332,380,6,0,5,7,20,418,
20221008,523,218,남제천,남원주,132,3,2,0,1,4,142,141,1,0,0,0,6,148,
20221008,523,240,남제천,제천,210,1,2,0,1,7,221,323,2,7,0,6,7,345,
20221008,523,297,남제천,동충주,363,5,4,7,23,17,419,446,6,9,7,12,11,491,
20221008,523,542,남제천,서안성,143,1,2,6,18,4,174,255,1,2,2,18,7,285,
20221008,523,543,남제천,남안성,378,1,2,9,98,7,495,462,2,2,16,38,12,532,
20221008,523,555,남제천,북진천,128,3,2,0,35,4,172,133,0,1,7,11,4,156,
20221008,524,126,청통와촌,왜관,87,13,14,11,5,5,135,86,13,13,15,10,5,142,
20221008,524,127,청통와촌,서대구,507,23,21,8,14,18,591,754,35,19,12,28,36,884,
20221008,524,129,청통와촌,북대구,1158,50,21,14,35,44,1322,943,19,20,4,24,32,1042,
20221008,524,230,청통와촌,팔공산,934,23,21,9,11,50,1048,1210,25,27,9,13,59,1343,
20221008,524,525,청통와촌,북영천,196,2,6,3,5,8,220,199,3,3,1,8,6,220,
20221008,524,527,청통와촌,포항,1147,37,19,5,31,46,1285,1059,24,12,9,33,45,1182,
20221008,524,621,청통와촌,동대구,279,7,5,0,16,10,317,281,8,4,1,29,7,330,
20221008,524,730,청통와촌,유천,125,6,0,0,0,5,136,93,6,0,0,0,4,103,
20221008,525,127,북영천,서대구,365,4,4,4,2,13,392,693,11,6,1,4,21,736,
20221008,525,129,북영천,북대구,957,9,10,9,12,41,1038,854,10,8,2,5,33,912,
20221008,525,230,북영천,팔공산,775,6,3,3,13,30,830,1017,6,5,2,5,36,1071,
20221008,525,524,북영천,청통와촌,199,3,3,1,8,6,220,196,2,6,3,5,8,220,
20221008,525,527,북영천,포항,477,9,6,1,77,16,586,541,10,8,10,62,23,654,
20221008,525,621,북영천,동대구,230,1,4,0,5,4,244,267,3,3,0,4,5,282,
20221008,526,129,서포항,북대구,149,3,3,1,2,7,165,186,1,2,0,1,6,196,
20221008,526,230,서포항,팔공산,118,1,2,1,0,2,124,218,1,1,2,1,9,232,
20221008,526,527,서포항,포항,1096,3,13,2,16,62,1192,1625,8,11,1,6,84,1735,
20221008,527,115,포항,대전,94,2,4,0,1,0,101,144,4,6,1,1,4,160,
20221008,527,123,포항,구미,274,2,2,1,0,9,288,304,1,2,0,3,10,320,
20221008,527,125,포항,남구미,207,1,4,1,8,10,231,282,1,2,0,3,13,301,
20221008,527,126,포항,왜관,276,10,7,3,15,9,320,255,26,12,7,13,13,326,
20221008,527,127,포항,서대구,1280,16,22,9,22,51,1400,2063,24,33,10,33,87,2250,
20221008,527,129,포항,북대구,3157,32,28,14,60,138,3429,2777,14,13,20,32,112,2968,
20221008,527,130,포항,동김천,99,2,0,1,28,6,136,110,3,2,0,1,5,121,
20221008,527,201,포항,칠곡,157,0,1,0,6,2,166,287,4,1,0,5,10,307,
20221008,527,230,포항,팔공산,2396,21,17,2,40,90,2566,3015,21,18,9,23,116,3202,
20221008,527,231,포항,화원옥포,198,2,5,5,8,14,232,176,2,4,2,5,15,204,
20221008,527,233,포항,현풍,88,2,4,4,10,4,112,123,0,2,1,18,7,151,
20221008,527,242,포항,고령,204,0,1,0,7,2,214,135,0,1,0,4,6,146,
20221008,527,261,포항,동광주,164,1,6,2,4,3,180,197,1,5,0,1,5,209,
20221008,527,524,포항,청통와촌,1059,24,12,9,33,45,1182,1147,37,19,5,31,46,1285,
20221008,527,525,포항,북영천,541,10,8,10,62,23,654,477,9,6,1,77,16,586,
20221008,527,526,포항,서포항,1625,8,11,1,6,84,1735,1096,3,13,2,16,62,1192,
20221008,527,621,포항,동대구,905,12,62,4,6,29,1018,1199,9,62,1,1,39,1311,
20221008,527,730,포항,유천,307,4,1,0,1,8,321,304,0,0,0,0,5,309,
20221008,527,772,포항,북달성,135,1,12,1,4,4,157,237,1,9,0,2,4,253,
20221008,528,101,기흥동탄,서울,6675,39,537,100,10,255,7616,7118,45,540,108,15,307,8133,
20221008,528,102,기흥동탄,동수원,121,0,9,0,0,11,141,301,1,14,0,1,22,339,
20221008,528,103,기흥동탄,수원신갈,1625,7,11,1,1,68,1713,1503,9,20,5,1,58,1596,
20221008,528,106,기흥동탄,오산,555,24,22,8,10,38,657,534,16,11,7,5,45,618,
20221008,528,107,기흥동탄,안성,630,10,8,3,2,43,696,728,5,6,3,5,39,786,
20221008,528,108,기흥동탄,천안,691,9,27,9,10,34,780,667,3,17,2,14,46,749,
20221008,528,111,기흥동탄,청주,113,0,1,0,1,4,119,163,0,3,2,2,6,176,
20221008,528,136,기흥동탄,음성,187,1,0,0,7,3,198,106,1,0,0,2,4,113,
20221008,528,171,기흥동탄,마성,318,0,2,0,1,16,337,403,0,1,0,0,19,423,
20221008,528,212,기흥동탄,북수원,421,0,8,0,1,25,455,623,4,5,3,2,30,667,
20221008,528,214,기흥동탄,동군포,160,0,2,0,0,11,173,144,3,0,1,0,4,152,
20221008,528,229,기흥동탄,북천안,207,4,1,2,9,7,230,113,3,0,1,4,6,127,
20221008,528,253,기흥동탄,서서울,731,3,18,3,6,39,800,797,4,10,4,5,47,867,
20221008,528,254,기흥동탄,군자,550,5,6,4,3,34,602,727,13,4,4,6,37,791,
20221008,528,255,기흥동탄,서안산,116,2,0,2,7,8,135,141,1,2,2,7,6,159,
20221008,528,541,기흥동탄,송탄,172,2,18,10,9,9,220,79,6,13,6,16,5,125,
20221008,528,542,기흥동탄,서안성,243,7,16,5,6,7,284,466,13,9,6,3,20,517,
20221008,528,543,기흥동탄,남안성,196,9,12,8,2,5,232,252,19,18,9,8,9,315,
20221008,528,555,기흥동탄,북진천,153,4,2,0,2,4,165,194,4,1,0,0,6,205,
20221008,528,671,기흥동탄,봉담,149,6,1,3,7,18,184,85,1,3,1,4,10,104,
20221008,528,673,기흥동탄,북오산,214,8,1,0,0,8,231,144,5,1,0,1,9,160,
20221008,528,677,기흥동탄,북평택,345,1,5,10,38,10,409,186,0,0,11,28,2,227,
20221008,528,741,기흥동탄,평택고덕,241,0,75,0,0,6,322,222,0,71,0,0,6,299,
20221008,529,135,노포,경주,143,0,54,0,0,8,205,160,1,63,0,0,13,237,
20221008,529,138,노포,양산,266,9,5,1,4,21,306,327,16,7,5,3,30,388,
20221008,529,139,노포,서울산,176,6,1,0,0,11,194,201,3,3,0,1,11,219,
20221008,529,148,노포,서김해,300,6,11,8,5,25,355,169,0,4,2,3,15,193,
20221008,529,149,노포,동김해,282,4,3,1,0,20,310,159,1,0,0,4,8,172,
20221008,529,245,노포,장유,340,2,3,5,4,15,369,192,2,3,6,5,14,222,
20221008,529,250,노포,남양산,257,3,3,4,1,21,289,249,15,3,2,2,17,288,
20221008,529,252,노포,대동,1073,15,17,13,25,67,1210,237,5,5,2,4,18,271,
20221008,529,286,노포,통도사휴게소,80,0,30,0,0,4,114,129,1,31,0,0,5,166,
20221008,529,289,노포,마산,232,0,28,0,0,11,271,83,1,27,0,0,3,114,
20221008,530,159,내장산,서전주,144,2,1,1,2,4,154,141,0,2,0,2,5,150,
20221008,530,167,내장산,광주,714,15,11,16,4,32,792,863,17,13,22,6,27,948,
20221008,530,569,내장산,북광주,99,1,0,1,0,1,102,131,1,0,1,0,2,135,
20221008,531,111,문의청남대,청주,98,0,1,0,1,7,107,104,0,3,3,1,2,113,
20221008,531,112,문의청남대,남청주,124,2,2,2,11,1,142,169,3,1,1,4,2,180,
20221008,531,127,문의청남대,서대구,169,1,0,3,1,4,178,100,0,0,0,0,3,103,
20221008,531,129,문의청남대,북대구,117,2,0,1,0,6,126,101,1,1,0,0,6,109,
20221008,531,198,문의청남대,서청주,122,0,1,0,2,1,126,112,0,0,2,0,6,120,
20221008,531,207,문의청남대,남안동,162,0,2,3,7,5,179,124,2,2,1,7,5,141,
20221008,531,532,문의청남대,회인,455,4,0,0,2,21,482,403,4,0,2,1,13,423,
20221008,531,533,문의청남대,보은,907,6,8,3,12,44,980,656,9,9,3,7,40,724,
20221008,531,534,문의청남대,속리산,409,7,5,3,1,17,442,293,3,6,1,0,13,316,
20221008,531,535,문의청남대,화서,179,0,0,0,0,7,186,96,1,0,3,3,7,110,
20221008,531,536,문의청남대,남상주,360,1,9,9,8,18,405,312,3,6,3,7,11,342,
20221008,531,749,문의청남대,영덕,425,2,1,4,0,6,438,157,0,1,0,1,4,163,
20221008,532,531,회인,문의청남대,403,4,0,2,1,13,423,455,4,0,0,2,21,482,
20221008,533,111,보은,청주,140,1,5,0,7,7,160,190,1,6,3,5,6,211,
20221008,533,112,보은,남청주,233,5,0,4,6,10,258,273,8,2,3,2,9,297,
20221008,533,190,보은,동서울,125,2,1,0,2,5,135,198,2,0,0,0,4,204,
20221008,533,198,보은,서청주,178,4,6,4,7,2,201,171,2,2,2,10,4,191,
20221008,533,531,보은,문의청남대,656,9,9,3,7,40,724,907,6,8,3,12,44,980,
20221008,533,534,보은,속리산,105,3,2,2,3,3,118,102,2,2,0,1,2,109,
20221008,533,536,보은,남상주,204,2,5,5,7,10,233,192,0,6,3,1,6,208,
20221008,534,112,속리산,남청주,109,1,2,2,1,2,117,108,1,3,0,1,3,116,
20221008,534,531,속리산,문의청남대,293,3,6,1,0,13,316,409,7,5,3,1,17,442,
20221008,534,533,속리산,보은,102,2,2,0,1,2,109,105,3,2,2,3,3,118,
20221008,534,536,속리산,남상주,120,2,1,2,10,4,139,150,1,1,1,12,7,172,
20221008,535,531,화서,문의청남대,96,1,0,3,3,7,110,179,0,0,0,0,7,186,
20221008,535,536,화서,남상주,222,4,13,8,4,15,266,282,7,12,6,5,22,334,
20221008,536,111,남상주,청주,95,4,1,1,2,2,105,99,1,2,3,2,5,112,
20221008,536,112,남상주,남청주,96,1,2,1,2,4,106,115,1,3,4,1,4,128,
20221008,536,129,남상주,북대구,95,0,16,0,0,4,115,81,0,14,0,0,8,103,
20221008,536,207,남상주,남안동,103,2,4,2,2,5,118,107,0,4,0,2,4,117,
20221008,536,531,남상주,문의청남대,312,3,6,3,7,11,342,360,1,9,9,8,18,405,
20221008,536,533,남상주,보은,192,0,6,3,1,6,208,204,2,5,5,7,10,233,
20221008,536,534,남상주,속리산,150,1,1,1,12,7,172,120,2,1,2,10,4,139,
20221008,536,535,남상주,화서,282,7,12,6,5,22,334,222,4,13,8,4,15,266,
20221008,537,233,남김천,현풍,183,6,12,8,11,6,226,222,6,12,6,14,11,271,
20221008,537,239,남김천,칠원,315,7,3,3,6,7,341,383,3,3,3,20,8,420,
20221008,537,241,남김천,동고령,89,2,5,3,4,5,108,73,6,9,2,9,5,104,
20221008,537,242,남김천,고령,118,1,3,2,4,2,130,107,0,0,0,3,2,112,
20221008,537,538,남김천,성주,241,5,10,4,10,13,283,222,7,13,2,9,11,264,
20221008,538,231,성주,화원옥포,87,3,4,1,2,6,103,142,1,2,1,0,5,151,
20221008,538,233,성주,현풍,184,6,10,7,15,16,238,240,7,16,5,15,13,296,
20221008,538,239,성주,칠원,134,3,1,1,5,6,150,161,0,2,1,4,1,169,
20221008,538,241,성주,동고령,80,4,7,6,1,5,103,80,4,10,5,1,4,104,
20221008,538,519,성주,남대구,192,1,1,0,1,9,204,422,0,1,1,0,6,430,
20221008,538,537,성주,남김천,222,7,13,2,9,11,264,241,5,10,4,10,13,283,
20221008,539,233,남성주,현풍,186,9,8,9,6,7,225,238,8,11,8,19,10,294,
20221008,539,519,남성주,남대구,175,5,1,3,48,12,244,244,1,5,3,64,18,335,
20221008,540,107,청북,안성,577,18,7,5,8,44,659,495,8,2,1,4,33,543,
20221008,540,108,청북,천안,316,5,1,2,3,9,336,221,1,0,2,1,12,237,
20221008,540,136,청북,음성,289,1,4,5,6,14,319,183,1,3,1,3,2,193,
20221008,540,253,청북,서서울,871,32,23,49,53,53,1081,1536,16,15,32,29,58,1686,
20221008,540,254,청북,군자,81,2,4,6,3,4,100,245,4,4,5,10,16,284,
20221008,540,257,청북,홍성,166,0,4,1,2,4,177,157,1,3,1,2,6,170,
20221008,540,259,청북,대천,133,0,0,1,0,4,138,122,0,1,2,0,6,131,
20221008,540,281,청북,매송,107,2,1,0,2,5,117,155,4,3,0,1,6,169,
20221008,540,285,청북,서평택,204,7,10,12,16,15,264,204,3,18,17,18,12,272,
20221008,540,287,청북,송악,191,4,4,10,41,7,257,454,4,8,7,51,18,542,
20221008,540,288,청북,당진,124,2,3,4,7,9,149,143,3,4,4,26,15,195,
20221008,540,298,청북,서산,352,2,3,4,14,9,384,312,3,8,4,27,12,366,
20221008,540,520,청북,평택,2062,28,63,83,42,61,2339,1667,30,70,34,31,68,1900,
20221008,540,541,청북,송탄,375,8,18,15,11,15,442,332,7,13,12,9,15,388,
20221008,540,542,청북,서안성,360,12,19,30,12,11,444,267,7,20,31,36,6,367,
20221008,540,543,청북,남안성,514,18,17,26,17,26,618,537,19,23,23,23,29,654,
20221008,540,555,청북,북진천,225,6,9,14,6,4,264,266,10,10,7,12,12,317,
20221008,540,741,청북,평택고덕,883,20,21,32,84,68,1108,1010,15,23,32,91,71,1242,
20221008,541,101,송탄,서울,638,20,17,28,12,39,754,894,14,11,21,7,47,994,
20221008,541,103,송탄,수원신갈,100,6,5,5,2,6,124,162,4,3,4,2,4,179,
20221008,541,107,송탄,안성,827,25,8,6,4,64,934,617,16,4,8,9,59,713,
20221008,541,108,송탄,천안,815,29,21,1,10,40,916,666,27,18,7,8,42,768,
20221008,541,111,송탄,청주,93,2,7,4,3,14,123,129,4,8,3,6,10,160,
20221008,541,136,송탄,음성,212,2,5,3,1,12,235,117,2,5,3,2,5,134,
20221008,541,229,송탄,북천안,370,16,12,12,11,25,446,104,12,10,11,12,8,157,
20221008,541,253,송탄,서서울,374,10,13,16,4,13,430,245,6,6,11,5,14,287,
20221008,541,285,송탄,서평택,63,6,4,8,35,3,119,58,4,5,11,23,9,110,
20221008,541,520,송탄,평택,330,15,13,11,15,12,396,361,7,9,7,11,14,409,
20221008,541,528,송탄,기흥동탄,79,6,13,6,16,5,125,172,2,18,10,9,9,220,
20221008,541,540,송탄,청북,332,7,13,12,9,15,388,375,8,18,15,11,15,442,
20221008,541,542,송탄,서안성,208,2,9,12,7,12,250,111,4,1,4,3,4,127,
20221008,541,543,송탄,남안성,615,25,8,19,24,36,727,564,29,16,18,18,47,692,
20221008,541,555,송탄,북진천,190,10,17,11,8,11,247,241,14,20,14,14,12,315,
20221008,541,741,송탄,평택고덕,85,2,4,5,8,3,107,104,2,2,0,5,10,123,
20221008,541,742,송탄,남사진위,122,3,4,10,2,9,150,387,12,5,10,7,20,441,
20221008,542,101,서안성,서울,2379,37,66,131,28,116,2757,976,21,59,61,14,45,1176,
20221008,542,103,서안성,수원신갈,366,1,11,14,2,16,410,154,1,8,6,0,5,174,
20221008,542,106,서안성,오산,300,6,18,34,6,21,385,243,8,17,21,10,17,316,
20221008,542,107,서안성,안성,363,10,5,8,0,21,407,394,6,6,3,1,19,429,
20221008,542,108,서안성,천안,862,19,47,28,13,31,1000,869,6,36,24,16,44,995,
20221008,542,128,서안성,금왕꽃동네,157,5,6,8,18,8,202,212,5,6,17,13,13,266,
20221008,542,136,서안성,음성,730,4,7,15,18,24,798,431,2,5,5,5,16,464,
20221008,542,188,서안성,서충주,159,1,6,9,12,11,198,217,3,6,4,22,11,263,
20221008,542,212,서안성,북수원,101,0,6,5,3,5,120,75,2,7,17,1,1,103,
20221008,542,229,서안성,북천안,360,2,13,11,5,12,403,89,1,6,3,9,2,110,
20221008,542,253,서안성,서서울,163,6,19,37,10,5,240,98,3,16,16,5,3,141,
20221008,542,297,서안성,동충주,166,0,2,3,13,6,190,162,0,1,7,20,4,194,
20221008,542,298,서안성,서산,99,3,1,0,1,2,106,165,4,4,0,4,3,180,
20221008,542,520,서안성,평택,183,5,13,5,11,6,223,219,9,6,7,4,8,253,
20221008,542,523,서안성,남제천,255,1,2,2,18,7,285,143,1,2,6,18,4,174,
20221008,542,528,서안성,기흥동탄,466,13,9,6,3,20,517,243,7,16,5,6,7,284,
20221008,542,540,서안성,청북,267,7,20,31,36,6,367,360,12,19,30,12,11,444,
20221008,542,541,서안성,송탄,111,4,1,4,3,4,127,208,2,9,12,7,12,250,
20221008,542,543,서안성,남안성,1053,17,42,59,71,65,1307,931,22,42,75,69,64,1203,
20221008,542,555,서안성,북진천,537,15,30,18,36,31,667,583,14,24,37,33,22,713,
20221008,542,601,서안성,남천안,261,3,17,12,2,9,304,118,3,7,10,7,3,148,
20221008,542,671,서안성,봉담,130,2,6,9,2,6,155,85,2,6,10,2,5,110,
20221008,542,673,서안성,북오산,378,9,4,6,2,32,431,160,6,2,7,0,13,188,
20221008,542,742,서안성,남사진위,497,10,8,50,7,30,602,392,6,13,41,6,20,478,
20221008,543,101,남안성,서울,1153,76,54,57,24,56,1420,966,48,35,40,20,48,1157,
20221008,543,103,남안성,수원신갈,199,2,8,8,4,9,230,126,9,0,7,2,9,153,
20221008,543,106,남안성,오산,317,18,12,18,35,25,425,400,15,13,12,17,25,482,
20221008,543,128,남안성,금왕꽃동네,272,8,18,25,39,12,374,452,13,24,35,52,25,601,
20221008,543,136,남안성,음성,911,4,26,26,34,18,1019,432,7,28,20,25,14,526,
20221008,543,188,남안성,서충주,389,6,19,23,42,22,501,548,9,25,21,28,32,663,
20221008,543,195,남안성,대소,103,7,9,27,37,7,190,261,16,20,46,50,20,413,
20221008,543,196,남안성,진천,102,1,5,10,3,9,130,78,3,9,8,17,5,120,
20221008,543,211,남안성,풍기,271,0,3,1,7,11,293,151,0,0,3,3,9,166,
20221008,543,212,남안성,북수원,156,2,1,3,1,6,169,138,6,1,2,0,6,153,
20221008,543,253,남안성,서서울,522,16,9,13,9,24,593,381,7,9,17,8,12,434,
20221008,543,254,남안성,군자,88,1,2,8,2,7,108,135,3,2,5,5,3,153,
20221008,543,297,남안성,동충주,389,6,5,29,63,19,511,788,7,12,17,80,26,930,
20221008,543,520,남안성,평택,368,15,9,13,8,16,429,359,18,11,8,9,20,425,
20221008,543,522,남안성,북단양,219,3,1,17,49,10,299,147,1,3,5,79,3,238,
20221008,543,523,남안성,남제천,462,2,2,16,38,12,532,378,1,2,9,98,7,495,
20221008,543,528,남안성,기흥동탄,252,19,18,9,8,9,315,196,9,12,8,2,5,232,
20221008,543,540,남안성,청북,537,19,23,23,23,29,654,514,18,17,26,17,26,618,
20221008,543,541,남안성,송탄,564,29,16,18,18,47,692,615,25,8,19,24,36,727,
20221008,543,542,남안성,서안성,931,22,42,75,69,64,1203,1053,17,42,59,71,65,1307,
20221008,543,555,남안성,북진천,706,37,48,53,83,36,963,737,47,60,55,102,35,1036,
20221008,543,561,남안성,북충주,129,1,0,1,3,5,139,219,0,1,1,5,7,233,
20221008,543,671,남안성,봉담,226,4,12,11,4,21,278,193,5,5,6,2,10,221,
20221008,543,673,남안성,북오산,281,5,7,2,6,18,319,224,12,3,4,1,16,260,
20221008,543,741,남안성,평택고덕,119,4,6,15,11,18,173,133,2,2,4,3,16,160,
20221008,543,742,남안성,남사진위,199,9,15,12,5,8,248,426,7,5,4,4,16,462,
20221008,544,145,완주,산인,373,0,13,6,19,10,421,457,4,13,5,14,11,504,
20221008,544,152,완주,유성,206,1,0,1,0,3,211,282,1,2,0,0,6,291,
20221008,544,153,완주,서대전,161,2,1,0,0,7,171,167,1,2,0,0,3,173,
20221008,544,168,완주,덕유산,143,3,1,0,1,4,152,97,3,0,0,2,2,104,
20221008,544,169,완주,장수,355,2,9,6,15,14,401,285,2,12,7,13,12,331,
20221008,544,244,완주,서부산,116,1,4,4,17,1,143,104,0,5,7,32,5,153,
20221008,544,516,완주,통영,271,0,7,2,1,10,291,126,0,8,0,0,6,140,
20221008,544,519,완주,남대구,238,5,7,3,6,7,266,277,6,7,5,16,6,317,
20221008,544,545,완주,소양,573,10,22,20,21,10,656,433,10,18,13,19,10,503,
20221008,544,546,완주,진안,573,3,13,6,3,16,614,382,3,10,3,6,17,421,
20221008,544,556,완주,동순천,223,0,5,3,35,8,274,196,1,5,4,90,5,301,
20221008,544,587,완주,오수,275,5,7,11,15,8,321,208,5,10,8,20,11,262,
20221008,544,588,완주,임실,265,1,7,1,0,8,282,268,0,1,2,6,6,283,
20221008,544,589,완주,상관,165,1,11,4,5,9,195,179,2,4,3,3,5,196,
20221008,545,145,소양,산인,238,0,31,2,0,3,274,444,1,33,0,2,18,498,
20221008,545,156,소양,익산,135,3,6,1,19,4,168,127,4,6,1,8,1,147,
20221008,545,157,소양,삼례,92,2,4,1,1,3,103,122,2,2,2,8,1,137,
20221008,545,168,소양,덕유산,112,4,0,0,0,4,120,103,1,0,0,0,3,107,
20221008,545,169,소양,장수,690,4,5,1,3,22,725,655,5,3,2,3,22,690,
20221008,545,516,소양,통영,208,0,2,0,0,4,214,128,1,3,0,0,6,138,
20221008,545,519,소양,남대구,246,3,23,1,1,4,278,327,1,25,2,0,3,358,
20221008,545,544,소양,완주,433,10,18,13,19,10,503,573,10,22,20,21,10,656,
20221008,545,546,소양,진안,318,3,30,2,1,14,368,265,1,35,0,2,16,319,
20221008,546,169,진안,장수,122,3,3,0,5,4,137,120,6,0,1,4,4,135,
20221008,546,544,진안,완주,382,3,10,3,6,17,421,573,3,13,6,3,16,614,
20221008,546,545,진안,소양,265,1,35,0,2,16,319,318,3,30,2,1,14,368,
20221008,547,553,무안공항,동광산,818,3,3,2,10,16,852,927,4,2,1,6,21,961,
20221008,548,509,북무안,목포,287,9,3,5,10,2,316,475,10,7,7,14,10,523,
20221008,548,552,북무안,서광산,191,10,11,5,2,3,222,281,11,6,7,1,6,312,
20221008,548,553,북무안,동광산,2219,20,22,13,37,51,2362,3807,24,30,25,39,86,4011,
20221008,549,509,동함평,목포,260,6,4,6,76,5,357,350,4,12,5,92,7,470,
20221008,549,552,동함평,서광산,216,6,4,9,3,10,248,253,8,9,6,1,10,287,
20221008,549,553,동함평,동광산,3503,20,43,12,44,114,3736,3756,30,47,10,41,126,4010,
20221008,550,509,문평,목포,99,3,2,2,16,7,129,147,3,6,3,20,8,187,
20221008,550,553,문평,동광산,713,9,9,9,32,20,792,873,10,13,13,27,27,963,
20221008,551,552,나주,서광산,113,2,6,4,15,8,148,108,1,5,5,7,6,132,
20221008,551,553,나주,동광산,1187,4,13,10,31,46,1291,1367,8,12,10,25,47,1469,
20221008,552,509,서광산,목포,395,17,20,13,14,11,470,491,20,21,12,21,11,576,
20221008,552,548,서광산,북무안,281,11,6,7,1,6,312,191,10,11,5,2,3,222,
20221008,552,549,서광산,동함평,253,8,9,6,1,10,287,216,6,4,9,3,10,248,
20221008,552,551,서광산,나주,108,1,5,5,7,6,132,113,2,6,4,15,8,148,
20221008,552,553,서광산,동광산,4166,117,114,111,201,139,4848,6432,142,134,128,160,173,7169,
20221008,553,508,동광산,무안,2671,27,30,13,32,91,2864,1598,16,27,16,14,58,1729,
20221008,553,509,동광산,목포,10018,138,189,121,189,315,10970,10943,154,205,72,206,357,11937,
20221008,553,547,동광산,무안공항,927,4,2,1,6,21,961,818,3,3,2,10,16,852,
20221008,553,548,동광산,북무안,3807,24,30,25,39,86,4011,2219,20,22,13,37,51,2362,
20221008,553,549,동광산,동함평,3756,30,47,10,41,126,4010,3503,20,43,12,44,114,3736,
20221008,553,550,동광산,문평,873,10,13,13,27,27,963,713,9,9,9,32,20,792,
20221008,553,551,동광산,나주,1367,8,12,10,25,47,1469,1187,4,13,10,31,46,1291,
20221008,553,552,동광산,서광산,6432,142,134,128,160,173,7169,4166,117,114,111,201,139,4848,
20221008,554,174,동홍천,춘천,1328,18,18,3,15,78,1460,1662,19,36,10,9,92,1828,
20221008,554,510,동홍천,양양,1505,8,24,11,6,43,1597,613,5,12,5,1,20,656,
20221008,554,701,동홍천,북양양,1193,1,8,5,19,29,1255,701,4,22,1,21,18,767,
20221008,554,702,동홍천,속초,801,7,5,10,7,19,849,535,8,12,3,8,19,585,
20221008,554,765,동홍천,내촌,245,4,8,3,7,13,280,201,2,8,8,6,13,238,
20221008,554,766,동홍천,인제,409,8,8,7,1,12,445,321,8,12,12,6,20,379,
20221008,555,101,북진천,서울,263,4,9,7,10,12,305,424,3,4,4,9,12,456,
20221008,555,103,북진천,수원신갈,156,1,3,2,0,8,170,129,0,4,2,0,4,139,
20221008,555,106,북진천,오산,203,13,7,5,5,14,247,290,9,8,6,6,17,336,
20221008,555,107,북진천,안성,95,3,2,3,1,4,108,96,3,3,1,0,4,107,
20221008,555,128,북진천,금왕꽃동네,90,3,6,9,12,3,123,81,6,5,4,15,2,113,
20221008,555,136,북진천,음성,322,2,4,10,5,16,359,120,8,9,13,11,6,167,
20221008,555,188,북진천,서충주,120,4,6,5,8,4,147,129,4,9,10,6,3,161,
20221008,555,190,북진천,동서울,666,17,17,12,12,21,745,737,13,13,15,4,23,805,
20221008,555,192,북진천,곤지암,146,4,2,1,0,6,159,126,3,5,1,1,4,140,
20221008,555,253,북진천,서서울,279,6,4,6,10,11,316,241,0,7,6,7,7,268,
20221008,555,297,북진천,동충주,268,1,4,6,20,7,306,287,0,6,9,30,8,340,
20221008,555,520,북진천,평택,193,5,5,2,4,4,213,192,7,4,3,3,8,217,
20221008,555,523,북진천,남제천,133,0,1,7,11,4,156,128,3,2,0,35,4,172,
20221008,555,528,북진천,기흥동탄,194,4,1,0,0,6,205,153,4,2,0,2,4,165,
20221008,555,540,북진천,청북,266,10,10,7,12,12,317,225,6,9,14,6,4,264,
20221008,555,541,북진천,송탄,241,14,20,14,14,12,315,190,10,17,11,8,11,247,
20221008,555,542,북진천,서안성,583,14,24,37,33,22,713,537,15,30,18,36,31,667,
20221008,555,543,북진천,남안성,737,47,60,55,102,35,1036,706,37,48,53,83,36,963,
20221008,555,671,북진천,봉담,128,4,4,1,5,10,152,123,4,2,1,1,5,136,
20221008,555,673,북진천,북오산,187,4,1,3,0,5,200,167,4,1,4,0,6,182,
20221008,555,742,북진천,남사진위,218,11,11,24,15,9,288,255,6,7,20,5,13,306,
20221008,556,145,동순천,산인,222,1,16,0,1,10,250,182,0,9,0,1,5,197,
20221008,556,152,동순천,유성,189,1,4,1,0,1,196,353,1,9,2,0,8,373,
20221008,556,153,동순천,서대전,129,0,2,2,4,5,142,236,0,5,7,5,5,258,
20221008,556,248,동순천,순창,133,0,1,0,1,3,138,140,2,4,1,1,4,152,
20221008,556,277,동순천,하동,151,2,7,2,1,10,173,98,1,0,0,0,5,104,
20221008,556,544,동순천,완주,196,1,5,4,90,5,301,223,0,5,3,35,8,274,
20221008,556,557,동순천,황전,1381,15,13,8,20,50,1487,1126,11,14,6,15,36,1208,
20221008,556,558,동순천,구례화엄사,398,5,7,4,6,12,432,419,7,4,4,23,15,472,
20221008,556,559,동순천,서남원,399,5,11,1,17,20,453,398,3,6,2,27,16,452,
20221008,556,587,동순천,오수,152,1,1,0,11,2,167,310,1,2,2,14,3,332,
20221008,556,588,동순천,임실,154,0,2,0,1,5,162,134,1,2,0,1,1,139,
20221008,556,589,동순천,상관,907,4,16,5,136,14,1082,1266,3,16,14,65,32,1396,
20221008,556,590,동순천,동전주,446,3,1,0,9,12,471,530,2,1,0,7,12,552,
20221008,557,271,황전,순천,408,2,5,0,16,19,450,539,8,4,1,32,28,612,
20221008,557,272,황전,광양,109,0,2,8,26,5,150,115,1,2,7,25,4,154,
20221008,557,273,황전,동광양,153,0,3,1,8,7,172,220,0,4,1,5,9,239,
20221008,557,556,황전,동순천,1126,11,14,6,15,36,1208,1381,15,13,8,20,50,1487,
20221008,558,248,구례화엄사,순창,116,0,1,2,0,2,121,127,3,0,2,0,1,133,
20221008,558,261,구례화엄사,동광주,673,12,10,2,15,15,727,888,5,9,1,10,20,933,
20221008,558,271,구례화엄사,순천,126,2,2,2,1,2,135,162,4,3,1,2,9,181,
20221008,558,556,구례화엄사,동순천,419,7,4,4,23,15,472,398,5,7,4,6,12,432,
20221008,558,559,구례화엄사,서남원,169,0,4,1,3,8,185,197,5,3,3,0,10,218,
20221008,558,569,구례화엄사,북광주,298,8,3,5,8,5,327,335,6,7,3,3,9,363,
20221008,558,589,구례화엄사,상관,219,3,4,0,0,3,229,346,1,4,1,2,5,359,
20221008,558,590,구례화엄사,동전주,96,1,1,0,0,3,101,120,1,3,1,1,4,130,
20221008,559,261,서남원,동광주,186,2,3,4,7,10,212,203,3,6,3,5,7,227,
20221008,559,271,서남원,순천,116,1,3,2,5,3,130,141,1,4,1,6,8,161,
20221008,559,556,서남원,동순천,398,3,6,2,27,16,452,399,5,11,1,17,20,453,
20221008,559,558,서남원,구례화엄사,197,5,3,3,0,10,218,169,0,4,1,3,8,185,
20221008,559,569,서남원,북광주,91,2,2,1,11,2,109,83,3,0,2,15,1,104,
20221008,559,589,서남원,상관,122,0,8,2,22,0,154,186,1,3,7,15,4,216,
20221008,560,101,감곡,서울,289,3,10,6,5,3,316,316,2,4,5,5,10,342,
20221008,560,102,감곡,동수원,223,0,5,2,7,10,247,174,1,7,3,2,4,191,
20221008,560,176,감곡,이천,181,3,5,2,11,5,207,187,2,3,0,5,4,201,
20221008,560,190,감곡,동서울,960,13,12,15,36,27,1063,1003,5,7,18,28,31,1092,
20221008,560,192,감곡,곤지암,172,0,2,1,20,6,201,114,0,4,1,9,2,130,
20221008,560,212,감곡,북수원,201,2,5,0,14,3,225,170,1,4,1,10,7,193,
20221008,560,253,감곡,서서울,251,1,1,2,30,5,290,270,3,0,4,9,5,291,
20221008,560,254,감곡,군자,199,4,3,8,61,5,280,246,2,3,11,28,10,300,
20221008,560,517,감곡,양평,308,4,3,2,33,8,358,265,2,3,9,14,9,302,
20221008,560,561,감곡,북충주,180,0,4,0,0,4,188,95,3,2,1,0,2,103,
20221008,560,597,감곡,서여주,168,2,1,2,32,5,210,128,2,0,5,14,4,153,
20221008,560,598,감곡,북여주,157,0,6,3,1,6,173,146,5,2,0,5,5,163,
20221008,561,101,북충주,서울,259,3,58,5,1,11,337,260,1,11,3,0,10,285,
20221008,561,102,북충주,동수원,157,0,3,0,0,6,166,93,0,4,0,4,4,105,
20221008,561,128,북충주,금왕꽃동네,114,2,1,0,0,3,120,177,3,4,0,2,3,189,
20221008,561,190,북충주,동서울,780,6,45,4,3,32,870,734,4,18,1,0,31,788,
20221008,561,192,북충주,곤지암,102,0,0,0,2,4,108,101,0,0,1,3,3,108,
20221008,561,212,북충주,북수원,116,1,4,3,0,2,126,105,1,3,3,0,3,115,
20221008,561,253,북충주,서서울,189,1,0,1,1,10,202,204,2,1,0,1,7,215,
20221008,561,254,북충주,군자,142,3,10,2,6,6,169,138,1,10,4,3,12,168,
20221008,561,297,북충주,동충주,100,1,0,3,58,4,166,83,3,2,3,64,3,158,
20221008,561,517,북충주,양평,152,2,0,0,0,1,155,151,2,3,0,3,12,171,
20221008,561,543,북충주,남안성,219,0,1,1,5,7,233,129,1,0,1,3,5,139,
20221008,561,560,북충주,감곡,95,3,2,1,0,2,103,180,0,4,0,0,4,188,
20221008,561,597,북충주,서여주,119,0,1,3,5,3,131,89,0,0,1,1,13,104,
20221008,562,101,충주,서울,160,0,8,1,1,3,173,182,2,48,1,1,6,240,
20221008,562,190,충주,동서울,662,8,13,6,3,31,723,532,0,39,6,2,19,598,
20221008,562,253,충주,서서울,167,0,1,2,3,5,178,146,2,0,1,2,11,162,
20221008,562,254,충주,군자,125,2,4,1,3,4,139,129,1,1,1,3,5,140,
20221008,562,517,충주,양평,112,0,0,0,1,6,119,117,2,4,0,11,7,141,
20221008,563,190,괴산,동서울,143,1,0,0,0,8,152,164,2,0,0,1,11,178,
20221008,564,190,연풍,동서울,192,1,5,4,2,5,209,362,0,4,2,2,8,378,
20221008,564,566,연풍,점촌함창,114,1,2,6,29,4,156,127,1,5,1,54,8,196,
20221008,564,570,연풍,북상주,90,0,2,7,7,2,108,117,0,6,6,5,2,136,
20221008,565,127,문경새재,서대구,360,4,3,8,1,10,386,146,3,0,0,0,4,153,
20221008,565,129,문경새재,북대구,304,3,0,4,0,6,317,158,1,0,0,1,8,168,
20221008,565,190,문경새재,동서울,252,2,7,2,5,6,274,427,3,5,4,4,7,450,
20221008,565,239,문경새재,칠원,419,0,6,4,3,9,441,95,0,2,1,2,2,102,
20221008,565,566,문경새재,점촌함창,218,3,20,1,6,9,257,274,5,31,2,1,9,322,
20221008,565,570,문경새재,북상주,328,4,4,4,3,7,350,248,3,3,1,2,6,263,
20221008,566,101,점촌함창,서울,116,1,19,6,2,7,151,128,0,24,0,1,7,160,
20221008,566,127,점촌함창,서대구,139,1,2,0,4,5,151,91,1,3,1,0,4,100,
20221008,566,190,점촌함창,동서울,377,1,30,6,1,13,428,391,2,15,2,0,6,416,
20221008,566,253,점촌함창,서서울,111,0,0,1,3,8,123,116,0,0,0,0,4,120,
20221008,566,564,점촌함창,연풍,127,1,5,1,54,8,196,114,1,2,6,29,4,156,
20221008,566,565,점촌함창,문경새재,274,5,31,2,1,9,322,218,3,20,1,6,9,257,
20221008,567,167,남고창,광주,1723,12,33,7,8,71,1854,1795,18,33,14,10,82,1952,
20221008,567,261,남고창,동광주,137,0,1,0,0,4,142,115,1,0,0,0,1,117,
20221008,567,271,남고창,순천,101,1,1,2,3,1,109,99,2,0,0,4,1,106,
20221008,567,568,남고창,장성물류,173,1,8,0,2,5,189,160,9,6,4,3,9,191,
20221008,567,569,남고창,북광주,437,4,2,4,4,20,471,456,6,5,2,3,24,496,
20221008,568,167,장성물류,광주,138,33,7,4,4,3,189,117,30,3,2,1,4,157,
20221008,568,228,장성물류,동군산,103,4,14,7,23,0,151,109,4,7,6,28,2,156,
20221008,568,567,장성물류,남고창,160,9,6,4,3,9,191,173,1,8,0,2,5,189,
20221008,568,569,장성물류,북광주,102,11,3,2,0,2,120,111,17,1,0,0,2,131,
20221008,569,145,북광주,산인,191,2,6,8,16,4,227,159,1,4,8,8,3,183,
20221008,569,158,북광주,전주,131,1,3,3,1,6,145,115,2,3,3,2,2,127,
20221008,569,159,북광주,서전주,261,4,7,4,2,10,288,237,2,1,8,6,4,258,
20221008,569,163,북광주,정읍,161,2,2,3,1,9,178,153,6,3,0,2,6,170,
20221008,569,165,북광주,백양사,111,2,0,2,3,4,122,94,0,0,3,2,2,101,
20221008,569,228,북광주,동군산,162,0,2,3,5,2,174,161,2,1,1,1,7,173,
20221008,569,247,북광주,남원,303,3,6,4,35,8,359,286,9,2,4,46,7,354,
20221008,569,248,북광주,순창,586,3,5,6,12,26,638,636,8,6,6,10,26,692,
20221008,569,249,북광주,담양,434,9,3,10,7,4,467,454,8,6,12,7,17,504,
20221008,569,263,북광주,옥과,892,6,5,11,12,34,960,770,7,6,13,16,24,836,
20221008,569,265,북광주,곡성,614,2,2,7,13,13,651,477,5,8,9,13,14,526,
20221008,569,266,북광주,석곡,194,2,0,1,2,2,201,160,2,1,1,3,7,174,
20221008,569,267,북광주,주암송광사,126,2,0,1,1,4,134,112,5,2,2,1,4,126,
20221008,569,270,북광주,서순천,344,14,1,3,5,8,375,266,11,6,3,7,7,300,
20221008,569,271,북광주,순천,1342,41,20,23,29,30,1485,1213,45,20,11,70,28,1387,
20221008,569,272,북광주,광양,100,4,2,5,16,2,129,90,3,0,6,20,1,120,
20221008,569,273,북광주,동광양,161,3,1,3,36,3,207,193,7,0,1,22,6,229,
20221008,569,502,북광주,부안,158,0,4,3,1,4,170,107,0,1,0,1,4,113,
20221008,569,503,북광주,줄포,145,2,0,0,0,1,148,117,0,1,0,0,3,121,
20221008,569,504,북광주,선운산,140,0,1,1,0,1,143,134,1,1,2,2,2,142,
20221008,569,505,북광주,고창,239,1,1,1,1,7,250,169,2,1,1,1,6,180,
20221008,569,506,북광주,영광,98,0,2,2,2,2,106,133,1,0,0,0,1,135,
20221008,569,519,북광주,남대구,154,4,12,10,1,6,187,141,2,8,9,3,6,169,
20221008,569,530,북광주,내장산,131,1,0,1,0,2,135,99,1,0,1,0,1,102,
20221008,569,558,북광주,구례화엄사,335,6,7,3,3,9,363,298,8,3,5,8,5,327,
20221008,569,559,북광주,서남원,83,3,0,2,15,1,104,91,2,2,1,11,2,109,
20221008,569,567,북광주,남고창,456,6,5,2,3,24,496,437,4,2,4,4,20,471,
20221008,569,568,북광주,장성물류,111,17,1,0,0,2,131,102,11,3,2,0,2,120,
20221008,569,587,북광주,오수,151,2,0,0,0,2,155,151,3,0,2,0,5,161,
20221008,569,588,북광주,임실,120,0,0,0,0,1,121,113,3,0,0,0,2,118,
20221008,570,127,북상주,서대구,191,3,4,0,4,13,215,227,1,2,0,4,9,243,
20221008,570,129,북상주,북대구,177,1,1,0,1,4,184,225,0,0,0,4,8,237,
20221008,570,190,북상주,동서울,317,7,6,20,5,6,361,284,7,7,15,4,12,329,
20221008,570,564,북상주,연풍,117,0,6,6,5,2,136,90,0,2,7,7,2,108,
20221008,570,565,북상주,문경새재,248,3,3,1,2,6,263,328,4,4,4,3,7,350,
20221008,571,152,면천,유성,156,1,2,0,1,4,164,160,3,2,1,1,8,175,
20221008,571,298,면천,서산,626,3,11,3,9,21,673,262,4,10,3,5,11,295,
20221008,571,572,면천,고덕,200,0,0,1,17,14,232,217,2,2,0,23,11,255,
20221008,571,573,면천,예산수덕사,225,2,4,2,19,9,261,256,3,4,3,16,11,293,
20221008,571,577,면천,공주,215,1,1,1,1,8,227,184,0,0,1,0,7,192,
20221008,571,578,면천,서세종,168,3,2,2,1,9,185,176,0,0,3,2,8,189,
20221008,571,579,면천,남세종,132,1,1,0,1,2,137,146,1,0,1,1,11,160,
20221008,572,152,고덕,유성,103,0,0,1,1,3,108,117,0,0,2,3,5,127,
20221008,572,253,고덕,서서울,633,5,4,13,4,29,688,411,4,3,1,2,14,435,
20221008,572,520,고덕,평택,116,0,12,4,0,5,137,97,2,7,0,0,9,115,
20221008,572,571,고덕,면천,217,2,2,0,23,11,255,200,0,0,1,17,14,232,
20221008,572,573,고덕,예산수덕사,369,2,8,10,5,8,402,218,2,4,6,5,4,239,
20221008,572,578,고덕,서세종,95,1,4,2,4,4,110,104,2,4,1,5,5,121,
20221008,573,115,예산수덕사,대전,426,4,0,1,0,19,450,447,1,3,1,0,25,477,
20221008,573,119,예산수덕사,판암,108,1,2,0,1,1,113,160,1,1,0,0,5,167,
20221008,573,151,예산수덕사,북대전,287,4,3,2,4,13,313,451,5,4,6,5,15,486,
20221008,573,152,예산수덕사,유성,831,8,3,1,3,38,884,876,3,1,1,3,34,918,
20221008,573,153,예산수덕사,서대전,252,1,1,0,0,11,265,393,0,1,4,1,15,414,
20221008,573,154,예산수덕사,안영,126,2,3,1,2,6,140,144,2,0,1,0,5,152,
20221008,573,253,예산수덕사,서서울,741,7,4,7,2,29,790,439,3,2,2,4,8,458,
20221008,573,288,예산수덕사,당진,121,3,1,2,11,6,144,112,1,2,4,6,5,130,
20221008,573,298,예산수덕사,서산,177,2,7,3,9,8,206,187,3,4,5,49,12,260,
20221008,573,571,예산수덕사,면천,256,3,4,3,16,11,293,225,2,4,2,19,9,261,
20221008,573,572,예산수덕사,고덕,218,2,4,6,5,4,239,369,2,8,10,5,8,402,
20221008,573,574,예산수덕사,신양,144,0,4,1,0,2,151,114,4,3,2,0,5,128,
20221008,573,577,예산수덕사,공주,692,17,10,1,9,37,766,685,6,12,5,6,23,737,
20221008,573,578,예산수덕사,서세종,1102,13,12,11,12,35,1185,1588,10,13,12,6,53,1682,
20221008,573,579,예산수덕사,남세종,557,3,1,0,0,21,582,737,2,3,0,3,31,776,
20221008,573,606,예산수덕사,서논산,109,1,0,7,6,2,125,114,1,2,1,1,2,121,
20221008,574,152,신양,유성,137,1,2,0,0,6,146,127,2,2,0,0,5,136,
20221008,574,253,신양,서서울,187,1,1,1,4,6,200,191,0,0,3,0,6,200,
20221008,574,573,신양,예산수덕사,114,4,3,2,0,5,128,144,0,4,1,0,2,151,
20221008,574,578,신양,서세종,105,1,2,0,0,3,111,144,2,2,1,0,8,157,
20221008,575,152,유구,유성,186,4,1,0,1,6,198,165,4,1,0,0,9,179,
20221008,575,227,유구,군산,582,2,3,2,1,26,616,240,0,5,1,0,10,256,
20221008,575,577,유구,공주,268,1,0,0,0,12,281,161,2,3,0,2,10,178,
20221008,575,578,유구,서세종,102,4,2,2,1,6,117,129,5,1,0,2,3,140,
20221008,575,579,유구,남세종,147,0,0,0,1,5,153,138,0,1,0,0,12,151,
20221008,575,593,유구,부여,409,1,2,1,0,6,419,169,0,0,0,0,8,177,
20221008,576,115,마곡사,대전,110,1,1,0,6,6,124,94,1,1,0,2,7,105,
20221008,576,152,마곡사,유성,165,2,1,2,1,6,177,167,0,0,2,2,5,176,
20221008,576,577,마곡사,공주,123,1,2,0,0,4,130,110,0,0,0,0,7,117,
20221008,576,578,마곡사,서세종,188,0,2,0,0,6,196,234,6,0,0,1,9,250,
20221008,576,579,마곡사,남세종,175,1,0,0,0,5,181,175,2,1,0,0,6,184,
20221008,577,115,공주,대전,149,0,1,0,7,7,164,104,0,2,0,10,10,126,
20221008,577,227,공주,군산,95,0,1,0,1,3,100,99,0,2,0,0,1,102,
20221008,577,298,공주,서산,246,1,6,1,10,10,274,324,3,5,6,3,13,354,
20221008,577,571,공주,면천,184,0,0,1,0,7,192,215,1,1,1,1,8,227,
20221008,577,573,공주,예산수덕사,685,6,12,5,6,23,737,692,17,10,1,9,37,766,
20221008,577,575,공주,유구,161,2,3,0,2,10,178,268,1,0,0,0,12,281,
20221008,577,576,공주,마곡사,110,0,0,0,0,7,117,123,1,2,0,0,4,130,
20221008,577,607,공주,연무,184,3,2,4,4,2,199,124,0,3,4,2,2,135,
20221008,577,613,공주,남풍세,229,2,2,1,10,13,257,288,3,6,1,2,12,312,
20221008,578,115,서세종,대전,455,22,10,0,5,25,517,453,21,7,0,5,43,529,
20221008,578,119,서세종,판암,123,1,2,0,1,8,135,182,3,2,0,0,6,193,
20221008,578,151,서세종,북대전,222,9,2,1,1,6,241,446,9,3,3,3,10,474,
20221008,578,152,서세종,유성,483,22,6,0,3,24,538,554,17,1,0,5,13,590,
20221008,578,153,서세종,서대전,217,7,2,0,1,8,235,380,10,2,2,0,21,415,
20221008,578,154,서세종,안영,188,4,1,2,0,11,206,258,13,2,1,1,11,286,
20221008,578,227,서세종,군산,775,8,3,2,4,22,814,491,1,2,2,9,19,524,
20221008,578,234,서세종,서천,101,0,5,0,0,3,109,120,0,5,0,0,2,127,
20221008,578,298,서세종,서산,666,9,1,7,5,29,717,520,5,1,1,10,31,568,
20221008,578,509,서세종,목포,186,0,3,3,7,9,208,116,0,1,2,2,3,124,
20221008,578,571,서세종,면천,176,0,0,3,2,8,189,168,3,2,2,1,9,185,
20221008,578,572,서세종,고덕,104,2,4,1,5,5,121,95,1,4,2,4,4,110,
20221008,578,573,서세종,예산수덕사,1588,10,13,12,6,53,1682,1102,13,12,11,12,35,1185,
20221008,578,574,서세종,신양,144,2,2,1,0,8,157,105,1,2,0,0,3,111,
20221008,578,575,서세종,유구,129,5,1,0,2,3,140,102,4,2,2,1,6,117,
20221008,578,576,서세종,마곡사,234,6,0,0,1,9,250,188,0,2,0,0,6,196,
20221008,578,579,서세종,남세종,379,10,3,1,1,13,407,489,12,2,0,3,20,526,
20221008,578,591,서세종,동서천,313,0,3,6,24,5,351,215,1,1,5,25,1,248,
20221008,578,592,서세종,서부여,386,0,2,5,1,15,409,203,1,2,2,1,1,210,
20221008,578,593,서세종,부여,430,2,3,4,3,8,450,336,2,3,0,2,10,353,
20221008,578,595,서세종,서공주,253,3,5,1,0,5,267,270,1,6,0,2,9,288,
20221008,578,604,서세종,남공주,199,2,1,1,1,8,212,166,4,3,0,2,9,184,
20221008,578,607,서세종,연무,124,1,2,0,0,4,131,139,0,2,0,2,8,151,
20221008,579,114,남세종,남대전,259,4,5,6,6,11,291,263,5,6,15,8,11,308,
20221008,579,115,남세종,대전,849,7,24,2,33,47,962,645,11,12,1,22,38,729,
20221008,579,116,남세종,옥천,391,9,1,2,2,33,438,320,19,3,1,2,26,371,
20221008,579,119,남세종,판암,334,5,1,2,12,16,370,388,7,0,2,7,19,423,
20221008,579,129,남세종,북대구,111,0,0,1,1,2,115,100,0,2,0,0,1,103,
20221008,579,151,남세종,북대전,184,0,3,2,9,11,209,201,2,5,2,10,8,228,
20221008,579,152,남세종,유성,429,7,5,3,4,18,466,192,4,7,2,2,10,217,
20221008,579,153,남세종,서대전,888,13,10,4,9,34,958,1041,14,12,5,7,59,1138,
20221008,579,154,남세종,안영,702,14,6,6,14,26,768,685,14,6,3,10,30,748,
20221008,579,156,남세종,익산,150,2,3,1,3,5,164,132,4,2,5,2,4,149,
20221008,579,158,남세종,전주,243,1,3,1,4,9,261,135,1,3,0,3,7,149,
20221008,579,159,남세종,서전주,119,0,0,0,3,5,127,118,1,1,0,1,2,123,
20221008,579,167,남세종,광주,312,2,1,4,1,6,326,201,3,3,0,0,7,214,
20221008,579,200,남세종,금산,236,1,5,0,0,12,254,164,2,1,0,2,6,175,
20221008,579,204,남세종,추부,204,1,3,1,0,14,223,138,1,1,3,0,9,152,
20221008,579,227,남세종,군산,148,0,1,0,0,4,153,106,0,0,0,4,0,110,
20221008,579,298,남세종,서산,353,0,1,0,1,7,362,262,0,0,0,1,14,277,
20221008,579,571,남세종,면천,146,1,0,1,1,11,160,132,1,1,0,1,2,137,
20221008,579,573,남세종,예산수덕사,737,2,3,0,3,31,776,557,3,1,0,0,21,582,
20221008,579,575,남세종,유구,138,0,1,0,0,12,151,147,0,0,0,1,5,153,
20221008,579,576,남세종,마곡사,175,2,1,0,0,6,184,175,1,0,0,0,5,181,
20221008,579,578,남세종,서세종,489,12,2,0,3,20,526,379,10,3,1,1,13,407,
20221008,579,593,남세종,부여,157,0,0,1,3,5,166,150,0,0,0,2,6,158,
20221008,579,595,남세종,서공주,374,1,1,1,2,8,387,287,1,1,1,3,9,302,
20221008,579,604,남세종,남공주,101,0,1,0,0,6,108,104,0,1,0,1,3,109,
20221008,579,613,남세종,남풍세,235,2,1,1,3,10,252,135,1,3,1,1,4,145,
20221008,580,174,북강릉,춘천,266,1,6,2,1,13,289,410,2,8,1,1,30,452,
20221008,580,180,북강릉,원주,189,4,6,0,1,8,208,340,1,2,1,0,13,357,
20221008,580,184,북강릉,대관령,403,3,7,1,0,10,424,526,3,10,2,2,16,559,
20221008,580,185,북강릉,평창,199,1,3,2,2,8,215,337,5,4,2,8,5,361,
20221008,580,187,북강릉,진부,157,5,4,1,1,3,171,179,2,1,0,1,4,187,
20221008,580,189,북강릉,강릉,178,2,7,0,3,5,195,256,3,2,2,2,8,273,
20221008,580,218,북강릉,남원주,133,1,2,0,1,5,142,135,1,1,1,0,3,141,
20221008,580,510,북강릉,양양,265,4,2,2,0,14,287,214,5,1,0,0,6,226,
20221008,580,581,북강릉,옥계,103,0,2,2,4,4,115,107,1,0,0,5,5,118,
20221008,580,582,북강릉,망상,178,4,5,0,1,10,198,198,6,0,0,1,6,211,
20221008,580,583,북강릉,동해,264,3,4,1,15,11,298,349,4,6,1,28,10,398,
20221008,580,585,북강릉,하조대,512,10,22,1,0,23,568,695,10,24,0,1,27,757,
20221008,580,701,북강릉,북양양,559,8,3,0,0,27,597,535,9,2,0,3,27,576,
20221008,580,702,북강릉,속초,659,15,8,1,7,31,721,671,21,14,1,7,34,748,
20221008,580,703,북강릉,삼척,132,2,1,0,1,7,143,196,5,1,0,4,10,216,
20221008,580,704,북강릉,근덕,176,3,7,3,6,4,199,274,1,6,3,3,8,295,
20221008,581,189,옥계,강릉,214,1,0,0,8,12,235,199,3,0,0,3,11,216,
20221008,581,580,옥계,북강릉,107,1,0,0,5,5,118,103,0,2,2,4,4,115,
20221008,581,582,옥계,망상,183,0,0,1,2,19,205,181,0,7,1,0,15,204,
20221008,581,583,옥계,동해,409,10,4,1,146,21,591,527,6,10,2,106,33,684,
20221008,581,584,옥계,남강릉,219,1,1,0,3,17,241,248,2,2,0,5,11,268,
20221008,581,703,옥계,삼척,210,2,5,0,7,6,230,249,3,1,0,11,6,270,
20221008,581,704,옥계,근덕,265,1,5,0,57,10,338,371,6,10,4,107,5,503,
20221008,582,189,망상,강릉,466,10,47,1,2,30,556,525,12,64,4,0,32,637,
20221008,582,580,망상,북강릉,198,6,0,0,1,6,211,178,4,5,0,1,10,198,
20221008,582,581,망상,옥계,181,0,7,1,0,15,204,183,0,0,1,2,19,205,
20221008,582,583,망상,동해,195,0,1,2,21,8,227,249,2,8,2,9,12,282,
20221008,582,584,망상,남강릉,524,10,7,3,1,42,587,490,18,2,0,2,44,556,
20221008,582,585,망상,하조대,95,1,2,0,1,6,105,106,0,2,0,0,7,115,
20221008,582,703,망상,삼척,134,0,0,0,5,3,142,156,2,2,2,1,6,169,
20221008,582,704,망상,근덕,135,1,1,0,20,3,160,165,1,1,1,25,6,199,
20221008,583,174,동해,춘천,128,0,0,0,8,7,143,158,1,0,0,4,7,170,
20221008,583,180,동해,원주,142,5,4,1,7,6,165,213,1,5,1,6,4,230,
20221008,583,184,동해,대관령,112,0,3,1,4,3,123,140,0,2,1,3,0,146,
20221008,583,189,동해,강릉,1041,8,31,2,26,64,1172,942,17,13,6,29,54,1061,
20221008,583,580,동해,북강릉,349,4,6,1,28,10,398,264,3,4,1,15,11,298,
20221008,583,581,동해,옥계,527,6,10,2,106,33,684,409,10,4,1,146,21,591,
20221008,583,582,동해,망상,249,2,8,2,9,12,282,195,0,1,2,21,8,227,
20221008,583,584,동해,남강릉,1091,25,11,4,32,50,1213,1007,20,15,7,31,63,1143,
20221008,583,585,동해,하조대,174,1,3,0,9,6,193,154,1,3,2,7,9,176,
20221008,583,701,동해,북양양,169,2,2,0,2,4,179,128,0,4,0,2,8,142,
20221008,583,702,동해,속초,223,0,3,3,19,1,249,168,0,0,13,9,6,196,
20221008,583,703,동해,삼척,505,6,48,2,2,42,605,631,3,61,0,0,45,740,
20221008,583,704,동해,근덕,1126,6,28,6,65,56,1287,1166,10,39,3,38,66,1322,
20221008,584,581,남강릉,옥계,248,2,2,0,5,11,268,219,1,1,0,3,17,241,
20221008,584,582,남강릉,망상,490,18,2,0,2,44,556,524,10,7,3,1,42,587,
20221008,584,583,남강릉,동해,1007,20,15,7,31,63,1143,1091,25,11,4,32,50,1213,
20221008,584,703,남강릉,삼척,475,6,5,1,2,36,525,529,11,3,0,3,24,570,
20221008,584,704,남강릉,근덕,555,3,7,0,6,24,595,713,9,4,4,5,22,757,
20221008,585,184,하조대,대관령,178,1,3,0,0,5,187,168,2,3,0,0,6,179,
20221008,585,189,하조대,강릉,539,6,12,3,1,30,591,518,7,17,1,0,23,566,
20221008,585,284,하조대,남양양,324,4,4,0,1,15,348,244,5,2,1,4,12,268,
20221008,585,580,하조대,북강릉,695,10,24,0,1,27,757,512,10,22,1,0,23,568,
20221008,585,582,하조대,망상,106,0,2,0,0,7,115,95,1,2,0,1,6,105,
20221008,585,583,하조대,동해,154,1,3,2,7,9,176,174,1,3,0,9,6,193,
20221008,585,701,하조대,북양양,215,3,1,0,0,4,223,165,1,2,0,0,4,172,
20221008,585,702,하조대,속초,264,1,3,0,1,11,280,363,0,4,1,0,9,377,
20221008,585,704,하조대,근덕,146,0,4,0,1,10,161,288,5,2,1,5,9,310,
20221008,586,261,북남원,동광주,175,0,2,2,0,7,186,133,1,2,1,0,5,142,
20221008,586,589,북남원,상관,273,2,5,3,1,9,293,322,2,2,2,3,9,340,
20221008,586,590,북남원,동전주,130,1,1,0,0,6,138,117,3,1,0,0,0,121,
20221008,587,261,오수,동광주,323,3,0,0,1,9,336,382,0,1,0,1,9,393,
20221008,587,544,오수,완주,208,5,10,8,20,11,262,275,5,7,11,15,8,321,
20221008,587,556,오수,동순천,310,1,2,2,14,3,332,152,1,1,0,11,2,167,
20221008,587,569,오수,북광주,151,3,0,2,0,5,161,151,2,0,0,0,2,155,
20221008,587,588,오수,임실,133,0,1,0,1,6,141,167,1,1,0,0,7,176,
20221008,587,589,오수,상관,1268,9,46,20,50,31,1424,1580,18,34,15,117,46,1810,
20221008,587,590,오수,동전주,593,5,4,4,9,19,634,588,5,6,7,19,27,652,
20221008,588,261,임실,동광주,263,3,5,0,0,13,284,351,2,2,0,0,13,368,
20221008,588,544,임실,완주,268,0,1,2,6,6,283,265,1,7,1,0,8,282,
20221008,588,556,임실,동순천,134,1,2,0,1,1,139,154,0,2,0,1,5,162,
20221008,588,569,임실,북광주,113,3,0,0,0,2,118,120,0,0,0,0,1,121,
20221008,588,587,임실,오수,167,1,1,0,0,7,176,133,0,1,0,1,6,141,
20221008,588,589,임실,상관,540,2,12,0,3,19,576,782,2,17,0,0,33,834,
20221008,588,590,임실,동전주,386,1,7,0,6,11,411,429,1,6,0,1,14,451,
20221008,589,261,상관,동광주,113,1,0,0,0,5,119,101,0,1,0,0,2,104,
20221008,589,269,상관,지리산,135,1,3,1,3,4,147,109,2,4,0,4,4,123,
20221008,589,271,상관,순천,291,2,2,0,5,8,308,283,4,2,0,12,10,311,
20221008,589,272,상관,광양,90,0,2,11,122,3,228,60,0,3,0,51,2,116,
20221008,589,273,상관,동광양,125,0,2,12,49,2,190,142,1,2,1,11,3,160,
20221008,589,544,상관,완주,179,2,4,3,3,5,196,165,1,11,4,5,9,195,
20221008,589,556,상관,동순천,1266,3,16,14,65,32,1396,907,4,16,5,136,14,1082,
20221008,589,558,상관,구례화엄사,346,1,4,1,2,5,359,219,3,4,0,0,3,229,
20221008,589,559,상관,서남원,186,1,3,7,15,4,216,122,0,8,2,22,0,154,
20221008,589,586,상관,북남원,322,2,2,2,3,9,340,273,2,5,3,1,9,293,
20221008,589,587,상관,오수,1580,18,34,15,117,46,1810,1268,9,46,20,50,31,1424,
20221008,589,588,상관,임실,782,2,17,0,0,33,834,540,2,12,0,3,19,576,
20221008,589,590,상관,동전주,231,1,3,0,2,9,246,186,0,2,0,2,5,195,
20221008,590,152,동전주,유성,282,0,0,0,0,10,292,287,1,0,1,0,24,313,
20221008,590,153,동전주,서대전,184,2,2,0,0,9,197,162,1,2,0,0,12,177,
20221008,590,156,동전주,익산,124,11,3,0,0,4,142,153,10,4,4,0,5,176,
20221008,590,261,동전주,동광주,128,0,1,0,1,3,133,105,0,0,0,0,7,112,
20221008,590,271,동전주,순천,117,0,1,0,0,5,123,158,4,1,0,0,3,166,
20221008,590,556,동전주,동순천,530,2,1,0,7,12,552,446,3,1,0,9,12,471,
20221008,590,558,동전주,구례화엄사,120,1,3,1,1,4,130,96,1,1,0,0,3,101,
20221008,590,586,동전주,북남원,117,3,1,0,0,0,121,130,1,1,0,0,6,138,
20221008,590,587,동전주,오수,588,5,6,7,19,27,652,593,5,4,4,9,19,634,
20221008,590,588,동전주,임실,429,1,6,0,1,14,451,386,1,7,0,6,11,411,
20221008,590,589,동전주,상관,186,0,2,0,2,5,195,231,1,3,0,2,9,246,
20221008,591,578,동서천,서세종,215,1,1,5,25,1,248,313,0,3,6,24,5,351,
20221008,591,595,동서천,서공주,134,1,4,1,6,4,150,243,4,6,7,11,7,278,
20221008,592,227,서부여,군산,258,3,5,1,2,6,275,187,1,5,2,5,12,212,
20221008,592,578,서부여,서세종,203,1,2,2,1,1,210,386,0,2,5,1,15,409,
20221008,593,115,부여,대전,96,1,3,0,0,4,104,101,1,2,0,0,3,107,
20221008,593,152,부여,유성,159,0,5,1,0,7,172,162,0,7,0,0,5,174,
20221008,593,227,부여,군산,261,0,4,2,5,10,282,314,0,2,1,1,12,330,
20221008,593,575,부여,유구,169,0,0,0,0,8,177,409,1,2,1,0,6,419,
20221008,593,578,부여,서세종,336,2,3,0,2,10,353,430,2,3,4,3,8,450,
20221008,593,579,부여,남세종,150,0,0,0,2,6,158,157,0,0,1,3,5,166,
20221008,593,595,부여,서공주,134,0,1,4,5,4,148,297,2,2,1,0,12,314,
20221008,593,603,부여,정안,93,0,1,1,1,4,100,158,1,3,1,3,5,171,
20221008,593,613,부여,남풍세,141,2,3,0,2,5,153,217,3,0,1,1,4,226,
20221008,595,115,서공주,대전,338,5,4,0,2,11,360,412,2,7,1,0,29,451,
20221008,595,151,서공주,북대전,273,2,4,1,3,3,286,304,0,3,4,5,15,331,
20221008,595,152,서공주,유성,472,7,6,1,4,16,506,562,8,3,1,4,17,595,
20221008,595,153,서공주,서대전,123,0,1,0,1,5,130,198,2,0,1,1,5,207,
20221008,595,227,서공주,군산,544,2,5,2,3,18,574,230,1,5,0,0,5,241,
20221008,595,578,서공주,서세종,270,1,6,0,2,9,288,253,3,5,1,0,5,267,
20221008,595,579,서공주,남세종,287,1,1,1,3,9,302,374,1,1,1,2,8,387,
20221008,595,591,서공주,동서천,243,4,6,7,11,7,278,134,1,4,1,6,4,150,
20221008,595,593,서공주,부여,297,2,2,1,0,12,314,134,0,1,4,5,4,148,
20221008,597,500,서여주,남여주,468,1,8,6,2,16,501,406,2,1,3,6,8,426,
20221008,597,517,서여주,양평,1095,24,28,25,15,56,1243,922,15,25,32,13,49,1056,
20221008,597,560,서여주,감곡,128,2,0,5,14,4,153,168,2,1,2,32,5,210,
20221008,597,561,서여주,북충주,89,0,0,1,1,13,104,119,0,1,3,5,3,131,
20221008,597,598,서여주,북여주,1111,46,110,24,26,49,1366,858,17,38,16,20,54,1003,
20221008,597,735,서여주,남양평,358,4,0,0,0,18,380,252,6,0,0,0,9,267,
20221008,598,500,북여주,남여주,409,6,6,2,7,14,444,348,9,5,4,8,13,387,
20221008,598,517,북여주,양평,2199,17,8,14,18,62,2318,3423,18,12,17,32,107,3609,
20221008,598,560,북여주,감곡,146,5,2,0,5,5,163,157,0,6,3,1,6,173,
20221008,598,597,북여주,서여주,858,17,38,16,20,54,1003,1111,46,110,24,26,49,1366,
20221008,598,735,북여주,남양평,1130,6,4,1,0,41,1182,881,13,6,0,1,27,928,
20221008,599,152,양촌,유성,209,1,0,0,0,10,220,249,1,0,0,0,8,258,
20221008,599,153,양촌,서대전,204,1,1,0,0,10,216,250,0,0,0,0,10,260,
20221008,601,101,남천안,서울,595,10,27,9,11,31,683,2366,23,135,9,20,65,2618,
20221008,601,103,남천안,수원신갈,131,1,2,0,4,2,140,432,3,0,4,3,10,452,
20221008,601,107,남천안,안성,194,1,5,3,0,10,213,370,2,7,3,2,12,396,
20221008,601,108,남천안,천안,281,10,11,9,17,12,340,1273,15,18,14,27,45,1392,
20221008,601,111,남천안,청주,199,6,3,0,1,13,222,107,0,2,4,7,4,124,
20221008,601,229,남천안,북천안,222,6,20,18,27,9,302,466,2,10,16,24,24,542,
20221008,601,542,남천안,서안성,118,3,7,10,7,3,148,261,3,17,12,2,9,304,
20221008,601,742,남천안,남사진위,118,1,4,5,6,4,138,741,3,3,3,3,21,774,
20221008,603,227,정안,군산,276,2,12,0,4,9,303,169,0,1,0,3,7,180,
20221008,603,593,정안,부여,158,1,3,1,3,5,171,93,0,1,1,1,4,100,
20221008,603,603,정안,정안,129,1,0,0,0,6,136,129,1,0,0,0,6,136,
20221008,603,604,정안,남공주,175,0,4,1,6,8,194,111,0,1,1,2,3,118,
20221008,603,606,정안,서논산,237,1,5,1,3,8,255,143,1,4,2,2,2,154,
20221008,603,607,정안,연무,494,4,14,4,5,18,539,235,3,2,2,5,7,254,
20221008,603,613,정안,남풍세,1875,23,13,28,73,65,2077,878,7,9,13,29,27,963,
20221008,604,578,남공주,서세종,166,4,3,0,2,9,184,199,2,1,1,1,8,212,
20221008,604,579,남공주,남세종,104,0,1,0,1,3,109,101,0,1,0,0,6,108,
20221008,604,603,남공주,정안,111,0,1,1,2,3,118,175,0,4,1,6,8,194,
20221008,604,613,남공주,남풍세,146,7,2,4,15,6,180,236,8,1,9,9,9,272,
20221008,605,606,탄천,서논산,97,1,1,1,2,5,107,125,2,2,1,9,7,146,
20221008,606,573,서논산,예산수덕사,114,1,2,1,1,2,121,109,1,0,7,6,2,125,
20221008,606,603,서논산,정안,143,1,4,2,2,2,154,237,1,5,1,3,8,255,
20221008,606,605,서논산,탄천,125,2,2,1,9,7,146,97,1,1,1,2,5,107,
20221008,606,607,서논산,연무,476,4,15,11,12,14,532,308,6,13,14,20,13,374,
20221008,606,613,서논산,남풍세,294,7,3,12,15,18,349,355,2,5,6,13,14,395,
20221008,607,577,연무,공주,124,0,3,4,2,2,135,184,3,2,4,4,2,199,
20221008,607,578,연무,서세종,139,0,2,0,2,8,151,124,1,2,0,0,4,131,
20221008,607,603,연무,정안,235,3,2,2,5,7,254,494,4,14,4,5,18,539,
20221008,607,606,연무,서논산,308,6,13,14,20,13,374,476,4,15,11,12,14,532,
20221008,607,613,연무,남풍세,496,11,20,19,31,15,592,777,13,21,19,31,34,895,
20221008,613,152,남풍세,유성,244,8,5,13,3,6,279,386,4,7,7,7,12,423,
20221008,613,153,남풍세,서대전,145,2,0,0,0,11,158,199,6,4,4,2,14,229,
20221008,613,227,남풍세,군산,404,0,3,2,6,17,432,177,4,4,2,9,5,201,
20221008,613,509,남풍세,목포,248,1,1,6,1,8,265,95,0,2,2,1,1,101,
20221008,613,577,남풍세,공주,288,3,6,1,2,12,312,229,2,2,1,10,13,257,
20221008,613,579,남풍세,남세종,135,1,3,1,1,4,145,235,2,1,1,3,10,252,
20221008,613,593,남풍세,부여,217,3,0,1,1,4,226,141,2,3,0,2,5,153,
20221008,613,603,남풍세,정안,878,7,9,13,29,27,963,1875,23,13,28,73,65,2077,
20221008,613,604,남풍세,남공주,236,8,1,9,9,9,272,146,7,2,4,15,6,180,
20221008,613,606,남풍세,서논산,355,2,5,6,13,14,395,294,7,3,12,15,18,349,
20221008,613,607,남풍세,연무,777,13,21,19,31,34,895,496,11,20,19,31,15,592,
20221008,621,123,동대구,구미,310,1,3,2,9,12,337,281,3,3,6,7,11,311,
20221008,621,125,동대구,남구미,229,4,4,3,4,17,261,239,1,1,2,3,20,266,
20221008,621,126,동대구,왜관,438,19,6,1,38,23,525,440,15,7,8,54,23,547,
20221008,621,127,동대구,서대구,969,24,23,15,20,65,1116,1427,38,60,18,32,88,1663,
20221008,621,129,동대구,북대구,588,19,19,10,23,30,689,406,6,7,10,3,19,451,
20221008,621,130,동대구,동김천,102,1,1,0,8,5,117,92,1,0,2,6,3,104,
20221008,621,131,동대구,경산,1796,42,25,12,17,92,1984,1836,37,25,5,40,102,2045,
20221008,621,132,동대구,영천,1359,11,23,2,30,52,1477,1169,7,21,3,33,43,1276,
20221008,621,133,동대구,건천,521,3,12,2,3,22,563,417,4,2,1,1,17,442,
20221008,621,135,동대구,경주,1274,4,34,1,0,56,1369,1250,8,46,0,1,40,1345,
20221008,621,190,동대구,동서울,111,1,1,3,2,5,123,114,2,2,5,4,1,128,
20221008,621,201,동대구,칠곡,123,3,3,1,4,4,138,146,3,1,3,1,8,162,
20221008,621,203,동대구,가산,82,2,0,1,12,5,102,104,1,1,2,0,4,112,
20221008,621,230,동대구,팔공산,152,3,4,7,1,5,172,205,5,7,5,4,9,235,
20221008,621,231,동대구,화원옥포,178,5,2,1,5,9,200,156,4,4,0,2,12,178,
20221008,621,233,동대구,현풍,111,0,3,2,2,4,122,127,0,2,1,2,7,139,
20221008,621,241,동대구,동고령,124,2,6,1,4,8,145,100,4,3,0,10,2,119,
20221008,621,242,동대구,고령,205,2,1,1,6,6,221,122,1,2,0,4,5,134,
20221008,621,518,동대구,칠곡물류,76,15,15,9,1,1,117,79,15,9,12,9,4,128,
20221008,621,524,동대구,청통와촌,281,8,4,1,29,7,330,279,7,5,0,16,10,317,
20221008,621,525,동대구,북영천,267,3,3,0,4,5,282,230,1,4,0,5,4,244,
20221008,621,527,동대구,포항,1199,9,62,1,1,39,1311,905,12,62,4,6,29,1018,
20221008,621,641,동대구,울산,376,1,30,0,1,19,427,341,0,33,0,1,15,390,
20221008,621,730,동대구,유천,107,3,0,0,1,4,115,120,1,0,0,0,4,125,
20221008,621,772,동대구,북달성,173,0,6,0,0,8,187,254,3,5,2,0,11,275,
20221008,621,776,동대구,연경,307,5,2,2,2,6,324,441,1,0,1,4,18,465,
20221008,621,779,동대구,율암,113,0,0,0,0,4,117,151,1,0,0,0,9,161,
20221008,623,624,수성,청도,855,5,3,3,4,28,898,796,11,5,2,8,40,862,
20221008,623,625,수성,밀양,824,8,8,1,1,29,871,783,8,12,3,2,24,832,
20221008,623,626,수성,남밀양,775,12,1,2,5,22,817,958,9,3,1,8,36,1015,
20221008,623,627,수성,삼랑진,336,1,5,1,2,18,363,386,3,7,6,2,17,421,
20221008,624,623,청도,수성,796,11,5,2,8,40,862,855,5,3,3,4,28,898,
20221008,624,625,청도,밀양,577,5,5,1,2,34,624,522,10,9,3,3,30,577,
20221008,624,626,청도,남밀양,1083,16,16,12,19,48,1194,1035,19,17,14,18,47,1150,
20221008,624,627,청도,삼랑진,342,8,5,1,5,14,375,341,2,6,5,4,16,374,
20221008,625,623,밀양,수성,783,8,12,3,2,24,832,824,8,8,1,1,29,871,
20221008,625,624,밀양,청도,522,10,9,3,3,30,577,577,5,5,1,2,34,624,
20221008,625,626,밀양,남밀양,1894,40,35,21,39,82,2111,2392,32,29,26,48,95,2622,
20221008,625,627,밀양,삼랑진,855,11,11,2,23,47,949,1028,6,6,3,3,65,1111,
20221008,625,628,밀양,상동,50,10,1,0,49,3,113,48,9,2,1,48,2,110,
20221008,626,623,남밀양,수성,958,9,3,1,8,36,1015,775,12,1,2,5,22,817,
20221008,626,624,남밀양,청도,1035,19,17,14,18,47,1150,1083,16,16,12,19,48,1194,
20221008,626,625,남밀양,밀양,2392,32,29,26,48,95,2622,1894,40,35,21,39,82,2111,
20221008,626,627,남밀양,삼랑진,1025,20,18,8,16,102,1189,1144,19,18,6,29,100,1316,
20221008,627,623,삼랑진,수성,386,3,7,6,2,17,421,336,1,5,1,2,18,363,
20221008,627,624,삼랑진,청도,341,2,6,5,4,16,374,342,8,5,1,5,14,375,
20221008,627,625,삼랑진,밀양,1028,6,6,3,3,65,1111,855,11,11,2,23,47,949,
20221008,627,626,삼랑진,남밀양,1144,19,18,6,29,100,1316,1025,20,18,8,16,102,1189,
20221008,628,625,상동,밀양,48,9,2,1,48,2,110,50,10,1,0,49,3,113,
20221008,641,123,울산,구미,117,0,4,0,3,3,127,108,0,4,2,2,6,122,
20221008,641,126,울산,왜관,94,0,1,5,6,3,109,90,0,1,2,6,3,102,
20221008,641,127,울산,서대구,276,2,19,2,15,15,329,384,0,19,5,8,17,433,
20221008,641,129,울산,북대구,405,4,8,5,9,16,447,309,3,1,4,1,12,330,
20221008,641,131,울산,경산,269,2,14,9,28,9,331,245,7,14,14,18,8,306,
20221008,641,132,울산,영천,325,3,15,5,10,15,373,262,3,16,11,11,9,312,
20221008,641,133,울산,건천,194,2,1,3,9,3,212,118,0,2,2,10,5,137,
20221008,641,135,울산,경주,502,0,30,1,9,36,578,493,2,30,3,3,40,571,
20221008,641,137,울산,통도사,730,22,19,7,6,39,823,626,30,15,7,6,37,721,
20221008,641,138,울산,양산,595,43,50,20,5,36,749,506,66,36,20,8,31,667,
20221008,641,139,울산,서울산,1750,19,40,3,34,82,1928,1676,23,34,11,26,112,1882,
20221008,641,140,울산,부산,514,4,7,0,1,29,555,540,4,7,0,0,24,575,
20221008,641,146,울산,동창원,209,0,0,1,4,9,223,126,0,0,2,0,6,134,
20221008,641,148,울산,서김해,504,5,20,16,7,17,569,395,5,17,15,3,34,469,
20221008,641,149,울산,동김해,399,10,4,1,2,25,441,343,1,3,2,1,28,378,
20221008,641,230,울산,팔공산,197,2,6,1,19,9,234,172,3,4,3,6,15,203,
20221008,641,245,울산,장유,755,5,26,6,10,44,846,560,7,25,8,12,29,641,
20221008,641,250,울산,남양산,652,28,34,6,7,37,764,668,14,51,4,2,39,778,
20221008,641,251,울산,물금,177,31,8,7,2,11,236,153,39,7,6,5,9,219,
20221008,641,252,울산,대동,2102,31,50,19,25,110,2337,2005,32,54,6,29,111,2237,
20221008,641,289,울산,마산,859,3,28,3,2,31,926,586,3,25,2,4,23,643,
20221008,641,621,울산,동대구,341,0,33,0,1,15,390,376,1,30,0,1,19,427,
20221008,641,642,울산,문수,223,3,5,0,5,14,250,228,2,2,2,4,21,259,
20221008,641,643,울산,청량,680,6,6,2,18,64,776,863,11,6,3,13,86,982,
20221008,641,644,울산,온양,446,1,3,1,2,43,496,436,1,4,2,1,45,489,
20221008,641,645,울산,장안,411,8,3,3,1,23,449,420,4,6,1,1,23,455,
20221008,641,646,울산,기장일광,379,2,4,0,9,25,419,410,0,1,0,0,27,438,
20221008,641,647,울산,해운대송정,212,2,1,0,3,7,225,191,1,0,0,1,5,198,
20221008,641,648,울산,해운대,1327,2,0,0,2,70,1401,1625,5,7,1,1,83,1722,
20221008,641,706,울산,남경주,1564,7,16,8,20,66,1681,1637,2,9,11,18,73,1750,
20221008,641,707,울산,남포항,2180,14,24,16,107,108,2449,1914,12,23,18,77,93,2137,
20221008,641,708,울산,동경주,247,2,0,1,4,14,268,198,1,1,0,4,11,215,
20221008,641,722,울산,활천,234,8,2,4,7,11,266,147,8,2,5,10,2,174,
20221008,641,747,울산,범서,133,2,6,3,2,7,153,143,2,7,4,5,9,170,
20221008,641,755,울산,광재,94,4,4,2,7,10,121,86,6,1,0,5,6,104,
20221008,642,139,문수,서울산,96,1,9,1,2,3,112,86,2,10,3,6,8,115,
20221008,642,641,문수,울산,228,2,2,2,4,21,259,223,3,5,0,5,14,250,
20221008,642,643,문수,청량,100,1,4,7,28,11,151,212,2,2,1,9,13,239,
20221008,642,644,문수,온양,141,1,3,0,2,11,158,147,0,3,0,0,11,161,
20221008,642,645,문수,장안,242,1,1,2,2,8,256,274,0,1,1,0,11,287,
20221008,642,646,문수,기장일광,281,2,2,0,1,16,302,310,1,8,0,0,15,334,
20221008,642,647,문수,해운대송정,154,0,0,0,3,8,165,149,0,0,0,0,6,155,
20221008,642,648,문수,해운대,882,0,2,0,2,37,923,1371,4,1,0,10,51,1437,
20221008,642,706,문수,남경주,646,4,17,12,6,42,727,517,2,17,11,23,30,600,
20221008,642,707,문수,남포항,725,9,6,5,21,40,806,544,10,5,10,40,29,638,
20221008,642,747,문수,범서,144,13,17,19,2,7,202,149,11,17,25,10,6,218,
20221008,643,641,청량,울산,863,11,6,3,13,86,982,680,6,6,2,18,64,776,
20221008,643,642,청량,문수,212,2,2,1,9,13,239,100,1,4,7,28,11,151,
20221008,643,645,청량,장안,1015,8,15,9,26,80,1153,797,8,8,8,30,63,914,
20221008,643,646,청량,기장일광,1058,9,11,2,14,79,1173,845,8,6,3,9,72,943,
20221008,643,647,청량,해운대송정,618,4,0,1,5,25,653,406,0,0,3,6,20,435,
20221008,643,648,청량,해운대,3895,11,14,7,27,224,4178,4208,13,63,28,256,223,4791,
20221008,643,706,청량,남경주,324,3,11,17,74,19,448,207,1,9,22,50,14,303,
20221008,643,707,청량,남포항,400,6,8,13,225,25,677,210,1,8,13,193,10,435,
20221008,643,747,청량,범서,119,10,24,15,45,7,220,97,12,22,14,36,10,191,
20221008,644,641,온양,울산,436,1,4,2,1,45,489,446,1,3,1,2,43,496,
20221008,644,642,온양,문수,147,0,3,0,0,11,161,141,1,3,0,2,11,158,
20221008,644,645,온양,장안,110,2,2,1,2,5,122,100,2,2,1,0,2,107,
20221008,644,646,온양,기장일광,226,3,2,0,2,14,247,156,2,2,0,0,15,175,
20221008,644,647,온양,해운대송정,137,1,1,0,0,14,153,140,0,0,0,0,9,149,
20221008,644,648,온양,해운대,625,2,1,2,1,54,685,857,4,3,1,9,52,926,
20221008,644,706,온양,남경주,95,0,1,0,1,5,102,111,1,2,0,2,4,120,
20221008,644,707,온양,남포항,131,0,1,1,3,4,140,104,0,1,5,7,7,124,
20221008,645,641,장안,울산,420,4,6,1,1,23,455,411,8,3,3,1,23,449,
20221008,645,642,장안,문수,274,0,1,1,0,11,287,242,1,1,2,2,8,256,
20221008,645,643,장안,청량,797,8,8,8,30,63,914,1015,8,15,9,26,80,1153,
20221008,645,644,장안,온양,100,2,2,1,0,2,107,110,2,2,1,2,5,122,
20221008,645,647,장안,해운대송정,488,2,5,1,2,25,523,636,4,7,2,3,42,694,
20221008,645,648,장안,해운대,1487,4,2,2,1,73,1569,3196,13,8,12,50,150,3429,
20221008,645,706,장안,남경주,195,0,10,2,2,4,213,204,1,7,2,3,7,224,
20221008,645,707,장안,남포항,387,1,1,0,2,7,398,346,2,2,0,5,8,363,
20221008,646,641,기장일광,울산,410,0,1,0,0,27,438,379,2,4,0,9,25,419,
20221008,646,642,기장일광,문수,310,1,8,0,0,15,334,281,2,2,0,1,16,302,
20221008,646,643,기장일광,청량,845,8,6,3,9,72,943,1058,9,11,2,14,79,1173,
20221008,646,644,기장일광,온양,156,2,2,0,0,15,175,226,3,2,0,2,14,247,
20221008,646,647,기장일광,해운대송정,1012,3,2,1,4,47,1069,577,0,0,2,6,32,617,
20221008,646,648,기장일광,해운대,4838,10,18,3,3,278,5150,6002,29,23,10,84,303,6451,
20221008,646,706,기장일광,남경주,184,1,0,0,0,11,196,193,1,0,0,0,8,202,
20221008,646,707,기장일광,남포항,316,3,2,1,0,16,338,250,2,3,1,2,17,275,
20221008,647,641,해운대송정,울산,191,1,0,0,1,5,198,212,2,1,0,3,7,225,
20221008,647,642,해운대송정,문수,149,0,0,0,0,6,155,154,0,0,0,3,8,165,
20221008,647,643,해운대송정,청량,406,0,0,3,6,20,435,618,4,0,1,5,25,653,
20221008,647,644,해운대송정,온양,140,0,0,0,0,9,149,137,1,1,0,0,14,153,
20221008,647,645,해운대송정,장안,636,4,7,2,3,42,694,488,2,5,1,2,25,523,
20221008,647,646,해운대송정,기장일광,577,0,0,2,6,32,617,1012,3,2,1,4,47,1069,
20221008,647,706,해운대송정,남경주,129,1,0,1,0,5,136,134,0,1,0,0,4,139,
20221008,647,707,해운대송정,남포항,175,0,0,0,0,8,183,182,1,0,0,0,3,186,
20221008,648,641,해운대,울산,1625,5,7,1,1,83,1722,1327,2,0,0,2,70,1401,
20221008,648,642,해운대,문수,1371,4,1,0,10,51,1437,882,0,2,0,2,37,923,
20221008,648,643,해운대,청량,4208,13,63,28,256,223,4791,3895,11,14,7,27,224,4178,
20221008,648,644,해운대,온양,857,4,3,1,9,52,926,625,2,1,2,1,54,685,
20221008,648,645,해운대,장안,3196,13,8,12,50,150,3429,1487,4,2,2,1,73,1569,
20221008,648,646,해운대,기장일광,6002,29,23,10,84,303,6451,4838,10,18,3,3,278,5150,
20221008,648,706,해운대,남경주,878,2,2,0,4,25,911,519,0,4,0,0,18,541,
20221008,648,707,해운대,남포항,1892,8,29,5,25,65,2024,1382,3,16,2,2,56,1461,
20221008,648,708,해운대,동경주,192,1,2,0,0,6,201,105,0,0,0,0,1,106,
20221008,651,651,남양주,남양주,91,3,1,2,0,5,102,91,3,1,2,0,5,102,
20221008,651,652,남양주,화도,7620,142,240,237,129,509,8877,7997,153,242,243,77,423,9135,
20221008,651,653,남양주,서종,1886,8,6,0,1,70,1971,2629,11,8,6,3,100,2757,
20221008,651,654,남양주,설악,6242,24,54,12,10,207,6549,4244,30,59,7,9,146,4495,
20221008,651,655,남양주,강촌,4241,26,89,17,16,124,4513,3406,15,105,11,14,113,3664,
20221008,651,656,남양주,남춘천,4506,16,55,16,15,138,4746,2427,9,49,10,8,59,2562,
20221008,652,651,화도,남양주,7997,153,242,243,77,423,9135,7620,142,240,237,129,509,8877,
20221008,652,653,화도,서종,982,14,3,4,4,71,1078,1431,22,10,9,6,98,1576,
20221008,652,654,화도,설악,1531,12,5,8,1,80,1637,1120,11,12,4,4,65,1216,
20221008,652,655,화도,강촌,856,6,7,1,0,35,905,726,9,7,3,11,31,787,
20221008,652,656,화도,남춘천,1041,4,3,7,0,37,1092,412,5,9,3,3,11,443,
20221008,653,651,서종,남양주,2629,11,8,6,3,100,2757,1886,8,6,0,1,70,1971,
20221008,653,652,서종,화도,1431,22,10,9,6,98,1576,982,14,3,4,4,71,1078,
20221008,653,654,서종,설악,919,2,6,2,4,32,965,309,6,2,4,0,17,338,
20221008,653,655,서종,강촌,458,1,1,1,0,13,474,124,0,0,0,0,5,129,
20221008,654,651,설악,남양주,4244,30,59,7,9,146,4495,6242,24,54,12,10,207,6549,
20221008,654,652,설악,화도,1120,11,12,4,4,65,1216,1531,12,5,8,1,80,1637,
20221008,654,653,설악,서종,309,6,2,4,0,17,338,919,2,6,2,4,32,965,
20221008,654,655,설악,강촌,722,4,7,3,0,30,766,404,4,7,4,1,20,440,
20221008,654,656,설악,남춘천,681,2,7,0,2,24,716,178,2,0,0,1,11,192,
20221008,655,651,강촌,남양주,3406,15,105,11,14,113,3664,4241,26,89,17,16,124,4513,
20221008,655,652,강촌,화도,726,9,7,3,11,31,787,856,6,7,1,0,35,905,
20221008,655,653,강촌,서종,124,0,0,0,0,5,129,458,1,1,1,0,13,474,
20221008,655,654,강촌,설악,404,4,7,4,1,20,440,722,4,7,3,0,30,766,
20221008,656,651,남춘천,남양주,2427,9,49,10,8,59,2562,4506,16,55,16,15,138,4746,
20221008,656,652,남춘천,화도,412,5,9,3,3,11,443,1041,4,3,7,0,37,1092,
20221008,656,654,남춘천,설악,178,2,0,0,1,11,192,681,2,7,0,2,24,716,
20221008,671,106,봉담,오산,514,30,23,13,11,36,627,600,25,27,13,10,43,718,
20221008,671,107,봉담,안성,359,5,5,2,1,16,388,476,8,4,2,2,32,524,
20221008,671,108,봉담,천안,346,1,23,0,1,18,389,368,2,22,1,0,20,413,
20221008,671,111,봉담,청주,125,0,13,0,1,8,147,175,1,16,0,0,10,202,
20221008,671,115,봉담,대전,92,1,13,1,0,2,109,120,3,14,0,0,3,140,
20221008,671,528,봉담,기흥동탄,85,1,3,1,4,10,104,149,6,1,3,7,18,184,
20221008,671,542,봉담,서안성,85,2,6,10,2,5,110,130,2,6,9,2,6,155,
20221008,671,543,봉담,남안성,193,5,5,6,2,10,221,226,4,12,11,4,21,278,
20221008,671,555,봉담,북진천,123,4,2,1,1,5,136,128,4,4,1,5,10,152,
20221008,671,672,봉담,정남,2720,71,44,30,137,124,3126,2435,65,34,32,248,116,2930,
20221008,671,673,봉담,북오산,1717,32,22,13,11,117,1912,2208,27,34,14,18,142,2443,
20221008,671,675,봉담,서오산,642,10,4,2,5,44,707,979,13,7,2,9,64,1074,
20221008,671,676,봉담,향남,883,30,12,5,6,48,984,918,49,22,7,13,62,1071,
20221008,671,677,봉담,북평택,11279,70,89,56,93,501,12088,10924,88,94,66,87,558,11817,
20221008,671,876,봉담,양감,110,2,3,2,9,6,132,110,3,1,5,7,4,130,
20221008,672,671,정남,봉담,2435,65,34,32,248,116,2930,2720,71,44,30,137,124,3126,
20221008,672,673,정남,북오산,304,3,3,1,3,13,327,515,7,1,5,7,23,558,
20221008,672,675,정남,서오산,233,2,1,1,1,13,251,925,16,7,2,14,29,993,
20221008,672,677,정남,북평택,217,5,6,3,3,6,240,221,7,7,9,2,10,256,
20221008,673,101,북오산,서울,1607,31,93,15,2,80,1828,1656,20,95,19,3,92,1885,
20221008,673,103,북오산,수원신갈,367,5,4,4,6,26,412,321,3,1,5,5,20,355,
20221008,673,106,북오산,오산,178,2,1,1,2,12,196,127,5,1,0,0,15,148,
20221008,673,107,북오산,안성,567,12,8,2,2,49,640,666,10,4,3,2,58,743,
20221008,673,108,북오산,천안,544,1,3,3,2,20,573,500,1,5,1,6,22,535,
20221008,673,111,북오산,청주,97,0,2,0,1,5,105,200,0,3,1,0,10,214,
20221008,673,136,북오산,음성,153,0,1,5,0,8,167,93,0,1,2,0,6,102,
20221008,673,229,북오산,북천안,170,4,5,0,2,9,190,103,3,6,3,1,8,124,
20221008,673,528,북오산,기흥동탄,144,5,1,0,1,9,160,214,8,1,0,0,8,231,
20221008,673,542,북오산,서안성,160,6,2,7,0,13,188,378,9,4,6,2,32,431,
20221008,673,543,북오산,남안성,224,12,3,4,1,16,260,281,5,7,2,6,18,319,
20221008,673,555,북오산,북진천,167,4,1,4,0,6,182,187,4,1,3,0,5,200,
20221008,673,671,북오산,봉담,2208,27,34,14,18,142,2443,1717,32,22,13,11,117,1912,
20221008,673,672,북오산,정남,515,7,1,5,7,23,558,304,3,3,1,3,13,327,
20221008,673,675,북오산,서오산,220,1,3,1,3,10,238,178,2,2,0,1,9,192,
20221008,673,676,북오산,향남,557,6,3,4,8,34,612,484,11,8,3,7,31,544,
20221008,673,677,북오산,북평택,2517,19,19,17,16,98,2686,1754,21,25,6,18,99,1923,
20221008,673,876,북오산,양감,201,13,2,4,20,5,245,267,9,24,4,26,13,343,
20221008,675,671,서오산,봉담,979,13,7,2,9,64,1074,642,10,4,2,5,44,707,
20221008,675,672,서오산,정남,925,16,7,2,14,29,993,233,2,1,1,1,13,251,
20221008,675,673,서오산,북오산,178,2,2,0,1,9,192,220,1,3,1,3,10,238,
20221008,675,676,서오산,향남,2648,57,33,12,83,144,2977,1946,44,28,10,58,112,2198,
20221008,675,677,서오산,북평택,17037,117,171,103,130,760,18318,13343,117,172,93,121,669,14515,
20221008,675,876,서오산,양감,678,24,4,8,107,38,859,818,23,10,11,103,45,1010,
20221008,676,101,향남,서울,125,8,9,3,12,8,165,212,4,10,3,9,8,246,
20221008,676,671,향남,봉담,918,49,22,7,13,62,1071,883,30,12,5,6,48,984,
20221008,676,673,향남,북오산,484,11,8,3,7,31,544,557,6,3,4,8,34,612,
20221008,676,675,향남,서오산,1946,44,28,10,58,112,2198,2648,57,33,12,83,144,2977,
20221008,676,677,향남,북평택,1780,70,51,47,73,88,2109,1682,73,57,64,45,79,2000,
20221008,677,101,북평택,서울,2324,25,143,45,95,112,2744,3581,35,133,42,51,147,3989,
20221008,677,103,북평택,수원신갈,491,7,8,12,16,28,562,628,4,7,4,8,22,673,
20221008,677,528,북평택,기흥동탄,186,0,0,11,28,2,227,345,1,5,10,38,10,409,
20221008,677,671,북평택,봉담,10924,88,94,66,87,558,11817,11279,70,89,56,93,501,12088,
20221008,677,672,북평택,정남,221,7,7,9,2,10,256,217,5,6,3,3,6,240,
20221008,677,673,북평택,북오산,1754,21,25,6,18,99,1923,2517,19,19,17,16,98,2686,
20221008,677,675,북평택,서오산,13343,117,172,93,121,669,14515,17037,117,171,103,130,760,18318,
20221008,677,676,북평택,향남,1682,73,57,64,45,79,2000,1780,70,51,47,73,88,2109,
20221008,677,876,북평택,양감,3258,60,56,48,64,173,3659,5035,47,64,51,62,209,5468,
20221008,682,683,조암,송산마도,535,33,24,23,25,17,657,610,30,25,23,49,23,760,
20221008,682,684,조암,남안산,614,42,51,33,94,30,864,870,44,41,37,66,45,1103,
20221008,682,685,조암,서시흥,1523,68,54,61,170,84,1960,2039,47,70,64,162,100,2482,
20221008,683,682,송산마도,조암,610,30,25,23,49,23,760,535,33,24,23,25,17,657,
20221008,683,684,송산마도,남안산,2154,87,68,47,154,130,2640,2266,67,44,34,73,122,2606,
20221008,683,685,송산마도,서시흥,5491,103,99,82,584,286,6645,4560,72,80,83,517,246,5558,
20221008,684,682,남안산,조암,870,44,41,37,66,45,1103,614,42,51,33,94,30,864,
20221008,684,683,남안산,송산마도,2266,67,44,34,73,122,2606,2154,87,68,47,154,130,2640,
20221008,684,685,남안산,서시흥,4159,169,114,219,250,281,5192,4691,142,127,194,168,317,5639,
20221008,685,520,서시흥,평택,87,2,2,2,2,5,100,3507,51,99,99,136,136,4028,
20221008,685,682,서시흥,조암,2039,47,70,64,162,100,2482,1523,68,54,61,170,84,1960,
20221008,685,683,서시흥,송산마도,4560,72,80,83,517,246,5558,5491,103,99,82,584,286,6645,
20221008,685,684,서시흥,남안산,4691,142,127,194,168,317,5639,4159,169,114,219,250,281,5192,
20221008,701,174,북양양,춘천,301,2,2,0,0,17,322,375,1,3,0,0,12,391,
20221008,701,184,북양양,대관령,120,0,1,0,1,4,126,173,0,2,1,0,6,182,
20221008,701,189,북양양,강릉,366,10,2,1,7,25,411,418,5,6,1,1,32,463,
20221008,701,284,북양양,남양양,310,2,2,2,1,7,324,280,5,2,0,1,8,296,
20221008,701,510,북양양,양양,271,1,4,0,0,6,282,639,2,54,0,0,14,709,
20221008,701,554,북양양,동홍천,701,4,22,1,21,18,767,1193,1,8,5,19,29,1255,
20221008,701,580,북양양,북강릉,535,9,2,0,3,27,576,559,8,3,0,0,27,597,
20221008,701,583,북양양,동해,128,0,4,0,2,8,142,169,2,2,0,2,4,179,
20221008,701,585,북양양,하조대,165,1,2,0,0,4,172,215,3,1,0,0,4,223,
20221008,701,702,북양양,속초,278,2,2,3,0,10,295,568,1,5,2,0,12,588,
20221008,701,704,북양양,근덕,153,1,6,1,1,5,167,319,3,4,0,1,8,335,
20221008,701,766,북양양,인제,127,1,0,0,0,6,134,168,0,0,0,0,6,174,
20221008,702,174,속초,춘천,311,2,8,0,0,19,340,351,1,4,0,0,20,376,
20221008,702,184,속초,대관령,189,2,1,0,0,6,198,203,2,5,0,0,7,217,
20221008,702,189,속초,강릉,541,23,5,3,12,22,606,654,11,8,2,8,21,704,
20221008,702,284,속초,남양양,414,4,4,3,4,11,440,396,4,3,2,2,18,425,
20221008,702,510,속초,양양,488,4,6,0,0,15,513,756,6,13,2,1,18,796,
20221008,702,554,속초,동홍천,535,8,12,3,8,19,585,801,7,5,10,7,19,849,
20221008,702,580,속초,북강릉,671,21,14,1,7,34,748,659,15,8,1,7,31,721,
20221008,702,583,속초,동해,168,0,0,13,9,6,196,223,0,3,3,19,1,249,
20221008,702,585,속초,하조대,363,0,4,1,0,9,377,264,1,3,0,1,11,280,
20221008,702,701,속초,북양양,568,1,5,2,0,12,588,278,2,2,3,0,10,295,
20221008,702,704,속초,근덕,175,0,7,0,3,9,194,374,2,7,0,6,12,401,
20221008,703,189,삼척,강릉,519,11,8,1,3,23,565,508,4,11,3,1,26,553,
20221008,703,580,삼척,북강릉,196,5,1,0,4,10,216,132,2,1,0,1,7,143,
20221008,703,581,삼척,옥계,249,3,1,0,11,6,270,210,2,5,0,7,6,230,
20221008,703,582,삼척,망상,156,2,2,2,1,6,169,134,0,0,0,5,3,142,
20221008,703,583,삼척,동해,631,3,61,0,0,45,740,505,6,48,2,2,42,605,
20221008,703,584,삼척,남강릉,529,11,3,0,3,24,570,475,6,5,1,2,36,525,
20221008,703,704,삼척,근덕,678,7,9,2,8,31,735,432,8,13,2,28,17,500,
20221008,704,189,근덕,강릉,618,8,13,5,3,16,663,507,10,9,1,3,19,549,
20221008,704,580,근덕,북강릉,274,1,6,3,3,8,295,176,3,7,3,6,4,199,
20221008,704,581,근덕,옥계,371,6,10,4,107,5,503,265,1,5,0,57,10,338,
20221008,704,582,근덕,망상,165,1,1,1,25,6,199,135,1,1,0,20,3,160,
20221008,704,583,근덕,동해,1166,10,39,3,38,66,1322,1126,6,28,6,65,56,1287,
20221008,704,584,근덕,남강릉,713,9,4,4,5,22,757,555,3,7,0,6,24,595,
20221008,704,585,근덕,하조대,288,5,2,1,5,9,310,146,0,4,0,1,10,161,
20221008,704,701,근덕,북양양,319,3,4,0,1,8,335,153,1,6,1,1,5,167,
20221008,704,702,근덕,속초,374,2,7,0,6,12,401,175,0,7,0,3,9,194,
20221008,704,703,근덕,삼척,432,8,13,2,28,17,500,678,7,9,2,8,31,735,
20221008,705,101,남이천,서울,328,9,8,12,8,7,372,381,5,7,9,8,2,412,
20221008,705,102,남이천,동수원,152,2,4,0,0,4,162,96,2,3,0,1,7,109,
20221008,705,173,남이천,양지,95,7,1,6,0,5,114,101,4,1,2,10,4,122,
20221008,705,190,남이천,동서울,1719,39,31,73,57,53,1972,1189,31,28,37,76,40,1401,
20221008,705,191,남이천,경기광주,110,3,2,5,2,4,126,99,2,1,4,0,4,110,
20221008,705,192,남이천,곤지암,622,18,20,16,30,17,723,387,13,14,15,16,11,456,
20221008,705,193,남이천,일죽,198,4,14,21,7,11,255,136,4,12,16,7,9,184,
20221008,705,212,남이천,북수원,131,1,3,2,9,6,152,99,4,1,3,4,0,111,
20221008,705,253,남이천,서서울,153,4,4,15,28,7,211,81,3,2,14,20,3,123,
20221008,705,254,남이천,군자,99,4,8,16,15,5,147,88,1,4,10,10,4,117,
20221008,706,641,남경주,울산,1637,2,9,11,18,73,1750,1564,7,16,8,20,66,1681,
20221008,706,642,남경주,문수,517,2,17,11,23,30,600,646,4,17,12,6,42,727,
20221008,706,643,남경주,청량,207,1,9,22,50,14,303,324,3,11,17,74,19,448,
20221008,706,644,남경주,온양,111,1,2,0,2,4,120,95,0,1,0,1,5,102,
20221008,706,645,남경주,장안,204,1,7,2,3,7,224,195,0,10,2,2,4,213,
20221008,706,646,남경주,기장일광,193,1,0,0,0,8,202,184,1,0,0,0,11,196,
20221008,706,647,남경주,해운대송정,134,0,1,0,0,4,139,129,1,0,1,0,5,136,
20221008,706,648,남경주,해운대,519,0,4,0,0,18,541,878,2,2,0,4,25,911,
20221008,706,707,남경주,남포항,1904,21,49,12,129,87,2202,1640,26,50,17,118,74,1925,
20221008,706,708,남경주,동경주,603,2,5,0,3,25,638,538,3,2,1,4,33,581,
20221008,706,747,남경주,범서,243,0,2,2,3,9,259,272,2,1,0,0,13,288,
20221008,707,139,남포항,서울산,91,0,2,0,3,5,101,127,0,0,0,5,7,139,
20221008,707,252,남포항,대동,123,4,3,0,23,6,159,286,2,10,4,16,20,338,
20221008,707,641,남포항,울산,1914,12,23,18,77,93,2137,2180,14,24,16,107,108,2449,
20221008,707,642,남포항,문수,544,10,5,10,40,29,638,725,9,6,5,21,40,806,
20221008,707,643,남포항,청량,210,1,8,13,193,10,435,400,6,8,13,225,25,677,
20221008,707,644,남포항,온양,104,0,1,5,7,7,124,131,0,1,1,3,4,140,
20221008,707,645,남포항,장안,346,2,2,0,5,8,363,387,1,1,0,2,7,398,
20221008,707,646,남포항,기장일광,250,2,3,1,2,17,275,316,3,2,1,0,16,338,
20221008,707,647,남포항,해운대송정,182,1,0,0,0,3,186,175,0,0,0,0,8,183,
20221008,707,648,남포항,해운대,1382,3,16,2,2,56,1461,1892,8,29,5,25,65,2024,
20221008,707,706,남포항,남경주,1640,26,50,17,118,74,1925,1904,21,49,12,129,87,2202,
20221008,707,707,남포항,남포항,123,1,0,1,1,2,128,123,1,0,1,1,2,128,
20221008,707,708,남포항,동경주,2164,17,15,9,263,98,2566,2205,15,18,11,271,110,2630,
20221008,707,747,남포항,범서,216,3,2,0,5,15,241,369,5,1,1,8,14,398,
20221008,708,641,동경주,울산,198,1,1,0,4,11,215,247,2,0,1,4,14,268,
20221008,708,648,동경주,해운대,105,0,0,0,0,1,106,192,1,2,0,0,6,201,
20221008,708,706,동경주,남경주,538,3,2,1,4,33,581,603,2,5,0,3,25,638,
20221008,708,707,동경주,남포항,2205,15,18,11,271,110,2630,2164,17,15,9,263,98,2566,
20221008,712,207,동상주,남안동,389,5,8,5,7,12,426,286,10,12,7,8,16,339,
20221008,712,713,동상주,서의성,278,5,8,6,5,7,309,250,2,9,5,8,7,281,
20221008,712,716,동상주,청송,128,0,0,0,0,3,131,99,2,2,0,0,4,107,
20221008,712,749,동상주,영덕,440,2,6,1,0,13,462,225,0,0,0,0,7,232,
20221008,713,207,서의성,남안동,135,2,9,3,7,5,161,133,2,7,3,3,6,154,
20221008,713,712,서의성,동상주,250,2,9,5,8,7,281,278,5,8,6,5,7,309,
20221008,714,208,북의성,서안동,96,5,1,1,5,3,111,102,1,2,0,5,3,113,
20221008,714,716,북의성,청송,132,1,0,0,0,6,139,94,2,1,1,4,6,108,
20221008,714,749,북의성,영덕,217,1,2,0,1,10,231,151,1,2,0,2,5,161,
20221008,715,716,동안동,청송,1072,17,5,6,14,43,1157,950,19,3,5,19,48,1044,
20221008,715,748,동안동,동청송영양,163,3,0,3,4,7,180,105,1,3,4,1,4,118,
20221008,715,749,동안동,영덕,1452,8,24,4,66,50,1604,1088,7,21,5,58,42,1221,
20221008,716,127,청송,서대구,164,1,3,0,0,8,176,212,1,2,0,0,5,220,
20221008,716,203,청송,가산,109,2,1,0,0,2,114,197,1,0,0,4,7,209,
20221008,716,712,청송,동상주,99,2,2,0,0,4,107,128,0,0,0,0,3,131,
20221008,716,714,청송,북의성,94,2,1,1,4,6,108,132,1,0,0,0,6,139,
20221008,716,715,청송,동안동,950,19,3,5,19,48,1044,1072,17,5,6,14,43,1157,
20221008,716,748,청송,동청송영양,199,1,0,1,0,4,205,181,1,0,1,4,3,190,
20221008,716,749,청송,영덕,566,2,5,0,1,19,593,406,3,2,0,0,15,426,
20221008,716,775,청송,동명동호,207,2,1,0,0,6,216,191,0,1,0,0,4,196,
20221008,722,138,활천,양산,96,5,7,9,2,4,123,111,9,5,6,3,6,140,
20221008,722,140,활천,부산,206,14,5,0,6,8,239,429,7,5,1,7,16,465,
20221008,722,252,활천,대동,193,8,9,2,20,6,238,347,13,4,4,15,7,390,
20221008,722,641,활천,울산,147,8,2,5,10,2,174,234,8,2,4,7,11,266,
20221008,723,120,북구미,황간,123,1,1,0,0,2,127,96,2,0,0,1,3,102,
20221008,723,122,북구미,김천,400,3,1,0,0,21,425,457,5,4,0,0,23,489,
20221008,723,123,북구미,구미,153,1,0,0,0,10,164,103,1,0,0,0,9,113,
20221008,723,125,북구미,남구미,293,4,1,0,0,17,315,255,6,1,1,0,19,282,
20221008,723,127,북구미,서대구,346,5,2,0,0,23,376,341,3,2,1,0,20,367,
20221008,723,129,북구미,북대구,432,2,1,0,0,12,447,390,3,2,1,2,16,414,
20221008,723,130,북구미,동김천,483,14,2,0,0,20,519,391,2,5,1,1,22,422,
20221008,723,774,북구미,남칠곡,114,1,0,0,0,9,124,104,1,0,0,0,7,112,
20221008,725,129,임고,북대구,170,0,0,0,0,2,172,200,0,0,0,0,6,206,
20221008,725,230,임고,팔공산,146,0,0,0,0,3,149,216,0,0,0,8,6,230,
20221008,730,123,유천,구미,114,1,0,0,0,10,125,148,0,0,0,0,10,158,
20221008,730,125,유천,남구미,128,0,0,0,0,1,129,177,1,0,0,0,6,184,
20221008,730,126,유천,왜관,131,4,0,0,0,9,144,179,9,0,0,0,16,204,
20221008,730,129,유천,북대구,332,0,1,0,0,9,342,415,1,2,0,1,7,426,
20221008,730,131,유천,경산,220,6,0,0,0,6,232,253,13,5,0,1,12,284,
20221008,730,132,유천,영천,102,2,0,0,0,1,105,111,0,1,0,1,2,115,
20221008,730,135,유천,경주,148,0,0,0,0,5,153,182,2,0,0,0,10,194,
20221008,730,201,유천,칠곡,827,5,0,0,0,50,882,720,3,2,0,1,54,780,
20221008,730,203,유천,가산,269,0,0,0,0,12,281,356,4,1,0,2,11,374,
20221008,730,230,유천,팔공산,245,0,0,0,0,9,254,305,3,0,0,0,10,318,
20221008,730,519,유천,남대구,2527,30,4,0,0,165,2726,2213,19,9,1,8,122,2372,
20221008,730,524,유천,청통와촌,93,6,0,0,0,4,103,125,6,0,0,0,5,136,
20221008,730,527,유천,포항,304,0,0,0,0,5,309,307,4,1,0,1,8,321,
20221008,730,621,유천,동대구,120,1,0,0,0,4,125,107,3,0,0,1,4,115,
20221008,731,129,북현풍,북대구,109,2,1,0,0,6,118,135,0,1,0,1,9,146,
20221008,731,201,북현풍,칠곡,217,1,0,0,0,14,232,171,0,0,0,0,18,189,
20221008,731,519,북현풍,남대구,1514,11,2,0,0,90,1617,1638,16,16,0,0,92,1762,
20221008,732,287,행담도,송악,319,5,3,1,0,22,350,380,7,4,2,1,27,421,
20221008,732,288,행담도,당진,188,4,1,0,0,9,202,179,2,0,1,0,13,195,
20221008,732,298,행담도,서산,119,1,0,1,0,0,121,100,1,0,3,1,2,107,
20221008,733,101,옥산,서울,156,7,6,0,0,6,175,158,2,24,0,0,3,187,
20221008,733,108,옥산,천안,237,4,0,0,0,10,251,169,3,0,1,0,7,180,
20221008,735,173,남양평,양지,112,1,0,0,0,5,118,125,1,0,0,0,2,128,
20221008,735,500,남양평,남여주,206,1,0,0,0,7,214,166,1,0,0,0,6,173,
20221008,735,517,남양평,양평,554,2,0,0,0,24,580,258,1,1,0,0,8,268,
20221008,735,597,남양평,서여주,252,6,0,0,0,9,267,358,4,0,0,0,18,380,
20221008,735,598,남양평,북여주,881,13,6,0,1,27,928,1130,6,4,1,0,41,1182,
20221008,736,190,삼성,동서울,412,7,1,0,0,12,432,400,9,0,0,0,9,418,
20221008,736,192,삼성,곤지암,126,1,0,0,0,3,130,129,3,0,0,0,1,133,
20221008,741,101,평택고덕,서울,621,1,23,3,2,37,687,317,3,20,1,2,17,360,
20221008,741,107,평택고덕,안성,202,3,2,2,2,19,230,142,3,0,0,0,15,160,
20221008,741,108,평택고덕,천안,254,1,11,0,2,12,280,193,0,15,0,1,12,221,
20221008,741,253,평택고덕,서서울,1640,18,10,14,8,117,1807,1231,12,7,8,5,76,1339,
20221008,741,254,평택고덕,군자,208,1,0,6,2,14,231,196,6,1,3,4,9,219,
20221008,741,281,평택고덕,매송,204,0,2,0,0,17,223,196,2,0,2,0,19,219,
20221008,741,282,평택고덕,비봉,149,0,3,2,2,12,168,117,2,1,3,1,5,129,
20221008,741,285,평택고덕,서평택,129,1,5,3,21,13,172,157,2,3,0,17,15,194,
20221008,741,287,평택고덕,송악,117,0,0,2,18,15,152,258,2,6,0,47,23,336,
20221008,741,298,평택고덕,서산,91,1,0,0,1,8,101,136,1,2,3,1,7,150,
20221008,741,520,평택고덕,평택,1008,15,63,8,9,78,1181,1145,12,47,7,6,69,1286,
20221008,741,528,평택고덕,기흥동탄,222,0,71,0,0,6,299,241,0,75,0,0,6,322,
20221008,741,540,평택고덕,청북,1010,15,23,32,91,71,1242,883,20,21,32,84,68,1108,
20221008,741,541,평택고덕,송탄,104,2,2,0,5,10,123,85,2,4,5,8,3,107,
20221008,741,543,평택고덕,남안성,133,2,2,4,3,16,160,119,4,6,15,11,18,173,
20221008,741,742,평택고덕,남사진위,203,2,13,1,1,19,239,414,3,15,9,6,20,467,
20221008,742,107,남사진위,안성,1509,20,35,25,8,84,1681,1003,35,39,19,5,66,1167,
20221008,742,108,남사진위,천안,2039,22,19,13,9,81,2183,977,17,16,12,8,44,1074,
20221008,742,110,남사진위,목천,167,1,3,3,3,5,182,91,3,2,14,4,3,117,
20221008,742,111,남사진위,청주,204,4,15,6,3,11,243,191,2,13,5,2,8,221,
20221008,742,113,남사진위,신탄진,140,12,5,3,6,6,172,101,1,4,7,1,6,120,
20221008,742,115,남사진위,대전,125,4,2,0,0,5,136,121,4,3,2,0,1,131,
20221008,742,229,남사진위,북천안,1176,8,6,18,13,51,1272,152,6,2,3,2,11,176,
20221008,742,520,남사진위,평택,191,4,6,12,3,8,224,108,2,5,1,3,6,125,
20221008,742,541,남사진위,송탄,387,12,5,10,7,20,441,122,3,4,10,2,9,150,
20221008,742,542,남사진위,서안성,392,6,13,41,6,20,478,497,10,8,50,7,30,602,
20221008,742,543,남사진위,남안성,426,7,5,4,4,16,462,199,9,15,12,5,8,248,
20221008,742,555,남사진위,북진천,255,6,7,20,5,13,306,218,11,11,24,15,9,288,
20221008,742,601,남사진위,남천안,741,3,3,3,3,21,774,118,1,4,5,6,4,138,
20221008,742,741,남사진위,평택고덕,414,3,15,9,6,20,467,203,2,13,1,1,19,239,
20221008,742,742,남사진위,남사진위,103,0,1,2,0,5,111,103,0,1,2,0,5,111,
20221008,747,641,범서,울산,143,2,7,4,5,9,170,133,2,6,3,2,7,153,
20221008,747,642,범서,문수,149,11,17,25,10,6,218,144,13,17,19,2,7,202,
20221008,747,643,범서,청량,97,12,22,14,36,10,191,119,10,24,15,45,7,220,
20221008,747,706,범서,남경주,272,2,1,0,0,13,288,243,0,2,2,3,9,259,
20221008,747,707,범서,남포항,369,5,1,1,8,14,398,216,3,2,0,5,15,241,
20221008,748,715,동청송영양,동안동,105,1,3,4,1,4,118,163,3,0,3,4,7,180,
20221008,748,716,동청송영양,청송,181,1,0,1,4,3,190,199,1,0,1,0,4,205,
20221008,748,749,동청송영양,영덕,696,8,10,2,11,41,768,811,6,13,6,11,44,891,
20221008,748,775,동청송영양,동명동호,100,0,1,0,2,6,109,105,1,0,0,0,3,109,
20221008,749,127,영덕,서대구,152,0,3,0,0,7,162,329,3,6,0,0,11,349,
20221008,749,203,영덕,가산,194,4,3,1,2,7,211,458,3,3,2,7,11,484,
20221008,749,531,영덕,문의청남대,157,0,1,0,1,4,163,425,2,1,4,0,6,438,
20221008,749,712,영덕,동상주,225,0,0,0,0,7,232,440,2,6,1,0,13,462,
20221008,749,714,영덕,북의성,151,1,2,0,2,5,161,217,1,2,0,1,10,231,
20221008,749,715,영덕,동안동,1088,7,21,5,58,42,1221,1452,8,24,4,66,50,1604,
20221008,749,716,영덕,청송,406,3,2,0,0,15,426,566,2,5,0,1,19,593,
20221008,749,748,영덕,동청송영양,811,6,13,6,11,44,891,696,8,10,2,11,41,768,
20221008,749,775,영덕,동명동호,118,1,0,0,1,4,124,165,0,0,1,5,3,174,
20221008,752,139,기장철마,서울산,127,0,2,0,0,4,133,110,2,1,1,1,5,120,
20221008,752,146,기장철마,동창원,205,1,0,0,1,1,208,135,1,0,0,0,4,140,
20221008,752,250,기장철마,남양산,352,4,2,2,6,24,390,281,3,3,2,3,19,311,
20221008,752,251,기장철마,물금,107,11,4,1,1,7,131,99,8,0,2,4,9,122,
20221008,752,252,기장철마,대동,1939,24,22,8,40,125,2158,1625,21,24,17,48,112,1847,
20221008,752,289,기장철마,마산,483,3,0,3,3,25,517,352,2,3,1,5,10,373,
20221008,752,753,기장철마,금정,414,12,2,18,7,28,481,385,8,6,10,12,35,456,
20221008,752,755,기장철마,광재,254,3,4,3,3,17,284,226,6,6,1,11,13,263,
20221008,752,757,기장철마,진영,182,3,2,4,2,10,203,129,6,3,3,1,5,147,
20221008,753,146,금정,동창원,134,2,2,0,1,5,144,120,2,1,0,0,8,131,
20221008,753,252,금정,대동,903,25,17,23,66,48,1082,1610,37,46,32,129,85,1939,
20221008,753,289,금정,마산,307,1,17,5,8,15,353,370,3,16,4,9,21,423,
20221008,753,752,금정,기장철마,385,8,6,10,12,35,456,414,12,2,18,7,28,481,
20221008,753,755,금정,광재,199,2,5,1,9,9,225,248,0,2,1,10,10,271,
20221008,753,757,금정,진영,134,2,4,2,10,6,158,172,3,3,0,7,10,195,
20221008,754,140,김해가야휴게소,부산,130,2,0,0,0,1,133,159,4,0,0,0,4,167,
20221008,754,754,김해가야휴게소,김해가야휴게소,96,0,0,0,0,9,105,96,0,0,0,0,9,105,
20221008,755,135,광재,경주,123,1,2,3,4,6,139,95,0,2,4,7,9,117,
20221008,755,138,광재,양산,140,9,13,3,9,4,178,126,11,10,3,8,1,159,
20221008,755,140,광재,부산,941,9,9,5,17,54,1035,1110,9,14,6,12,56,1207,
20221008,755,146,광재,동창원,203,13,3,4,34,9,266,141,10,1,1,3,9,165,
20221008,755,250,광재,남양산,356,4,5,2,11,18,396,311,5,9,1,12,25,363,
20221008,755,251,광재,물금,403,14,11,3,12,27,470,377,14,5,8,8,29,441,
20221008,755,252,광재,대동,1750,30,33,30,173,98,2114,1867,26,37,27,143,118,2218,
20221008,755,289,광재,마산,460,22,17,23,23,21,566,444,18,23,13,26,22,546,
20221008,755,641,광재,울산,86,6,1,0,5,6,104,94,4,4,2,7,10,121,
20221008,755,752,광재,기장철마,226,6,6,1,11,13,263,254,3,4,3,3,17,284,
20221008,755,753,광재,금정,248,0,2,1,10,10,271,199,2,5,1,9,9,225,
20221008,755,756,광재,한림,127,10,9,11,30,12,199,122,12,12,9,46,10,211,
20221008,755,757,광재,진영,310,17,23,31,24,13,418,272,15,25,28,27,23,390,
20221008,756,140,한림,부산,239,4,3,6,11,14,277,247,7,4,4,28,18,308,
20221008,756,250,한림,남양산,90,4,8,3,33,5,143,83,6,6,1,45,3,144,
20221008,756,251,한림,물금,97,8,4,2,6,8,125,83,6,4,5,5,6,109,
20221008,756,252,한림,대동,573,19,20,5,108,23,748,492,21,10,9,30,23,585,
20221008,756,755,한림,광재,122,12,12,9,46,10,211,127,10,9,11,30,12,199,
20221008,757,135,진영,경주,98,4,0,1,2,6,111,93,3,1,0,8,5,110,
20221008,757,140,진영,부산,597,4,6,10,3,24,644,715,7,7,8,18,34,789,
20221008,757,238,진영,칠서,17,3,5,3,97,0,125,32,4,5,6,76,0,123,
20221008,757,250,진영,남양산,190,5,8,7,5,6,221,216,1,6,6,4,8,241,
20221008,757,251,진영,물금,233,11,5,4,5,14,272,229,12,4,8,5,14,272,
20221008,757,252,진영,대동,650,18,3,10,39,39,759,571,10,5,7,6,29,628,
20221008,757,289,진영,마산,772,23,22,21,64,40,942,619,12,32,24,107,39,833,
20221008,757,752,진영,기장철마,129,6,3,3,1,5,147,182,3,2,4,2,10,203,
20221008,757,753,진영,금정,172,3,3,0,7,10,195,134,2,4,2,10,6,158,
20221008,757,755,진영,광재,272,15,25,28,27,23,390,310,17,23,31,24,13,418,
20221008,765,174,내촌,춘천,124,2,1,1,2,4,134,126,1,0,3,4,12,146,
20221008,765,554,내촌,동홍천,201,2,8,8,6,13,238,245,4,8,3,7,13,280,
20221008,766,174,인제,춘천,262,1,1,2,2,19,287,254,0,4,0,2,11,271,
20221008,766,510,인제,양양,167,2,1,0,0,6,176,148,3,5,0,1,5,162,
20221008,766,554,인제,동홍천,321,8,12,12,6,20,379,409,8,8,7,1,12,445,
20221008,766,701,인제,북양양,168,0,0,0,0,6,174,127,1,0,0,0,6,134,
20221008,766,766,인제,인제,129,1,0,0,1,8,139,129,1,0,0,1,8,139,
20221008,771,137,배내골,통도사,215,1,4,0,0,10,230,238,4,3,0,0,9,254,
20221008,771,139,배내골,서울산,216,0,1,0,0,6,223,281,0,0,0,0,14,295,
20221008,771,140,배내골,부산,277,1,0,0,0,16,294,459,2,1,0,0,24,486,
20221008,771,252,배내골,대동,174,0,1,0,0,11,186,309,0,0,0,0,16,325,
20221008,772,122,북달성,김천,89,3,6,1,0,3,102,97,1,5,0,0,4,107,
20221008,772,123,북달성,구미,396,7,9,3,2,19,436,376,8,7,3,8,24,426,
20221008,772,125,북달성,남구미,397,5,17,8,7,25,459,338,5,13,4,7,20,387,
20221008,772,126,북달성,왜관,478,17,11,10,3,18,537,417,26,9,5,5,28,490,
20221008,772,129,북달성,북대구,474,5,4,1,0,28,512,403,7,4,1,3,22,440,
20221008,772,131,북달성,경산,200,14,10,7,3,11,245,179,7,6,10,12,8,222,
20221008,772,190,북달성,동서울,91,3,1,2,2,2,101,94,1,0,3,1,4,103,
20221008,772,230,북달성,팔공산,186,4,3,1,0,15,209,122,3,4,0,1,9,139,
20221008,772,518,북달성,칠곡물류,110,7,22,37,7,5,188,122,10,18,36,6,6,198,
20221008,772,527,북달성,포항,237,1,9,0,2,4,253,135,1,12,1,4,4,157,
20221008,772,621,북달성,동대구,254,3,5,2,0,11,275,173,0,6,0,0,8,187,
20221008,772,773,북달성,북다사,280,4,2,4,1,14,305,261,2,0,1,2,11,277,
20221008,772,774,북달성,남칠곡,2470,26,32,16,19,111,2674,2392,33,29,22,19,113,2608,
20221008,773,123,북다사,구미,135,0,1,2,1,7,146,121,2,2,2,1,7,135,
20221008,773,125,북다사,남구미,139,1,0,1,2,8,151,101,0,0,2,2,10,115,
20221008,773,126,북다사,왜관,153,3,3,2,2,10,173,121,6,3,4,1,7,142,
20221008,773,129,북다사,북대구,526,3,6,3,3,25,566,214,2,2,1,3,12,234,
20221008,773,131,북다사,경산,136,11,8,3,1,2,161,99,5,2,3,2,4,115,
20221008,773,772,북다사,북달성,261,2,0,1,2,11,277,280,4,2,4,1,14,305,
20221008,773,774,북다사,남칠곡,1427,13,7,3,11,61,1522,1208,22,11,8,10,55,1314,
20221008,774,122,남칠곡,김천,112,2,2,0,2,4,122,117,2,1,1,2,4,127,
20221008,774,123,남칠곡,구미,433,1,2,5,3,29,473,431,5,4,3,2,34,479,
20221008,774,125,남칠곡,남구미,305,2,2,5,5,28,347,309,6,0,0,7,13,335,
20221008,774,126,남칠곡,왜관,500,16,7,2,11,21,557,433,11,10,8,14,7,483,
20221008,774,127,남칠곡,서대구,144,1,7,0,1,3,156,237,2,6,0,0,8,253,
20221008,774,130,남칠곡,동김천,183,5,3,6,4,7,208,150,2,3,1,9,4,169,
20221008,774,518,남칠곡,칠곡물류,100,15,25,14,7,9,170,116,13,27,20,5,14,195,
20221008,774,723,남칠곡,북구미,104,1,0,0,0,7,112,114,1,0,0,0,9,124,
20221008,774,772,남칠곡,북달성,2392,33,29,22,19,113,2608,2470,26,32,16,19,111,2674,
20221008,774,773,남칠곡,북다사,1208,22,11,8,10,55,1314,1427,13,7,3,11,61,1522,
20221008,775,174,동명동호,춘천,111,1,1,0,0,3,116,90,0,0,0,1,9,100,
20221008,775,202,동명동호,다부,311,3,4,2,3,14,337,480,13,8,3,15,19,538,
20221008,775,203,동명동호,가산,1488,30,15,9,55,53,1650,2246,34,26,22,212,79,2619,
20221008,775,205,동명동호,군위,672,7,3,3,3,20,708,793,2,2,2,6,34,839,
20221008,775,206,동명동호,의성,619,1,2,0,1,25,648,733,3,5,2,7,38,788,
20221008,775,207,동명동호,남안동,1034,13,6,1,2,35,1091,1109,7,7,1,1,38,1163,
20221008,775,208,동명동호,서안동,553,2,4,6,1,18,584,657,5,5,3,7,19,696,
20221008,775,210,동명동호,영주,585,4,7,0,1,12,609,569,6,5,2,4,19,605,
20221008,775,211,동명동호,풍기,176,2,1,0,0,6,185,176,0,2,0,1,4,183,
20221008,775,716,동명동호,청송,191,0,1,0,0,4,196,207,2,1,0,0,6,216,
20221008,775,748,동명동호,동청송영양,105,1,0,0,0,3,109,100,0,1,0,2,6,109,
20221008,775,749,동명동호,영덕,165,0,0,1,5,3,174,118,1,0,0,1,4,124,
20221008,776,131,연경,경산,808,25,22,11,19,45,930,697,30,23,6,13,40,809,
20221008,776,132,연경,영천,272,4,1,1,7,8,293,152,3,5,4,7,9,180,
20221008,776,135,연경,경주,240,3,1,3,0,8,255,264,2,0,1,0,12,279,
20221008,776,621,연경,동대구,441,1,0,1,4,18,465,307,5,2,2,2,6,324,
20221008,776,777,연경,파군재,4740,29,20,12,12,233,5046,3368,22,17,9,9,181,3606,
20221008,776,778,연경,둔산,665,15,16,6,4,29,735,435,19,7,5,5,20,491,
20221008,776,779,연경,율암,6083,59,48,61,242,338,6831,6457,55,56,43,214,344,7169,
20221008,777,131,파군재,경산,201,0,2,5,1,10,219,181,2,2,4,0,6,195,
20221008,777,776,파군재,연경,3368,22,17,9,9,181,3606,4740,29,20,12,12,233,5046,
20221008,777,778,파군재,둔산,182,2,2,0,0,9,195,148,1,0,0,1,9,159,
20221008,777,779,파군재,율암,2767,16,8,8,4,188,2991,2840,14,13,4,5,203,3079,
20221008,778,776,둔산,연경,435,19,7,5,5,20,491,665,15,16,6,4,29,735,
20221008,778,777,둔산,파군재,148,1,0,0,1,9,159,182,2,2,0,0,9,195,
20221008,778,779,둔산,율암,168,4,7,1,1,7,188,232,3,6,7,1,19,268,
20221008,779,131,율암,경산,201,2,2,2,5,16,228,510,6,7,2,9,29,563,
20221008,779,132,율암,영천,236,1,1,0,2,9,249,283,3,2,1,5,18,312,
20221008,779,133,율암,건천,104,2,1,0,0,8,115,182,0,3,1,5,8,199,
20221008,779,135,율암,경주,260,0,1,0,0,7,268,639,7,1,0,0,33,680,
20221008,779,621,율암,동대구,151,1,0,0,0,9,161,113,0,0,0,0,4,117,
20221008,779,776,율암,연경,6457,55,56,43,214,344,7169,6083,59,48,61,242,338,6831,
20221008,779,777,율암,파군재,2840,14,13,4,5,203,3079,2767,16,8,8,4,188,2991,
20221008,779,778,율암,둔산,232,3,6,7,1,19,268,168,4,7,1,1,7,188,
20221008,876,671,양감,봉담,110,3,1,5,7,4,130,110,2,3,2,9,6,132,
20221008,876,673,양감,북오산,267,9,24,4,26,13,343,201,13,2,4,20,5,245,
20221008,876,675,양감,서오산,818,23,10,11,103,45,1010,678,24,4,8,107,38,859,
20221008,876,677,양감,북평택,5035,47,64,51,62,209,5468,3258,60,56,48,64,173,3659,
20221008,981,982,서영암,강진무위사,3601,20,86,44,25,95,3871,2386,25,89,28,25,62,2615,
20221008,981,983,서영암,장흥,947,10,12,6,16,36,1027,731,6,13,3,6,36,795,
20221008,981,984,서영암,보성,255,1,7,1,3,5,272,211,4,5,4,1,1,226,
20221008,981,985,서영암,벌교,418,2,3,4,8,10,445,407,3,8,6,4,9,437,
20221008,981,987,서영암,남순천,2891,22,76,37,125,97,3248,3139,30,87,48,150,80,3534,
20221008,982,981,강진무위사,서영암,2386,25,89,28,25,62,2615,3601,20,86,44,25,95,3871,
20221008,982,985,강진무위사,벌교,152,2,4,0,6,4,168,187,3,5,2,2,6,205,
20221008,982,987,강진무위사,남순천,1236,11,19,16,48,43,1373,1628,15,20,20,79,49,1811,
20221008,983,981,장흥,서영암,731,6,13,3,6,36,795,947,10,12,6,16,36,1027,
20221008,983,984,장흥,보성,281,6,3,1,1,8,300,196,2,4,0,0,8,210,
20221008,983,985,장흥,벌교,127,5,2,1,2,4,141,157,3,2,1,3,6,172,
20221008,983,987,장흥,남순천,1005,5,31,2,15,38,1096,1446,9,33,6,20,42,1556,
20221008,984,981,보성,서영암,211,4,5,4,1,1,226,255,1,7,1,3,5,272,
20221008,984,983,보성,장흥,196,2,4,0,0,8,210,281,6,3,1,1,8,300,
20221008,984,985,보성,벌교,2818,34,48,23,51,71,3045,2000,33,41,9,45,49,2177,
20221008,984,987,보성,남순천,2566,18,49,39,116,63,2851,2916,27,48,28,145,76,3240,
20221008,985,981,벌교,서영암,407,3,8,6,4,9,437,418,2,3,4,8,10,445,
20221008,985,982,벌교,강진무위사,187,3,5,2,2,6,205,152,2,4,0,6,4,168,
20221008,985,983,벌교,장흥,157,3,2,1,3,6,172,127,5,2,1,2,4,141,
20221008,985,984,벌교,보성,2000,33,41,9,45,49,2177,2818,34,48,23,51,71,3045,
20221008,985,987,벌교,남순천,791,9,11,4,9,23,847,1076,8,11,3,11,31,1140,
20221008,986,987,고흥,남순천,4460,41,97,53,123,170,4944,6821,49,98,100,159,229,7456,
20221008,987,981,남순천,서영암,3139,30,87,48,150,80,3534,2891,22,76,37,125,97,3248,
20221008,987,982,남순천,강진무위사,1628,15,20,20,79,49,1811,1236,11,19,16,48,43,1373,
20221008,987,983,남순천,장흥,1446,9,33,6,20,42,1556,1005,5,31,2,15,38,1096,
20221008,987,984,남순천,보성,2916,27,48,28,145,76,3240,2566,18,49,39,116,63,2851,
20221008,987,985,남순천,벌교,1076,8,11,3,11,31,1140,791,9,11,4,9,23,847,
20221008,987,986,남순천,고흥,6821,49,98,100,159,229,7456,4460,41,97,53,123,170,4944,
