집계일자,출발영업소코드,도착영업소코드,출발영업소명,도착영업소명,도착지방향1종교통량,도착지방향2종교통량,도착지방향3종교통량,도착지방향4종교통량,도착지방향5종교통량,도착지방향6종교통량,도착지방향총교통량,출발지방향1종교통량,출발지방향2종교통량,출발지방향3종교통량,출발지방향4종교통량,출발지방향5종교통량,출발지방향6종교통량,출발지방향총교통량,Unnamed: 19
20221001,101,102,서울,동수원,4012,41,211,11,10,210,4495,4016,33,310,14,12,204,4589,
20221001,101,103,서울,수원신갈,14521,395,1010,302,79,614,16921,13576,458,1005,271,84,594,15988,
20221001,101,105,서울,기흥,6395,55,150,56,29,238,6923,5360,69,169,87,29,196,5910,
20221001,101,106,서울,오산,4780,194,322,102,42,223,5663,5307,298,338,114,54,267,6378,
20221001,101,107,서울,안성,3187,48,279,25,5,166,3710,3597,38,278,29,26,187,4155,
20221001,101,108,서울,천안,5692,49,363,29,12,222,6367,5230,35,336,20,14,209,5844,
20221001,101,111,서울,청주,807,11,381,15,8,31,1253,895,6,313,15,6,39,1274,
20221001,101,171,서울,마성,3379,56,108,59,5,140,3747,2914,18,91,50,8,137,3218,
20221001,101,172,서울,용인,2149,52,67,20,7,103,2398,2885,84,70,36,19,169,3263,
20221001,101,173,서울,양지,2212,98,106,42,41,68,2567,4342,268,108,91,64,143,5016,
20221001,101,528,서울,기흥동탄,7286,42,476,112,14,332,8262,6588,36,462,106,10,251,7453,
20221001,101,542,서울,서안성,902,16,73,59,16,37,1103,2290,35,65,129,29,128,2676,
20221001,101,543,서울,남안성,1003,47,32,48,32,36,1198,1229,68,46,65,46,55,1509,
20221001,101,673,서울,북오산,1682,31,97,19,11,94,1934,1726,30,94,20,13,104,1987,
20221001,101,677,서울,북평택,3363,32,116,43,60,116,3730,2267,27,148,35,75,117,2669,
20221001,102,101,동수원,서울,4016,33,310,14,12,204,4589,4012,41,211,11,10,210,4495,
20221001,102,212,동수원,북수원,3266,16,148,3,11,189,3633,3990,24,160,10,8,205,4397,
20221001,102,214,동수원,동군포,1441,18,9,6,2,67,1543,1344,17,14,3,4,63,1445,
20221001,102,215,동수원,군포,1158,14,5,1,7,72,1257,1744,10,11,1,10,98,1874,
20221001,102,253,동수원,서서울,5595,51,36,12,9,296,5999,5639,40,33,13,14,295,6034,
20221001,102,254,동수원,군자,4579,36,38,14,19,211,4897,5350,44,51,35,24,234,5738,
20221001,102,255,동수원,서안산,1280,20,10,3,5,65,1383,1406,24,15,13,4,85,1547,
20221001,103,101,수원신갈,서울,13576,458,1005,271,84,594,15988,14521,395,1010,302,79,614,16921,
20221001,103,105,수원신갈,기흥,2074,17,14,6,12,116,2239,2493,19,3,4,12,98,2629,
20221001,103,108,수원신갈,천안,977,8,34,1,2,37,1059,1087,7,31,2,2,57,1186,
20221001,103,253,수원신갈,서서울,2342,87,62,43,13,125,2672,2570,83,46,40,22,147,2908,
20221001,103,254,수원신갈,군자,2079,74,49,51,34,95,2382,2433,69,48,83,59,115,2807,
20221001,103,528,수원신갈,기흥동탄,1467,5,15,1,3,82,1573,1642,10,9,0,2,86,1749,
20221001,105,101,기흥,서울,5360,69,169,87,29,196,5910,6395,55,150,56,29,238,6923,
20221001,105,103,기흥,수원신갈,2493,19,3,4,12,98,2629,2074,17,14,6,12,116,2239,
20221001,106,101,오산,서울,5307,298,338,114,54,267,6378,4780,194,322,102,42,223,5663,
20221001,106,107,오산,안성,1368,17,15,10,3,100,1513,952,23,12,6,10,66,1069,
20221001,107,101,안성,서울,3597,38,278,29,26,187,4155,3187,48,279,25,5,166,3710,
20221001,107,106,안성,오산,952,23,12,6,10,66,1069,1368,17,15,10,3,100,1513,
20221001,107,108,안성,천안,1776,15,27,5,5,110,1938,1830,20,34,8,2,120,2014,
20221001,107,742,안성,남사진위,1046,28,33,21,7,71,1206,1465,19,33,22,19,78,1636,
20221001,108,101,천안,서울,5230,35,336,20,14,209,5844,5692,49,363,29,12,222,6367,
20221001,108,103,천안,수원신갈,1087,7,31,2,2,57,1186,977,8,34,1,2,37,1059,
20221001,108,107,천안,안성,1830,20,34,8,2,120,2014,1776,15,27,5,5,110,1938,
20221001,108,229,천안,북천안,2308,34,65,23,9,80,2519,2282,52,85,39,30,97,2585,
20221001,108,742,천안,남사진위,994,18,20,10,5,39,1086,2121,21,23,20,4,73,2262,
20221001,111,101,청주,서울,895,6,313,15,6,39,1274,807,11,381,15,8,31,1253,
20221001,112,115,남청주,대전,1270,65,57,5,17,77,1491,1153,72,56,7,4,82,1374,
20221001,114,153,남대전,서대전,1650,26,30,26,6,98,1836,1414,27,42,29,10,82,1604,
20221001,115,112,대전,남청주,1153,72,56,7,4,82,1374,1270,65,57,5,17,77,1491,
20221001,115,116,대전,옥천,2217,76,28,11,10,168,2510,2231,39,37,17,13,154,2491,
20221001,116,115,옥천,대전,2231,39,37,17,13,154,2491,2217,76,28,11,10,168,2510,
20221001,119,153,판암,서대전,1906,19,9,6,77,149,2166,1904,17,17,5,64,144,2151,
20221001,123,127,구미,서대구,1985,20,24,14,4,117,2164,2055,22,26,10,1,116,2230,
20221001,123,129,구미,북대구,2062,10,60,4,3,83,2222,2191,12,55,3,2,96,2359,
20221001,125,127,남구미,서대구,1861,21,40,19,6,108,2055,1928,26,50,19,6,117,2146,
20221001,125,129,남구미,북대구,1645,16,21,9,6,97,1794,1888,9,26,5,5,107,2040,
20221001,126,127,왜관,서대구,2213,78,54,21,48,115,2529,2539,88,55,31,37,119,2869,
20221001,126,129,왜관,북대구,2707,62,37,10,60,138,3014,3270,64,41,13,77,144,3609,
20221001,127,123,서대구,구미,2055,22,26,10,1,116,2230,1985,20,24,14,4,117,2164,
20221001,127,125,서대구,남구미,1928,26,50,19,6,117,2146,1861,21,40,19,6,108,2055,
20221001,127,126,서대구,왜관,2539,88,55,31,37,119,2869,2213,78,54,21,48,115,2529,
20221001,127,131,서대구,경산,2188,91,65,51,42,100,2537,1424,80,54,25,34,86,1703,
20221001,127,203,서대구,가산,2132,21,37,15,25,76,2306,2206,33,34,32,15,93,2413,
20221001,127,527,서대구,포항,2262,24,31,15,36,104,2472,1374,22,23,7,34,66,1526,
20221001,127,621,서대구,동대구,1484,41,66,20,31,81,1723,1030,29,18,14,29,49,1169,
20221001,129,123,북대구,구미,2191,12,55,3,2,96,2359,2062,10,60,4,3,83,2222,
20221001,129,125,북대구,남구미,1888,9,26,5,5,107,2040,1645,16,21,9,6,97,1794,
20221001,129,126,북대구,왜관,3270,64,41,13,77,144,3609,2707,62,37,10,60,138,3014,
20221001,129,131,북대구,경산,1860,63,41,28,25,90,2107,2310,101,60,36,44,122,2673,
20221001,129,527,북대구,포항,2578,21,14,17,31,103,2764,3175,34,29,17,52,153,3460,
20221001,131,127,경산,서대구,1424,80,54,25,34,86,1703,2188,91,65,51,42,100,2537,
20221001,131,129,경산,북대구,2310,101,60,36,44,122,2673,1860,63,41,28,25,90,2107,
20221001,131,230,경산,팔공산,1052,34,34,3,5,67,1195,1210,48,28,8,10,61,1365,
20221001,131,621,경산,동대구,1853,39,32,9,40,93,2066,1790,38,30,12,13,88,1971,
20221001,132,621,영천,동대구,1190,7,26,2,36,53,1314,1362,8,16,0,23,51,1460,
20221001,135,140,경주,부산,2479,7,24,8,11,111,2640,2698,10,19,3,12,110,2852,
20221001,135,252,경주,대동,1936,9,61,19,61,87,2173,2416,15,55,15,37,107,2645,
20221001,135,621,경주,동대구,1251,6,45,0,2,39,1343,1234,2,43,0,0,48,1327,
20221001,137,140,통도사,부산,883,31,12,3,16,55,1000,1044,20,12,4,17,56,1153,
20221001,138,140,양산,부산,3906,182,94,29,74,203,4488,4098,209,109,31,83,189,4719,
20221001,138,252,양산,대동,1798,172,77,65,110,79,2301,1862,168,66,41,118,91,2346,
20221001,139,140,서울산,부산,2068,30,21,8,3,78,2208,2332,32,19,3,5,76,2467,
20221001,139,252,서울산,대동,1212,16,19,13,22,49,1331,1411,18,20,12,13,67,1541,
20221001,139,641,서울산,울산,1378,30,43,12,26,95,1584,1305,18,38,10,15,89,1475,
20221001,140,135,부산,경주,2698,10,19,3,12,110,2852,2479,7,24,8,11,111,2640,
20221001,140,137,부산,통도사,1044,20,12,4,17,56,1153,883,31,12,3,16,55,1000,
20221001,140,138,부산,양산,4098,209,109,31,83,189,4719,3906,182,94,29,74,203,4488,
20221001,140,139,부산,서울산,2332,32,19,3,5,76,2467,2068,30,21,8,3,78,2208,
20221001,140,250,부산,남양산,7902,97,178,16,16,540,8749,7744,96,154,12,13,539,8558,
20221001,140,251,부산,물금,831,109,14,20,26,36,1036,1009,92,18,20,25,46,1210,
20221001,140,252,부산,대동,1058,10,17,16,59,52,1212,1029,17,16,17,58,61,1198,
20221001,140,286,부산,통도사휴게소,1209,7,3,0,0,51,1270,1301,3,2,0,0,37,1343,
20221001,140,289,부산,마산,1671,4,11,4,4,53,1747,1111,12,7,4,1,34,1169,
20221001,142,145,군북,산인,4486,29,58,22,40,262,4897,5503,28,66,24,39,282,5942,
20221001,144,145,함안,산인,2015,26,23,11,83,132,2290,1988,28,26,11,76,124,2253,
20221001,145,142,산인,군북,5503,28,66,24,39,282,5942,4486,29,58,22,40,262,4897,
20221001,145,144,산인,함안,1988,28,26,11,76,124,2253,2015,26,23,11,83,132,2290,
20221001,145,272,산인,광양,2198,8,46,6,18,51,2327,1085,8,37,11,6,32,1179,
20221001,145,291,산인,사천,3101,29,48,8,15,113,3314,2318,47,34,9,9,102,2519,
20221001,145,292,산인,진주,1955,19,143,5,13,99,2234,2032,15,141,5,15,116,2324,
20221001,145,293,산인,문산,1616,17,18,9,2,87,1749,1421,22,12,5,1,67,1528,
20221001,145,295,산인,진성,1239,11,7,3,7,53,1320,1104,11,10,2,8,41,1176,
20221001,146,150,동창원,북부산,1137,13,5,0,3,62,1220,1777,15,6,2,3,90,1893,
20221001,146,244,동창원,서부산,1295,16,19,7,41,84,1462,2239,27,28,23,49,99,2465,
20221001,146,289,동창원,마산,2615,41,38,21,41,195,2951,2204,48,34,14,47,179,2526,
20221001,147,244,진례,서부산,1099,41,26,32,38,86,1322,1188,40,19,24,62,85,1418,
20221001,148,150,서김해,북부산,6282,70,61,39,63,432,6947,6188,83,35,26,45,437,6814,
20221001,148,289,서김해,마산,1855,15,48,8,12,102,2040,1703,23,47,7,15,83,1878,
20221001,149,150,동김해,북부산,10416,136,113,25,47,721,11458,8832,116,108,18,30,595,9699,
20221001,149,250,동김해,남양산,1088,14,56,4,6,85,1253,925,15,45,5,3,74,1067,
20221001,149,251,동김해,물금,1049,36,11,6,3,90,1195,964,34,12,9,5,96,1120,
20221001,149,289,동김해,마산,996,25,30,8,6,58,1123,996,15,26,13,4,56,1110,
20221001,150,146,북부산,동창원,1777,15,6,2,3,90,1893,1137,13,5,0,3,62,1220,
20221001,150,148,북부산,서김해,6188,83,35,26,45,437,6814,6282,70,61,39,63,432,6947,
20221001,150,149,북부산,동김해,8832,116,108,18,30,595,9699,10416,136,113,25,47,721,11458,
20221001,150,245,북부산,장유,4391,28,81,5,39,251,4795,3442,23,74,6,17,225,3787,
20221001,150,289,북부산,마산,5340,19,113,9,14,195,5690,4568,21,88,9,12,192,4890,
20221001,152,154,유성,안영,1087,15,26,5,8,65,1206,995,13,19,9,12,48,1096,
20221001,153,114,서대전,남대전,1414,27,42,29,10,82,1604,1650,26,30,26,6,98,1836,
20221001,153,119,서대전,판암,1904,17,17,5,64,144,2151,1906,19,9,6,77,149,2166,
20221001,153,154,서대전,안영,1097,25,32,21,67,62,1304,1007,27,25,19,54,63,1195,
20221001,154,152,안영,유성,995,13,19,9,12,48,1096,1087,15,26,5,8,65,1206,
20221001,154,153,안영,서대전,1007,27,25,19,54,63,1195,1097,25,32,21,67,62,1304,
20221001,158,167,전주,광주,1023,23,61,21,12,22,1162,1122,27,76,20,8,37,1290,
20221001,159,167,서전주,광주,2216,51,38,27,33,76,2441,2093,51,31,20,28,49,2272,
20221001,163,167,정읍,광주,1001,14,48,17,9,30,1119,953,17,46,15,7,30,1068,
20221001,166,167,장성,광주,1902,60,54,16,18,88,2138,2732,81,55,16,10,106,3000,
20221001,167,158,광주,전주,1122,27,76,20,8,37,1290,1023,23,61,21,12,22,1162,
20221001,167,159,광주,서전주,2093,51,31,20,28,49,2272,2216,51,38,27,33,76,2441,
20221001,167,163,광주,정읍,953,17,46,15,7,30,1068,1001,14,48,17,9,30,1119,
20221001,167,166,광주,장성,2732,81,55,16,10,106,3000,1902,60,54,16,18,88,2138,
20221001,167,567,광주,남고창,1859,19,33,5,7,58,1981,1816,17,32,7,5,57,1934,
20221001,171,101,마성,서울,2914,18,91,50,8,137,3218,3379,56,108,59,5,140,3747,
20221001,171,253,마성,서서울,1083,0,18,1,1,60,1163,1150,6,13,3,6,53,1231,
20221001,172,101,용인,서울,2885,84,70,36,19,169,3263,2149,52,67,20,7,103,2398,
20221001,172,173,용인,양지,2008,74,53,33,19,79,2266,1281,66,56,49,31,91,1574,
20221001,173,101,양지,서울,4342,268,108,91,64,143,5016,2212,98,106,42,41,68,2567,
20221001,173,172,양지,용인,1281,66,56,49,31,91,1574,2008,74,53,33,19,79,2266,
20221001,174,179,춘천,홍천,3868,40,57,16,32,269,4282,3438,55,42,15,30,249,3829,
20221001,174,216,춘천,횡성,1566,35,18,12,13,86,1730,1293,37,16,11,6,71,1434,
20221001,174,218,춘천,남원주,1374,26,50,9,6,70,1535,1429,18,63,15,3,94,1622,
20221001,174,554,춘천,동홍천,1541,12,19,3,5,82,1662,1267,9,12,0,2,82,1372,
20221001,176,190,이천,동서울,1676,27,64,94,44,76,1981,1003,22,37,25,20,49,1156,
20221001,177,190,여주,동서울,1105,12,41,35,18,21,1232,918,14,32,21,12,35,1032,
20221001,179,174,홍천,춘천,3438,55,42,15,30,249,3829,3868,40,57,16,32,269,4282,
20221001,184,189,대관령,강릉,1758,37,49,7,9,79,1939,1761,25,53,2,9,93,1943,
20221001,189,184,강릉,대관령,1761,25,53,2,9,93,1943,1758,37,49,7,9,79,1939,
20221001,190,176,동서울,이천,1003,22,37,25,20,49,1156,1676,27,64,94,44,76,1981,
20221001,190,177,동서울,여주,918,14,32,21,12,35,1032,1105,12,41,35,18,21,1232,
20221001,190,191,동서울,경기광주,8906,270,277,104,145,505,10207,8130,281,281,183,216,510,9601,
20221001,190,192,동서울,곤지암,3762,185,122,77,63,188,4397,4049,241,75,92,51,210,4718,
20221001,190,193,동서울,일죽,2855,49,74,74,63,97,3212,2799,68,83,118,65,101,3234,
20221001,190,194,동서울,서이천,4755,331,239,140,82,227,5774,3488,289,191,104,53,178,4303,
20221001,190,198,동서울,서청주,952,11,13,17,6,36,1035,1423,7,17,9,12,49,1517,
20221001,190,199,동서울,오창,1105,12,7,9,28,37,1198,1193,6,13,6,11,54,1283,
20221001,190,560,동서울,감곡,995,8,14,17,32,37,1103,1028,15,11,11,35,42,1142,
20221001,190,705,동서울,남이천,1556,33,26,33,29,42,1719,1636,30,38,35,17,45,1801,
20221001,191,190,경기광주,동서울,8130,281,281,183,216,510,9601,8906,270,277,104,145,505,10207,
20221001,192,190,곤지암,동서울,4049,241,75,92,51,210,4718,3762,185,122,77,63,188,4397,
20221001,192,194,곤지암,서이천,1984,174,82,73,55,107,2475,1252,97,69,55,48,63,1584,
20221001,193,190,일죽,동서울,2799,68,83,118,65,101,3234,2855,49,74,74,63,97,3212,
20221001,194,190,서이천,동서울,3488,289,191,104,53,178,4303,4755,331,239,140,82,227,5774,
20221001,194,192,서이천,곤지암,1252,97,69,55,48,63,1584,1984,174,82,73,55,107,2475,
20221001,196,198,진천,서청주,939,22,59,14,13,57,1104,869,13,50,12,25,55,1024,
20221001,198,190,서청주,동서울,1423,7,17,9,12,49,1517,952,11,13,17,6,36,1035,
20221001,198,196,서청주,진천,869,13,50,12,25,55,1024,939,22,59,14,13,57,1104,
20221001,199,190,오창,동서울,1193,6,13,6,11,54,1283,1105,12,7,9,28,37,1198,
20221001,203,127,가산,서대구,2206,33,34,32,15,93,2413,2132,21,37,15,25,76,2306,
20221001,203,775,가산,동명동호,2159,32,28,27,345,87,2678,1457,25,16,9,102,46,1655,
20221001,207,775,남안동,동명동호,1174,6,9,5,8,37,1239,1038,8,7,2,6,31,1092,
20221001,212,102,북수원,동수원,3990,24,160,10,8,205,4397,3266,16,148,3,11,189,3633,
20221001,212,253,북수원,서서울,2332,25,21,7,4,101,2490,1029,15,11,6,5,49,1115,
20221001,212,254,북수원,군자,2052,21,20,13,12,107,2225,1619,21,22,15,16,83,1776,
20221001,213,253,부곡,서서울,1337,50,31,21,30,86,1555,1062,48,22,24,37,55,1248,
20221001,213,254,부곡,군자,956,17,15,19,85,46,1138,1061,23,13,19,111,61,1288,
20221001,214,102,동군포,동수원,1344,17,14,3,4,63,1445,1441,18,9,6,2,67,1543,
20221001,215,102,군포,동수원,1744,10,11,1,10,98,1874,1158,14,5,1,7,72,1257,
20221001,215,253,군포,서서울,3507,44,40,27,39,210,3867,4941,89,98,52,78,298,5556,
20221001,215,254,군포,군자,2472,34,37,19,38,143,2743,3675,71,52,71,79,199,4147,
20221001,216,174,횡성,춘천,1293,37,16,11,6,71,1434,1566,35,18,12,13,86,1730,
20221001,218,174,남원주,춘천,1429,18,63,15,3,94,1622,1374,26,50,9,6,70,1535,
20221001,218,240,남원주,제천,2172,30,43,11,47,99,2402,2246,45,38,9,21,111,2470,
20221001,229,108,북천안,천안,2282,52,85,39,30,97,2585,2308,34,65,23,9,80,2519,
20221001,230,131,팔공산,경산,1210,48,28,8,10,61,1365,1052,34,34,3,5,67,1195,
20221001,230,524,팔공산,청통와촌,1129,30,18,4,34,69,1284,886,27,21,5,36,52,1027,
20221001,230,527,팔공산,포항,2875,20,10,4,10,129,3048,2261,31,13,6,13,87,2411,
20221001,231,519,화원옥포,남대구,5490,115,65,23,238,370,6301,5414,94,74,20,214,356,6172,
20221001,232,519,달성,남대구,1886,55,60,14,13,125,2153,1840,59,44,21,8,116,2088,
20221001,233,519,현풍,남대구,3917,101,100,31,78,246,4473,3551,91,88,57,38,230,4055,
20221001,237,239,남지,칠원,936,9,41,11,43,61,1101,954,11,46,10,31,59,1111,
20221001,238,239,칠서,칠원,1078,35,54,47,171,64,1449,1115,46,60,45,138,63,1467,
20221001,239,237,칠원,남지,954,11,46,10,31,59,1111,936,9,41,11,43,61,1101,
20221001,239,238,칠원,칠서,1115,46,60,45,138,63,1467,1078,35,54,47,171,64,1449,
20221001,239,519,칠원,남대구,2150,23,85,18,51,106,2433,2640,29,81,34,30,105,2919,
20221001,240,218,제천,남원주,2246,45,38,9,21,111,2470,2172,30,43,11,47,99,2402,
20221001,241,519,동고령,남대구,3011,52,65,36,76,143,3383,3297,54,56,26,91,144,3668,
20221001,242,519,고령,남대구,2556,28,40,12,104,126,2866,3083,16,31,14,96,129,3369,
20221001,243,519,해인사,남대구,955,2,3,1,2,37,1000,1245,4,3,0,0,40,1292,
20221001,244,146,서부산,동창원,2239,27,28,23,49,99,2465,1295,16,19,7,41,84,1462,
20221001,244,147,서부산,진례,1188,40,19,24,62,85,1418,1099,41,26,32,38,86,1322,
20221001,244,245,서부산,장유,14456,114,310,42,112,961,15995,13723,114,280,58,137,938,15250,
20221001,244,289,서부산,마산,6093,28,287,12,28,215,6663,4465,36,302,13,17,180,5013,
20221001,245,150,장유,북부산,3442,23,74,6,17,225,3787,4391,28,81,5,39,251,4795,
20221001,245,244,장유,서부산,13723,114,280,58,137,938,15250,14456,114,310,42,112,961,15995,
20221001,245,289,장유,마산,1833,9,38,20,19,87,2006,1716,13,36,16,9,91,1881,
20221001,248,261,순창,동광주,1915,17,19,3,49,61,2064,1980,13,20,5,31,65,2114,
20221001,249,261,담양,동광주,3141,25,97,10,13,103,3389,2757,22,96,11,8,103,2997,
20221001,250,140,남양산,부산,7744,96,154,12,13,539,8558,7902,97,178,16,16,540,8749,
20221001,250,149,남양산,동김해,925,15,45,5,3,74,1067,1088,14,56,4,6,85,1253,
20221001,250,252,남양산,대동,3045,97,57,31,52,196,3478,3880,109,83,43,76,250,4441,
20221001,251,140,물금,부산,1009,92,18,20,25,46,1210,831,109,14,20,26,36,1036,
20221001,251,149,물금,동김해,964,34,12,9,5,96,1120,1049,36,11,6,3,90,1195,
20221001,251,252,물금,대동,2685,159,46,56,295,178,3419,3405,163,40,59,321,211,4199,
20221001,252,135,대동,경주,2416,15,55,15,37,107,2645,1936,9,61,19,61,87,2173,
20221001,252,138,대동,양산,1862,168,66,41,118,91,2346,1798,172,77,65,110,79,2301,
20221001,252,139,대동,서울산,1411,18,20,12,13,67,1541,1212,16,19,13,22,49,1331,
20221001,252,140,대동,부산,1029,17,16,17,58,61,1198,1058,10,17,16,59,52,1212,
20221001,252,250,대동,남양산,3880,109,83,43,76,250,4441,3045,97,57,31,52,196,3478,
20221001,252,251,대동,물금,3405,163,40,59,321,211,4199,2685,159,46,56,295,178,3419,
20221001,252,641,대동,울산,1878,33,53,17,34,112,2127,1976,33,53,20,37,94,2213,
20221001,252,752,대동,기장철마,1623,24,18,14,50,102,1831,1895,20,26,12,38,149,2140,
20221001,252,753,대동,금정,1509,44,33,30,88,112,1816,916,23,26,16,62,50,1093,
20221001,252,755,대동,광재,1681,27,32,30,102,127,1999,1622,29,46,37,94,94,1922,
20221001,253,102,서서울,동수원,5639,40,33,13,14,295,6034,5595,51,36,12,9,296,5999,
20221001,253,103,서서울,수원신갈,2570,83,46,40,22,147,2908,2342,87,62,43,13,125,2672,
20221001,253,171,서서울,마성,1150,6,13,3,6,53,1231,1083,0,18,1,1,60,1163,
20221001,253,212,서서울,북수원,1029,15,11,6,5,49,1115,2332,25,21,7,4,101,2490,
20221001,253,213,서서울,부곡,1062,48,22,24,37,55,1248,1337,50,31,21,30,86,1555,
20221001,253,215,서서울,군포,4941,89,98,52,78,298,5556,3507,44,40,27,39,210,3867,
20221001,253,255,서서울,서안산,11350,236,144,148,201,638,12717,11458,219,107,106,193,638,12721,
20221001,253,256,서서울,안산,9209,111,57,37,35,589,10038,6176,76,50,14,35,389,6740,
20221001,253,257,서서울,홍성,1624,6,9,5,3,47,1694,1223,7,14,14,2,50,1310,
20221001,253,259,서서울,대천,1535,5,13,5,0,51,1609,1008,2,12,4,2,27,1055,
20221001,253,281,서서울,매송,4021,52,25,21,34,221,4374,4203,30,13,15,63,220,4544,
20221001,253,282,서서울,비봉,5036,112,88,70,303,249,5858,4783,138,98,75,379,269,5742,
20221001,253,283,서서울,발안,5203,55,44,53,123,258,5736,3790,91,54,64,153,237,4389,
20221001,253,285,서서울,서평택,1224,11,32,45,93,60,1465,1453,27,39,86,172,95,1872,
20221001,253,287,서서울,송악,2033,9,13,18,119,88,2280,2921,12,30,36,264,144,3407,
20221001,253,288,서서울,당진,1477,7,23,16,17,66,1606,2021,8,31,21,26,82,2189,
20221001,253,298,서서울,서산,3612,26,24,21,9,137,3829,3490,14,26,20,24,152,3726,
20221001,253,520,서서울,평택,2942,41,50,39,44,119,3235,2915,39,62,61,66,121,3264,
20221001,253,540,서서울,청북,1155,13,12,19,39,46,1284,896,25,23,46,60,52,1102,
20221001,253,741,서서울,평택고덕,992,8,3,8,8,52,1071,1797,19,7,16,10,130,1979,
20221001,254,102,군자,동수원,5350,44,51,35,24,234,5738,4579,36,38,14,19,211,4897,
20221001,254,103,군자,수원신갈,2433,69,48,83,59,115,2807,2079,74,49,51,34,95,2382,
20221001,254,212,군자,북수원,1619,21,22,15,16,83,1776,2052,21,20,13,12,107,2225,
20221001,254,213,군자,부곡,1061,23,13,19,111,61,1288,956,17,15,19,85,46,1138,
20221001,254,215,군자,군포,3675,71,52,71,79,199,4147,2472,34,37,19,38,143,2743,
20221001,254,255,군자,서안산,10345,176,138,128,215,604,11606,9108,187,103,115,204,495,10212,
20221001,254,256,군자,안산,5186,82,111,39,47,340,5805,5322,73,106,31,35,389,5956,
20221001,254,281,군자,매송,1174,14,10,10,47,69,1324,1024,11,10,8,46,72,1171,
20221001,254,282,군자,비봉,1467,44,34,33,83,53,1714,894,39,13,30,92,43,1111,
20221001,254,283,군자,발안,1922,18,20,22,46,105,2133,1073,22,18,17,35,59,1224,
20221001,255,102,서안산,동수원,1406,24,15,13,4,85,1547,1280,20,10,3,5,65,1383,
20221001,255,253,서안산,서서울,11458,219,107,106,193,638,12721,11350,236,144,148,201,638,12717,
20221001,255,254,서안산,군자,9108,187,103,115,204,495,10212,10345,176,138,128,215,604,11606,
20221001,256,253,안산,서서울,6176,76,50,14,35,389,6740,9209,111,57,37,35,589,10038,
20221001,256,254,안산,군자,5322,73,106,31,35,389,5956,5186,82,111,39,47,340,5805,
20221001,257,253,홍성,서서울,1223,7,14,14,2,50,1310,1624,6,9,5,3,47,1694,
20221001,259,253,대천,서서울,1008,2,12,4,2,27,1055,1535,5,13,5,0,51,1609,
20221001,261,248,동광주,순창,1980,13,20,5,31,65,2114,1915,17,19,3,49,61,2064,
20221001,261,249,동광주,담양,2757,22,96,11,8,103,2997,3141,25,97,10,13,103,3389,
20221001,261,262,동광주,창평,1680,59,21,15,6,49,1830,1740,56,27,26,23,67,1939,
20221001,261,263,동광주,옥과,2854,23,89,8,14,102,3090,2475,17,85,11,22,97,2707,
20221001,261,265,동광주,곡성,2126,15,31,8,20,75,2275,1740,13,26,3,13,72,1867,
20221001,261,270,동광주,서순천,1238,20,50,3,4,33,1348,1258,13,53,6,5,37,1372,
20221001,261,271,동광주,순천,5055,62,78,16,30,145,5386,4823,77,82,14,35,160,5191,
20221001,262,261,창평,동광주,1740,56,27,26,23,67,1939,1680,59,21,15,6,49,1830,
20221001,263,261,옥과,동광주,2475,17,85,11,22,97,2707,2854,23,89,8,14,102,3090,
20221001,265,261,곡성,동광주,1740,13,26,3,13,72,1867,2126,15,31,8,20,75,2275,
20221001,270,261,서순천,동광주,1258,13,53,6,5,37,1372,1238,20,50,3,4,33,1348,
20221001,271,261,순천,동광주,4823,77,82,14,35,160,5191,5055,62,78,16,30,145,5386,
20221001,271,569,순천,북광주,1109,47,13,9,54,24,1256,1278,37,15,20,30,25,1405,
20221001,272,145,광양,산인,1085,8,37,11,6,32,1179,2198,8,46,6,18,51,2327,
20221001,280,519,거창,남대구,1777,20,38,7,4,94,1940,2332,21,46,8,7,108,2522,
20221001,281,253,매송,서서울,4203,30,13,15,63,220,4544,4021,52,25,21,34,221,4374,
20221001,281,254,매송,군자,1024,11,10,8,46,72,1171,1174,14,10,10,47,69,1324,
20221001,282,253,비봉,서서울,4783,138,98,75,379,269,5742,5036,112,88,70,303,249,5858,
20221001,282,254,비봉,군자,894,39,13,30,92,43,1111,1467,44,34,33,83,53,1714,
20221001,283,253,발안,서서울,3790,91,54,64,153,237,4389,5203,55,44,53,123,258,5736,
20221001,283,254,발안,군자,1073,22,18,17,35,59,1224,1922,18,20,22,46,105,2133,
20221001,285,253,서평택,서서울,1453,27,39,86,172,95,1872,1224,11,32,45,93,60,1465,
20221001,286,140,통도사휴게소,부산,1301,3,2,0,0,37,1343,1209,7,3,0,0,51,1270,
20221001,287,253,송악,서서울,2921,12,30,36,264,144,3407,2033,9,13,18,119,88,2280,
20221001,288,253,당진,서서울,2021,8,31,21,26,82,2189,1477,7,23,16,17,66,1606,
20221001,289,140,마산,부산,1111,12,7,4,1,34,1169,1671,4,11,4,4,53,1747,
20221001,289,146,마산,동창원,2204,48,34,14,47,179,2526,2615,41,38,21,41,195,2951,
20221001,289,148,마산,서김해,1703,23,47,7,15,83,1878,1855,15,48,8,12,102,2040,
20221001,289,149,마산,동김해,996,15,26,13,4,56,1110,996,25,30,8,6,58,1123,
20221001,289,150,마산,북부산,4568,21,88,9,12,192,4890,5340,19,113,9,14,195,5690,
20221001,289,244,마산,서부산,4465,36,302,13,17,180,5013,6093,28,287,12,28,215,6663,
20221001,289,245,마산,장유,1716,13,36,16,9,91,1881,1833,9,38,20,19,87,2006,
20221001,291,145,사천,산인,2318,47,34,9,9,102,2519,3101,29,48,8,15,113,3314,
20221001,291,292,사천,진주,2084,42,55,22,24,175,2402,2857,54,55,34,33,214,3247,
20221001,292,145,진주,산인,2032,15,141,5,15,116,2324,1955,19,143,5,13,99,2234,
20221001,292,291,진주,사천,2857,54,55,34,33,214,3247,2084,42,55,22,24,175,2402,
20221001,292,516,진주,통영,1019,7,21,2,0,73,1122,946,22,21,3,3,71,1066,
20221001,293,145,문산,산인,1421,22,12,5,1,67,1528,1616,17,18,9,2,87,1749,
20221001,295,145,진성,산인,1104,11,10,2,8,41,1176,1239,11,7,3,7,53,1320,
20221001,298,253,서산,서서울,3490,14,26,20,24,152,3726,3612,26,24,21,9,137,3829,
20221001,508,509,무안,목포,1131,27,21,15,28,51,1273,1489,22,31,17,25,58,1642,
20221001,508,553,무안,동광산,1515,13,28,13,10,57,1636,2732,29,39,19,26,81,2926,
20221001,509,508,목포,무안,1489,22,31,17,25,58,1642,1131,27,21,15,28,51,1273,
20221001,509,553,목포,동광산,11127,145,194,97,225,355,12143,9760,110,194,121,186,291,10662,
20221001,513,515,고성,북통영,2654,32,67,9,17,129,2908,2620,25,71,5,13,126,2860,
20221001,513,516,고성,통영,6135,55,67,32,69,341,6699,4612,55,68,26,78,280,5119,
20221001,514,516,동고성,통영,1401,12,27,12,38,148,1638,1443,4,24,12,39,159,1681,
20221001,515,513,북통영,고성,2620,25,71,5,13,126,2860,2654,32,67,9,17,129,2908,
20221001,516,292,통영,진주,946,22,21,3,3,71,1066,1019,7,21,2,0,73,1122,
20221001,516,513,통영,고성,4612,55,68,26,78,280,5119,6135,55,67,32,69,341,6699,
20221001,516,514,통영,동고성,1443,4,24,12,39,159,1681,1401,12,27,12,38,148,1638,
20221001,517,597,양평,서여주,950,22,52,59,31,44,1158,842,21,43,38,37,49,1030,
20221001,517,598,양평,북여주,3280,22,14,11,55,126,3508,1851,12,9,7,18,67,1964,
20221001,519,231,남대구,화원옥포,5414,94,74,20,214,356,6172,5490,115,65,23,238,370,6301,
20221001,519,232,남대구,달성,1840,59,44,21,8,116,2088,1886,55,60,14,13,125,2153,
20221001,519,233,남대구,현풍,3551,91,88,57,38,230,4055,3917,101,100,31,78,246,4473,
20221001,519,239,남대구,칠원,2640,29,81,34,30,105,2919,2150,23,85,18,51,106,2433,
20221001,519,241,남대구,동고령,3297,54,56,26,91,144,3668,3011,52,65,36,76,143,3383,
20221001,519,242,남대구,고령,3083,16,31,14,96,129,3369,2556,28,40,12,104,126,2866,
20221001,519,243,남대구,해인사,1245,4,3,0,0,40,1292,955,2,3,1,2,37,1000,
20221001,519,280,남대구,거창,2332,21,46,8,7,108,2522,1777,20,38,7,4,94,1940,
20221001,519,730,남대구,유천,2187,32,13,1,0,127,2360,2582,34,9,0,0,162,2787,
20221001,519,731,남대구,북현풍,1595,18,14,0,1,87,1715,1532,10,4,0,0,102,1648,
20221001,520,253,평택,서서울,2915,39,62,61,66,121,3264,2942,41,50,39,44,119,3235,
20221001,520,540,평택,청북,1250,21,58,32,35,49,1445,1868,16,71,51,45,67,2118,
20221001,520,741,평택,평택고덕,931,10,55,14,11,61,1082,1033,5,58,7,16,86,1205,
20221001,524,230,청통와촌,팔공산,886,27,21,5,36,52,1027,1129,30,18,4,34,69,1284,
20221001,524,527,청통와촌,포항,1039,44,10,4,24,42,1163,1025,30,11,7,17,43,1133,
20221001,526,527,서포항,포항,1237,4,12,0,10,73,1336,1905,10,11,2,7,93,2028,
20221001,527,127,포항,서대구,1374,22,23,7,34,66,1526,2262,24,31,15,36,104,2472,
20221001,527,129,포항,북대구,3175,34,29,17,52,153,3460,2578,21,14,17,31,103,2764,
20221001,527,230,포항,팔공산,2261,31,13,6,13,87,2411,2875,20,10,4,10,129,3048,
20221001,527,524,포항,청통와촌,1025,30,11,7,17,43,1133,1039,44,10,4,24,42,1163,
20221001,527,526,포항,서포항,1905,10,11,2,7,93,2028,1237,4,12,0,10,73,1336,
20221001,527,621,포항,동대구,904,8,65,3,4,35,1019,1026,10,58,1,3,36,1134,
20221001,528,101,기흥동탄,서울,6588,36,462,106,10,251,7453,7286,42,476,112,14,332,8262,
20221001,528,103,기흥동탄,수원신갈,1642,10,9,0,2,86,1749,1467,5,15,1,3,82,1573,
20221001,540,253,청북,서서울,896,25,23,46,60,52,1102,1155,13,12,19,39,46,1284,
20221001,540,520,청북,평택,1868,16,71,51,45,67,2118,1250,21,58,32,35,49,1445,
20221001,542,101,서안성,서울,2290,35,65,129,29,128,2676,902,16,73,59,16,37,1103,
20221001,542,543,서안성,남안성,976,17,41,57,42,62,1195,973,26,44,49,53,65,1210,
20221001,543,101,남안성,서울,1229,68,46,65,46,55,1509,1003,47,32,48,32,36,1198,
20221001,543,542,남안성,서안성,973,26,44,49,53,65,1210,976,17,41,57,42,62,1195,
20221001,543,555,남안성,북진천,841,37,47,70,70,34,1099,718,41,52,59,96,42,1008,
20221001,548,553,북무안,동광산,2276,17,34,13,94,62,2496,3921,25,30,23,105,106,4210,
20221001,549,553,동함평,동광산,3576,27,39,24,57,116,3839,3760,39,52,27,45,154,4077,
20221001,551,553,나주,동광산,1104,10,13,11,31,57,1226,1338,8,7,9,31,67,1460,
20221001,552,553,서광산,동광산,3954,127,110,109,90,115,4505,6289,152,148,120,107,181,6997,
20221001,553,508,동광산,무안,2732,29,39,19,26,81,2926,1515,13,28,13,10,57,1636,
20221001,553,509,동광산,목포,9760,110,194,121,186,291,10662,11127,145,194,97,225,355,12143,
20221001,553,548,동광산,북무안,3921,25,30,23,105,106,4210,2276,17,34,13,94,62,2496,
20221001,553,549,동광산,동함평,3760,39,52,27,45,154,4077,3576,27,39,24,57,116,3839,
20221001,553,551,동광산,나주,1338,8,7,9,31,67,1460,1104,10,13,11,31,57,1226,
20221001,553,552,동광산,서광산,6289,152,148,120,107,181,6997,3954,127,110,109,90,115,4505,
20221001,554,174,동홍천,춘천,1267,9,12,0,2,82,1372,1541,12,19,3,5,82,1662,
20221001,555,543,북진천,남안성,718,41,52,59,96,42,1008,841,37,47,70,70,34,1099,
20221001,556,557,동순천,황전,1276,5,18,6,18,45,1368,1051,9,15,2,17,37,1131,
20221001,556,589,동순천,상관,926,3,22,11,112,19,1093,1281,6,22,14,65,33,1421,
20221001,557,556,황전,동순천,1051,9,15,2,17,37,1131,1276,5,18,6,18,45,1368,
20221001,560,190,감곡,동서울,1028,15,11,11,35,42,1142,995,8,14,17,32,37,1103,
20221001,567,167,남고창,광주,1816,17,32,7,5,57,1934,1859,19,33,5,7,58,1981,
20221001,569,271,북광주,순천,1278,37,15,20,30,25,1405,1109,47,13,9,54,24,1256,
20221001,573,578,예산수덕사,서세종,1191,14,13,9,7,44,1278,1539,12,12,12,9,46,1630,
20221001,578,573,서세종,예산수덕사,1539,12,12,12,9,46,1630,1191,14,13,9,7,44,1278,
20221001,583,704,동해,근덕,1247,4,24,5,58,62,1400,1294,12,23,5,52,69,1455,
20221001,587,589,오수,상관,1164,11,39,20,20,35,1289,1390,9,28,10,69,44,1550,
20221001,589,556,상관,동순천,1281,6,22,14,65,33,1421,926,3,22,11,112,19,1093,
20221001,589,587,상관,오수,1390,9,28,10,69,44,1550,1164,11,39,20,20,35,1289,
20221001,597,517,서여주,양평,842,21,43,38,37,49,1030,950,22,52,59,31,44,1158,
20221001,598,517,북여주,양평,1851,12,9,7,18,67,1964,3280,22,14,11,55,126,3508,
20221001,603,613,정안,남풍세,1239,28,22,27,69,46,1431,1001,15,10,7,27,40,1100,
20221001,613,603,남풍세,정안,1001,15,10,7,27,40,1100,1239,28,22,27,69,46,1431,
20221001,621,127,동대구,서대구,1030,29,18,14,29,49,1169,1484,41,66,20,31,81,1723,
20221001,621,131,동대구,경산,1790,38,30,12,13,88,1971,1853,39,32,9,40,93,2066,
20221001,621,132,동대구,영천,1362,8,16,0,23,51,1460,1190,7,26,2,36,53,1314,
20221001,621,135,동대구,경주,1234,2,43,0,0,48,1327,1251,6,45,0,2,39,1343,
20221001,621,527,동대구,포항,1026,10,58,1,3,36,1134,904,8,65,3,4,35,1019,
20221001,624,626,청도,남밀양,1069,18,13,9,27,45,1181,973,12,12,8,17,42,1064,
20221001,625,626,밀양,남밀양,1750,24,36,24,20,65,1919,2450,33,39,25,34,93,2674,
20221001,626,624,남밀양,청도,973,12,12,8,17,42,1064,1069,18,13,9,27,45,1181,
20221001,626,625,남밀양,밀양,2450,33,39,25,34,93,2674,1750,24,36,24,20,65,1919,
20221001,626,627,남밀양,삼랑진,925,21,21,8,66,90,1131,1120,22,17,9,56,87,1311,
20221001,627,626,삼랑진,남밀양,1120,22,17,9,56,87,1311,925,21,21,8,66,90,1131,
20221001,641,139,울산,서울산,1305,18,38,10,15,89,1475,1378,30,43,12,26,95,1584,
20221001,641,252,울산,대동,1976,33,53,20,37,94,2213,1878,33,53,17,34,112,2127,
20221001,641,648,울산,해운대,1323,6,7,1,12,85,1434,1508,7,8,0,1,93,1617,
20221001,641,706,울산,남경주,1561,6,9,4,10,91,1681,1533,4,6,9,15,78,1645,
20221001,641,707,울산,남포항,2183,14,20,13,107,118,2455,1781,16,17,19,80,105,2018,
20221001,643,648,청량,해운대,3930,15,22,11,112,210,4300,4200,20,59,39,337,215,4870,
20221001,645,648,장안,해운대,1412,8,5,3,7,77,1512,3102,24,13,7,120,152,3418,
20221001,646,648,기장일광,해운대,5063,10,22,2,59,272,5428,6190,20,33,8,71,322,6644,
20221001,648,641,해운대,울산,1508,7,8,0,1,93,1617,1323,6,7,1,12,85,1434,
20221001,648,643,해운대,청량,4200,20,59,39,337,215,4870,3930,15,22,11,112,210,4300,
20221001,648,645,해운대,장안,3102,24,13,7,120,152,3418,1412,8,5,3,7,77,1512,
20221001,648,646,해운대,기장일광,6190,20,33,8,71,322,6644,5063,10,22,2,59,272,5428,
20221001,648,707,해운대,남포항,1857,7,28,10,47,69,2018,1349,2,14,6,18,75,1464,
20221001,651,652,남양주,화도,7387,123,216,240,101,502,8569,8061,152,249,232,68,474,9236,
20221001,651,653,남양주,서종,1677,14,6,5,14,60,1776,2272,15,6,2,19,95,2409,
20221001,651,654,남양주,설악,6240,23,63,10,3,212,6551,4282,21,48,9,5,142,4507,
20221001,651,655,남양주,강촌,4275,23,99,19,12,149,4577,3446,11,99,7,17,121,3701,
20221001,651,656,남양주,남춘천,4325,19,41,18,26,136,4565,2578,9,41,5,9,53,2695,
20221001,652,651,화도,남양주,8061,152,249,232,68,474,9236,7387,123,216,240,101,502,8569,
20221001,652,653,화도,서종,955,17,7,6,3,67,1055,1325,26,4,11,3,81,1450,
20221001,652,654,화도,설악,1661,7,6,6,0,80,1760,1118,13,9,1,3,73,1217,
20221001,653,651,서종,남양주,2272,15,6,2,19,95,2409,1677,14,6,5,14,60,1776,
20221001,653,652,서종,화도,1325,26,4,11,3,81,1450,955,17,7,6,3,67,1055,
20221001,654,651,설악,남양주,4282,21,48,9,5,142,4507,6240,23,63,10,3,212,6551,
20221001,654,652,설악,화도,1118,13,9,1,3,73,1217,1661,7,6,6,0,80,1760,
20221001,655,651,강촌,남양주,3446,11,99,7,17,121,3701,4275,23,99,19,12,149,4577,
20221001,656,651,남춘천,남양주,2578,9,41,5,9,53,2695,4325,19,41,18,26,136,4565,
20221001,671,672,봉담,정남,2695,86,42,35,71,160,3089,2357,75,30,19,151,142,2774,
20221001,671,673,봉담,북오산,1731,31,26,11,17,122,1938,1994,24,40,14,13,121,2206,
20221001,671,677,봉담,북평택,10574,91,99,53,123,433,11373,10563,107,106,45,110,491,11422,
20221001,672,671,정남,봉담,2357,75,30,19,151,142,2774,2695,86,42,35,71,160,3089,
20221001,673,101,북오산,서울,1726,30,94,20,13,104,1987,1682,31,97,19,11,94,1934,
20221001,673,671,북오산,봉담,1994,24,40,14,13,121,2206,1731,31,26,11,17,122,1938,
20221001,673,677,북오산,북평택,2042,12,20,15,11,104,2204,1749,25,28,15,14,85,1916,
20221001,675,676,서오산,향남,2612,48,34,15,76,128,2913,1927,41,26,9,48,99,2150,
20221001,675,677,서오산,북평택,15929,119,175,92,135,695,17145,12524,126,191,87,127,635,13690,
20221001,676,675,향남,서오산,1927,41,26,9,48,99,2150,2612,48,34,15,76,128,2913,
20221001,676,677,향남,북평택,1696,70,42,52,64,77,2001,1321,46,52,68,77,91,1655,
20221001,677,101,북평택,서울,2267,27,148,35,75,117,2669,3363,32,116,43,60,116,3730,
20221001,677,671,북평택,봉담,10563,107,106,45,110,491,11422,10574,91,99,53,123,433,11373,
20221001,677,673,북평택,북오산,1749,25,28,15,14,85,1916,2042,12,20,15,11,104,2204,
20221001,677,675,북평택,서오산,12524,126,191,87,127,635,13690,15929,119,175,92,135,695,17145,
20221001,677,676,북평택,향남,1321,46,52,68,77,91,1655,1696,70,42,52,64,77,2001,
20221001,677,876,북평택,양감,3008,60,48,44,86,143,3389,5216,52,63,49,71,220,5671,
20221001,682,685,조암,서시흥,1585,61,60,72,137,101,2016,1620,47,57,52,148,73,1997,
20221001,683,684,송산마도,남안산,2112,72,74,45,105,120,2528,2033,47,33,26,32,106,2277,
20221001,683,685,송산마도,서시흥,4975,92,85,76,680,252,6160,3817,59,73,69,585,203,4806,
20221001,684,683,남안산,송산마도,2033,47,33,26,32,106,2277,2112,72,74,45,105,120,2528,
20221001,684,685,남안산,서시흥,2964,140,104,194,178,219,3799,4624,144,129,168,155,303,5523,
20221001,685,682,서시흥,조암,1620,47,57,52,148,73,1997,1585,61,60,72,137,101,2016,
20221001,685,683,서시흥,송산마도,3817,59,73,69,585,203,4806,4975,92,85,76,680,252,6160,
20221001,685,684,서시흥,남안산,4624,144,129,168,155,303,5523,2964,140,104,194,178,219,3799,
20221001,704,583,근덕,동해,1294,12,23,5,52,69,1455,1247,4,24,5,58,62,1400,
20221001,705,190,남이천,동서울,1636,30,38,35,17,45,1801,1556,33,26,33,29,42,1719,
20221001,706,641,남경주,울산,1533,4,6,9,15,78,1645,1561,6,9,4,10,91,1681,
20221001,706,707,남경주,남포항,1912,21,50,15,113,81,2192,1568,20,50,26,120,70,1854,
20221001,707,641,남포항,울산,1781,16,17,19,80,105,2018,2183,14,20,13,107,118,2455,
20221001,707,648,남포항,해운대,1349,2,14,6,18,75,1464,1857,7,28,10,47,69,2018,
20221001,707,706,남포항,남경주,1568,20,50,26,120,70,1854,1912,21,50,15,113,81,2192,
20221001,707,708,남포항,동경주,2333,16,18,8,190,97,2662,2231,22,20,16,197,101,2587,
20221001,708,707,동경주,남포항,2231,22,20,16,197,101,2587,2333,16,18,8,190,97,2662,
20221001,715,716,동안동,청송,1101,13,9,6,20,49,1198,1006,17,10,4,18,39,1094,
20221001,715,749,동안동,영덕,1392,5,22,3,18,40,1480,1069,5,19,4,18,42,1157,
20221001,716,715,청송,동안동,1006,17,10,4,18,39,1094,1101,13,9,6,20,49,1198,
20221001,730,519,유천,남대구,2582,34,9,0,0,162,2787,2187,32,13,1,0,127,2360,
20221001,731,519,북현풍,남대구,1532,10,4,0,0,102,1648,1595,18,14,0,1,87,1715,
20221001,741,253,평택고덕,서서울,1797,19,7,16,10,130,1979,992,8,3,8,8,52,1071,
20221001,741,520,평택고덕,평택,1033,5,58,7,16,86,1205,931,10,55,14,11,61,1082,
20221001,742,107,남사진위,안성,1465,19,33,22,19,78,1636,1046,28,33,21,7,71,1206,
20221001,742,108,남사진위,천안,2121,21,23,20,4,73,2262,994,18,20,10,5,39,1086,
20221001,749,715,영덕,동안동,1069,5,19,4,18,42,1157,1392,5,22,3,18,40,1480,
20221001,752,252,기장철마,대동,1895,20,26,12,38,149,2140,1623,24,18,14,50,102,1831,
20221001,753,252,금정,대동,916,23,26,16,62,50,1093,1509,44,33,30,88,112,1816,
20221001,755,252,광재,대동,1622,29,46,37,94,94,1922,1681,27,32,30,102,127,1999,
20221001,772,774,북달성,남칠곡,2366,35,15,13,15,125,2569,2253,29,27,18,21,111,2459,
20221001,773,774,북다사,남칠곡,1304,12,11,7,11,67,1412,1073,19,16,9,9,55,1181,
20221001,774,772,남칠곡,북달성,2253,29,27,18,21,111,2459,2366,35,15,13,15,125,2569,
20221001,774,773,남칠곡,북다사,1073,19,16,9,9,55,1181,1304,12,11,7,11,67,1412,
20221001,775,203,동명동호,가산,1457,25,16,9,102,46,1655,2159,32,28,27,345,87,2678,
20221001,775,207,동명동호,남안동,1038,8,7,2,6,31,1092,1174,6,9,5,8,37,1239,
20221001,776,777,연경,파군재,4339,27,21,6,13,245,4651,3148,23,25,4,7,170,3377,
20221001,776,779,연경,율암,5721,66,48,58,290,343,6526,6022,72,70,43,244,343,6794,
20221001,777,776,파군재,연경,3148,23,25,4,7,170,3377,4339,27,21,6,13,245,4651,
20221001,777,779,파군재,율암,2786,11,15,4,4,176,2996,2848,8,12,3,17,175,3063,
20221001,779,776,율암,연경,6022,72,70,43,244,343,6794,5721,66,48,58,290,343,6526,
20221001,779,777,율암,파군재,2848,8,12,3,17,175,3063,2786,11,15,4,4,176,2996,
20221001,876,677,양감,북평택,5216,52,63,49,71,220,5671,3008,60,48,44,86,143,3389,
20221001,981,982,서영암,강진무위사,3575,30,98,45,24,105,3877,2329,34,86,32,35,69,2585,
20221001,981,987,서영암,남순천,2946,12,53,25,134,97,3267,3153,20,75,44,153,95,3540,
20221001,982,981,강진무위사,서영암,2329,34,86,32,35,69,2585,3575,30,98,45,24,105,3877,
20221001,982,987,강진무위사,남순천,1302,10,33,11,40,41,1437,1772,13,35,5,64,52,1941,
20221001,984,985,보성,벌교,2956,24,36,25,33,71,3145,2044,30,37,13,26,54,2204,
20221001,984,987,보성,남순천,2596,25,50,21,131,67,2890,2912,28,43,32,161,62,3238,
20221001,985,984,벌교,보성,2044,30,37,13,26,54,2204,2956,24,36,25,33,71,3145,
20221001,986,987,고흥,남순천,4266,43,103,62,165,150,4789,7058,57,120,95,189,210,7729,
20221001,987,981,남순천,서영암,3153,20,75,44,153,95,3540,2946,12,53,25,134,97,3267,
20221001,987,982,남순천,강진무위사,1772,13,35,5,64,52,1941,1302,10,33,11,40,41,1437,
20221001,987,984,남순천,보성,2912,28,43,32,161,62,3238,2596,25,50,21,131,67,2890,
20221001,987,986,남순천,고흥,7058,57,120,95,189,210,7729,4266,43,103,62,165,150,4789,
20221002,101,102,서울,동수원,2900,10,166,3,0,145,3224,3520,14,264,14,3,164,3979,
20221002,101,103,서울,수원신갈,11465,215,888,240,41,475,13324,10149,207,858,222,42,440,11918,
20221002,101,105,서울,기흥,4860,21,108,38,6,176,5209,4794,30,156,66,5,156,5207,
20221002,101,106,서울,오산,4549,124,248,60,7,268,5256,4675,128,251,71,6,257,5388,
20221002,101,107,서울,안성,3956,30,257,11,3,184,4441,3129,21,250,17,7,166,3590,
20221002,101,108,서울,천안,5117,19,293,6,3,234,5672,4931,19,315,16,4,200,5485,
20221002,101,111,서울,청주,936,4,253,3,3,28,1227,694,6,306,1,2,28,1037,
20221002,101,171,서울,마성,2574,8,76,49,0,89,2796,2417,7,83,47,0,109,2663,
20221002,101,172,서울,용인,2840,41,54,15,3,166,3119,3314,40,53,19,5,195,3626,
20221002,101,173,서울,양지,2593,49,69,16,20,83,2830,4172,101,79,28,30,130,4540,
20221002,101,528,서울,기흥동탄,5941,13,380,103,0,237,6674,5669,12,387,108,5,246,6427,
20221002,101,542,서울,서안성,1196,12,48,53,7,51,1367,1652,20,53,85,19,72,1901,
20221002,101,543,서울,남안성,1219,28,19,35,6,39,1346,1146,32,20,43,10,38,1289,
20221002,101,601,서울,남천안,938,6,26,2,3,32,1007,1425,6,55,19,5,43,1553,
20221002,101,673,서울,북오산,1534,11,84,10,1,105,1745,1419,12,85,10,1,102,1629,
20221002,101,677,서울,북평택,2401,10,194,22,16,103,2746,2620,13,137,21,15,86,2892,
20221002,102,101,동수원,서울,3520,14,264,14,3,164,3979,2900,10,166,3,0,145,3224,
20221002,102,212,동수원,북수원,2151,10,122,2,0,110,2395,2013,6,122,1,0,107,2249,
20221002,102,253,동수원,서서울,4851,10,26,3,3,247,5140,4928,15,32,4,2,240,5221,
20221002,102,254,동수원,군자,4005,13,25,5,1,157,4206,4948,10,32,5,6,212,5213,
20221002,102,255,동수원,서안산,997,24,4,0,2,48,1075,1174,11,10,5,3,51,1254,
20221002,103,101,수원신갈,서울,10149,207,858,222,42,440,11918,11465,215,888,240,41,475,13324,
20221002,103,105,수원신갈,기흥,1474,3,8,3,8,79,1575,2282,7,3,4,8,120,2424,
20221002,103,253,수원신갈,서서울,1667,44,27,39,1,91,1869,2282,43,36,32,3,116,2512,
20221002,103,254,수원신갈,군자,1543,29,19,17,5,69,1682,2253,39,23,47,8,116,2486,
20221002,105,101,기흥,서울,4794,30,156,66,5,156,5207,4860,21,108,38,6,176,5209,
20221002,105,103,기흥,수원신갈,2282,7,3,4,8,120,2424,1474,3,8,3,8,79,1575,
20221002,106,101,오산,서울,4675,128,251,71,6,257,5388,4549,124,248,60,7,268,5256,
20221002,107,101,안성,서울,3129,21,250,17,7,166,3590,3956,30,257,11,3,184,4441,
20221002,107,108,안성,천안,1799,6,28,2,3,123,1961,1745,11,28,1,1,103,1889,
20221002,107,742,안성,남사진위,975,17,27,10,3,43,1075,1476,8,29,13,3,76,1605,
20221002,108,101,천안,서울,4931,19,315,16,4,200,5485,5117,19,293,6,3,234,5672,
20221002,108,107,천안,안성,1745,11,28,1,1,103,1889,1799,6,28,2,3,123,1961,
20221002,108,229,천안,북천안,1606,18,46,17,9,69,1765,1933,28,55,11,9,97,2133,
20221002,111,101,청주,서울,694,6,306,1,2,28,1037,936,4,253,3,3,28,1227,
20221002,112,115,남청주,대전,929,21,44,2,0,60,1056,953,22,41,1,0,61,1078,
20221002,114,153,남대전,서대전,1509,6,12,16,1,85,1629,1077,6,13,20,2,75,1193,
20221002,115,112,대전,남청주,953,22,41,1,0,61,1078,929,21,44,2,0,60,1056,
20221002,115,116,대전,옥천,1951,9,14,2,0,131,2107,1843,14,14,5,3,121,2000,
20221002,116,115,옥천,대전,1843,14,14,5,3,121,2000,1951,9,14,2,0,131,2107,
20221002,119,153,판암,서대전,1457,9,6,2,0,103,1577,1582,7,8,3,1,111,1712,
20221002,123,127,구미,서대구,1512,10,13,2,0,90,1627,1612,7,12,2,0,86,1719,
20221002,123,129,구미,북대구,1722,5,57,2,0,75,1861,1825,6,50,3,0,88,1972,
20221002,125,127,남구미,서대구,1268,9,32,3,4,75,1391,1513,9,35,4,3,82,1646,
20221002,125,129,남구미,북대구,1288,3,12,0,1,63,1367,1533,4,15,4,0,86,1642,
20221002,126,127,왜관,서대구,1810,19,17,7,1,97,1951,2011,40,21,7,3,97,2179,
20221002,126,129,왜관,북대구,2309,19,15,0,1,91,2435,2601,16,22,2,0,118,2759,
20221002,127,123,서대구,구미,1612,7,12,2,0,86,1719,1512,10,13,2,0,90,1627,
20221002,127,125,서대구,남구미,1513,9,35,4,3,82,1646,1268,9,32,3,4,75,1391,
20221002,127,126,서대구,왜관,2011,40,21,7,3,97,2179,1810,19,17,7,1,97,1951,
20221002,127,131,서대구,경산,1612,37,11,6,9,80,1755,1151,25,6,4,4,61,1251,
20221002,127,135,서대구,경주,1169,3,15,4,2,43,1236,1010,2,12,4,0,33,1061,
20221002,127,203,서대구,가산,1962,9,19,5,1,85,2081,2057,9,10,4,0,77,2157,
20221002,127,527,서대구,포항,2325,9,28,3,12,83,2460,1884,14,16,1,11,76,2002,
20221002,129,123,북대구,구미,1825,6,50,3,0,88,1972,1722,5,57,2,0,75,1861,
20221002,129,125,북대구,남구미,1533,4,15,4,0,86,1642,1288,3,12,0,1,63,1367,
20221002,129,126,북대구,왜관,2601,16,22,2,0,118,2759,2309,19,15,0,1,91,2435,
20221002,129,131,북대구,경산,1190,29,15,8,7,46,1295,1728,38,14,11,5,89,1885,
20221002,129,527,북대구,포항,2740,11,9,7,4,89,2860,3893,17,19,9,10,135,4083,
20221002,131,127,경산,서대구,1151,25,6,4,4,61,1251,1612,37,11,6,9,80,1755,
20221002,131,129,경산,북대구,1728,38,14,11,5,89,1885,1190,29,15,8,7,46,1295,
20221002,131,621,경산,동대구,1442,26,5,1,1,63,1538,1331,14,9,7,2,60,1423,
20221002,132,621,영천,동대구,947,2,18,0,0,33,1000,1180,4,16,0,0,55,1255,
20221002,135,127,경주,서대구,1010,2,12,4,0,33,1061,1169,3,15,4,2,43,1236,
20221002,135,140,경주,부산,2939,4,11,4,2,114,3074,2968,3,19,3,2,120,3115,
20221002,135,252,경주,대동,2138,9,41,12,3,88,2291,2438,8,41,9,5,120,2621,
20221002,135,621,경주,동대구,1436,6,42,1,0,54,1539,1316,0,33,1,0,38,1388,
20221002,137,140,통도사,부산,1027,14,5,0,2,52,1100,1379,3,7,1,0,61,1451,
20221002,138,140,양산,부산,3373,39,43,10,2,127,3594,3428,43,35,10,8,122,3646,
20221002,138,252,양산,대동,1295,25,15,11,57,46,1449,1524,37,19,11,44,57,1692,
20221002,139,140,서울산,부산,2910,3,17,1,0,99,3030,2274,7,10,1,1,86,2379,
20221002,139,252,서울산,대동,1482,5,18,1,2,71,1579,1314,5,5,4,1,72,1401,
20221002,139,641,서울산,울산,2139,8,40,2,3,110,2302,1356,5,45,2,5,68,1481,
20221002,140,135,부산,경주,2968,3,19,3,2,120,3115,2939,4,11,4,2,114,3074,
20221002,140,137,부산,통도사,1379,3,7,1,0,61,1451,1027,14,5,0,2,52,1100,
20221002,140,138,부산,양산,3428,43,35,10,8,122,3646,3373,39,43,10,2,127,3594,
20221002,140,139,부산,서울산,2274,7,10,1,1,86,2379,2910,3,17,1,0,99,3030,
20221002,140,250,부산,남양산,6389,27,131,3,2,418,6970,6425,27,111,10,4,398,6975,
20221002,140,286,부산,통도사휴게소,1408,5,3,0,0,51,1467,1581,1,4,0,0,46,1632,
20221002,140,289,부산,마산,1129,2,6,1,0,46,1184,1298,3,6,1,1,40,1349,
20221002,142,145,군북,산인,5318,11,60,0,8,243,5640,4799,14,30,3,4,214,5064,
20221002,144,145,함안,산인,2118,4,6,3,1,141,2273,2132,5,7,1,1,135,2281,
20221002,145,142,산인,군북,4799,14,30,3,4,214,5064,5318,11,60,0,8,243,5640,
20221002,145,144,산인,함안,2132,5,7,1,1,135,2281,2118,4,6,3,1,141,2273,
20221002,145,272,산인,광양,1292,2,35,3,1,35,1368,1611,7,46,8,3,33,1708,
20221002,145,291,산인,사천,2368,9,28,3,5,99,2512,2829,12,33,4,0,125,3003,
20221002,145,292,산인,진주,1514,5,128,3,3,85,1738,2056,3,140,1,1,119,2320,
20221002,145,293,산인,문산,1283,7,12,1,1,49,1353,1393,6,15,3,2,59,1478,
20221002,146,150,동창원,북부산,1044,2,5,0,0,66,1117,1090,3,5,3,0,58,1159,
20221002,146,244,동창원,서부산,1310,3,13,5,2,74,1407,1493,8,12,3,4,67,1587,
20221002,146,289,동창원,마산,1955,19,10,4,5,125,2118,2317,18,14,3,3,125,2480,
20221002,148,150,서김해,북부산,5642,40,34,8,7,347,6078,5182,33,44,11,3,307,5580,
20221002,148,289,서김해,마산,1583,7,43,4,3,83,1723,1837,5,45,0,4,97,1988,
20221002,149,150,동김해,북부산,8945,86,89,7,6,586,9719,7377,71,66,4,2,500,8020,
20221002,150,146,북부산,동창원,1090,3,5,3,0,58,1159,1044,2,5,0,0,66,1117,
20221002,150,148,북부산,서김해,5182,33,44,11,3,307,5580,5642,40,34,8,7,347,6078,
20221002,150,149,북부산,동김해,7377,71,66,4,2,500,8020,8945,86,89,7,6,586,9719,
20221002,150,245,북부산,장유,3886,8,73,2,10,234,4213,2894,8,68,0,5,161,3136,
20221002,150,289,북부산,마산,3768,4,79,3,7,147,4008,5773,17,134,3,23,196,6146,
20221002,153,114,서대전,남대전,1077,6,13,20,2,75,1193,1509,6,12,16,1,85,1629,
20221002,153,119,서대전,판암,1582,7,8,3,1,111,1712,1457,9,6,2,0,103,1577,
20221002,159,167,서전주,광주,1889,10,25,13,2,47,1986,1780,17,15,4,1,43,1860,
20221002,166,167,장성,광주,2221,17,38,2,5,83,2366,2811,38,37,2,3,93,2984,
20221002,167,159,광주,서전주,1780,17,15,4,1,43,1860,1889,10,25,13,2,47,1986,
20221002,167,166,광주,장성,2811,38,37,2,3,93,2984,2221,17,38,2,5,83,2366,
20221002,167,567,광주,남고창,1807,11,27,9,1,51,1906,2167,6,29,1,1,63,2267,
20221002,171,101,마성,서울,2417,7,83,47,0,109,2663,2574,8,76,49,0,89,2796,
20221002,172,101,용인,서울,3314,40,53,19,5,195,3626,2840,41,54,15,3,166,3119,
20221002,172,173,용인,양지,1124,56,19,13,7,62,1281,1168,36,20,13,8,63,1308,
20221002,172,253,용인,서서울,1031,10,7,10,5,53,1116,1009,17,8,9,6,65,1114,
20221002,173,101,양지,서울,4172,101,79,28,30,130,4540,2593,49,69,16,20,83,2830,
20221002,173,172,양지,용인,1168,36,20,13,8,63,1308,1124,56,19,13,7,62,1281,
20221002,174,179,춘천,홍천,3575,20,32,4,6,233,3870,2978,14,32,1,4,213,3242,
20221002,174,216,춘천,횡성,1160,14,8,4,1,65,1252,1537,20,9,6,7,78,1657,
20221002,174,218,춘천,남원주,1289,9,43,5,3,69,1418,1230,3,55,4,3,49,1344,
20221002,174,554,춘천,동홍천,1081,6,14,3,0,53,1157,1413,5,9,2,0,52,1481,
20221002,176,190,이천,동서울,1352,14,39,10,1,73,1489,1180,10,57,8,3,65,1323,
20221002,177,190,여주,동서울,1222,11,26,14,0,39,1312,1559,5,43,17,1,39,1664,
20221002,179,174,홍천,춘천,2978,14,32,1,4,213,3242,3575,20,32,4,6,233,3870,
20221002,184,189,대관령,강릉,2022,16,45,3,1,88,2175,1985,15,48,1,3,98,2150,
20221002,189,184,강릉,대관령,1985,15,48,1,3,98,2150,2022,16,45,3,1,88,2175,
20221002,190,176,동서울,이천,1180,10,57,8,3,65,1323,1352,14,39,10,1,73,1489,
20221002,190,177,동서울,여주,1559,5,43,17,1,39,1664,1222,11,26,14,0,39,1312,
20221002,190,191,동서울,경기광주,8779,174,242,44,49,455,9743,7684,122,219,33,86,409,8553,
20221002,190,192,동서울,곤지암,3848,133,77,51,17,176,4302,3384,79,50,50,9,132,3704,
20221002,190,193,동서울,일죽,2764,25,64,35,21,122,3031,2850,29,50,54,14,110,3107,
20221002,190,194,동서울,서이천,3839,120,118,75,16,185,4353,3004,46,85,58,14,158,3365,
20221002,190,198,동서울,서청주,1147,3,22,7,1,42,1222,1223,4,20,4,3,39,1293,
20221002,190,199,동서울,오창,1070,3,1,4,8,54,1140,1210,2,4,5,6,47,1274,
20221002,190,560,동서울,감곡,1164,8,7,6,5,37,1227,1330,5,10,8,6,46,1405,
20221002,190,705,동서울,남이천,1439,17,17,16,2,49,1540,1366,30,13,12,5,44,1470,
20221002,191,190,경기광주,동서울,7684,122,219,33,86,409,8553,8779,174,242,44,49,455,9743,
20221002,192,190,곤지암,동서울,3384,79,50,50,9,132,3704,3848,133,77,51,17,176,4302,
20221002,192,194,곤지암,서이천,1465,64,40,29,5,83,1686,1341,27,28,26,5,68,1495,
20221002,193,190,일죽,동서울,2850,29,50,54,14,110,3107,2764,25,64,35,21,122,3031,
20221002,194,190,서이천,동서울,3004,46,85,58,14,158,3365,3839,120,118,75,16,185,4353,
20221002,194,192,서이천,곤지암,1341,27,28,26,5,68,1495,1465,64,40,29,5,83,1686,
20221002,198,190,서청주,동서울,1223,4,20,4,3,39,1293,1147,3,22,7,1,42,1222,
20221002,199,190,오창,동서울,1210,2,4,5,6,47,1274,1070,3,1,4,8,54,1140,
20221002,203,127,가산,서대구,2057,9,10,4,0,77,2157,1962,9,19,5,1,85,2081,
20221002,203,775,가산,동명동호,1982,7,4,3,3,66,2065,1494,10,5,4,4,67,1584,
20221002,207,775,남안동,동명동호,1059,1,6,1,0,35,1102,1007,4,3,1,0,38,1053,
20221002,212,102,북수원,동수원,2013,6,122,1,0,107,2249,2151,10,122,2,0,110,2395,
20221002,212,254,북수원,군자,1870,5,19,11,7,97,2009,1475,6,14,8,5,77,1585,
20221002,213,253,부곡,서서울,1053,32,12,12,3,67,1179,894,32,11,19,3,70,1029,
20221002,215,253,군포,서서울,2897,21,30,5,3,171,3127,2644,19,51,7,7,163,2891,
20221002,215,254,군포,군자,1935,7,22,5,11,90,2070,2091,18,20,11,19,115,2274,
20221002,216,174,횡성,춘천,1537,20,9,6,7,78,1657,1160,14,8,4,1,65,1252,
20221002,218,174,남원주,춘천,1230,3,55,4,3,49,1344,1289,9,43,5,3,69,1418,
20221002,218,240,남원주,제천,1779,9,25,1,7,91,1912,1906,8,26,7,4,95,2046,
20221002,229,108,북천안,천안,1933,28,55,11,9,97,2133,1606,18,46,17,9,69,1765,
20221002,230,525,팔공산,북영천,1023,1,3,1,0,47,1075,1080,2,3,0,1,34,1120,
20221002,230,527,팔공산,포항,2873,8,4,0,2,95,2982,2580,10,6,0,2,84,2682,
20221002,231,519,화원옥포,남대구,4485,25,33,6,5,293,4847,4426,25,24,6,3,300,4784,
20221002,232,519,달성,남대구,1417,22,20,4,4,137,1604,1487,21,12,3,3,118,1644,
20221002,233,519,현풍,남대구,3226,41,39,9,4,182,3501,2957,35,35,21,6,154,3208,
20221002,237,239,남지,칠원,1027,6,44,3,5,62,1147,974,1,37,3,6,59,1080,
20221002,239,237,칠원,남지,974,1,37,3,6,59,1080,1027,6,44,3,5,62,1147,
20221002,239,519,칠원,남대구,2374,13,71,11,2,97,2568,2534,15,72,5,3,93,2722,
20221002,240,218,제천,남원주,1906,8,26,7,4,95,2046,1779,9,25,1,7,91,1912,
20221002,241,519,동고령,남대구,3888,10,56,5,1,150,4110,3203,12,38,5,4,141,3403,
20221002,242,519,고령,남대구,2827,17,31,2,8,115,3000,2925,14,27,5,9,137,3117,
20221002,243,519,해인사,남대구,1181,1,4,1,0,45,1232,1221,2,2,0,0,39,1264,
20221002,244,146,서부산,동창원,1493,8,12,3,4,67,1587,1310,3,13,5,2,74,1407,
20221002,244,245,서부산,장유,13096,51,236,14,23,871,14291,12813,39,223,15,27,839,13956,
20221002,244,289,서부산,마산,4771,16,250,7,10,213,5267,5528,24,286,6,8,202,6054,
20221002,245,150,장유,북부산,2894,8,68,0,5,161,3136,3886,8,73,2,10,234,4213,
20221002,245,244,장유,서부산,12813,39,223,15,27,839,13956,13096,51,236,14,23,871,14291,
20221002,245,289,장유,마산,1539,4,15,6,0,75,1639,2137,5,29,11,0,97,2279,
20221002,248,261,순창,동광주,1874,11,13,1,0,65,1964,2009,3,23,3,2,60,2100,
20221002,249,261,담양,동광주,3441,10,96,1,2,106,3656,3105,10,98,0,2,83,3298,
20221002,250,140,남양산,부산,6425,27,111,10,4,398,6975,6389,27,131,3,2,418,6970,
20221002,250,252,남양산,대동,2264,13,12,4,10,133,2436,3114,32,13,7,8,197,3371,
20221002,251,252,물금,대동,2232,74,13,16,30,134,2499,3195,88,15,13,35,171,3517,
20221002,252,135,대동,경주,2438,8,41,9,5,120,2621,2138,9,41,12,3,88,2291,
20221002,252,138,대동,양산,1524,37,19,11,44,57,1692,1295,25,15,11,57,46,1449,
20221002,252,139,대동,서울산,1314,5,5,4,1,72,1401,1482,5,18,1,2,71,1579,
20221002,252,250,대동,남양산,3114,32,13,7,8,197,3371,2264,13,12,4,10,133,2436,
20221002,252,251,대동,물금,3195,88,15,13,35,171,3517,2232,74,13,16,30,134,2499,
20221002,252,641,대동,울산,2178,6,35,3,2,110,2334,1907,10,28,3,3,104,2055,
20221002,252,752,대동,기장철마,1615,6,10,2,5,115,1753,1762,10,10,1,3,122,1908,
20221002,252,755,대동,광재,1396,13,9,2,4,81,1505,1267,6,12,4,4,68,1361,
20221002,253,102,서서울,동수원,4928,15,32,4,2,240,5221,4851,10,26,3,3,247,5140,
20221002,253,103,서서울,수원신갈,2282,43,36,32,3,116,2512,1667,44,27,39,1,91,1869,
20221002,253,172,서서울,용인,1009,17,8,9,6,65,1114,1031,10,7,10,5,53,1116,
20221002,253,213,서서울,부곡,894,32,11,19,3,70,1029,1053,32,12,12,3,67,1179,
20221002,253,215,서서울,군포,2644,19,51,7,7,163,2891,2897,21,30,5,3,171,3127,
20221002,253,255,서서울,서안산,8795,103,67,64,72,470,9571,8613,110,56,52,79,475,9385,
20221002,253,256,서서울,안산,6957,56,39,11,4,485,7552,4391,42,25,3,13,293,4767,
20221002,253,257,서서울,홍성,1807,2,12,1,1,57,1880,1799,6,9,2,0,47,1863,
20221002,253,259,서서울,대천,1375,1,12,1,0,42,1431,1515,4,7,5,0,50,1581,
20221002,253,281,서서울,매송,2801,7,6,7,3,182,3006,2363,14,6,3,11,149,2546,
20221002,253,282,서서울,비봉,3708,46,31,17,449,200,4451,4447,46,30,16,411,212,5162,
20221002,253,283,서서울,발안,2853,29,12,11,158,174,3237,2992,22,13,10,125,179,3341,
20221002,253,285,서서울,서평택,1893,5,25,28,69,97,2117,2377,10,33,49,86,96,2651,
20221002,253,287,서서울,송악,2487,6,10,7,52,106,2668,4151,8,18,12,84,143,4416,
20221002,253,288,서서울,당진,1908,8,32,0,4,97,2049,2666,7,29,15,7,121,2845,
20221002,253,298,서서울,서산,4563,10,24,14,2,175,4788,3877,17,15,18,4,147,4078,
20221002,253,520,서서울,평택,3720,21,36,18,23,175,3993,3621,15,19,22,22,151,3850,
20221002,253,741,서서울,평택고덕,1503,9,8,6,7,112,1645,1044,9,11,7,5,67,1143,
20221002,254,102,군자,동수원,4948,10,32,5,6,212,5213,4005,13,25,5,1,157,4206,
20221002,254,103,군자,수원신갈,2253,39,23,47,8,116,2486,1543,29,19,17,5,69,1682,
20221002,254,212,군자,북수원,1475,6,14,8,5,77,1585,1870,5,19,11,7,97,2009,
20221002,254,215,군자,군포,2091,18,20,11,19,115,2274,1935,7,22,5,11,90,2070,
20221002,254,255,군자,서안산,6226,66,33,15,36,414,6790,7620,70,32,14,24,455,8215,
20221002,254,256,군자,안산,3994,28,79,11,10,271,4393,4377,27,83,19,15,310,4831,
20221002,255,102,서안산,동수원,1174,11,10,5,3,51,1254,997,24,4,0,2,48,1075,
20221002,255,253,서안산,서서울,8613,110,56,52,79,475,9385,8795,103,67,64,72,470,9571,
20221002,255,254,서안산,군자,7620,70,32,14,24,455,8215,6226,66,33,15,36,414,6790,
20221002,256,253,안산,서서울,4391,42,25,3,13,293,4767,6957,56,39,11,4,485,7552,
20221002,256,254,안산,군자,4377,27,83,19,15,310,4831,3994,28,79,11,10,271,4393,
20221002,257,253,홍성,서서울,1799,6,9,2,0,47,1863,1807,2,12,1,1,57,1880,
20221002,258,259,광천,대천,997,7,8,4,0,26,1042,1084,6,6,3,0,25,1124,
20221002,259,253,대천,서서울,1515,4,7,5,0,50,1581,1375,1,12,1,0,42,1431,
20221002,259,258,대천,광천,1084,6,6,3,0,25,1124,997,7,8,4,0,26,1042,
20221002,261,248,동광주,순창,2009,3,23,3,2,60,2100,1874,11,13,1,0,65,1964,
20221002,261,249,동광주,담양,3105,10,98,0,2,83,3298,3441,10,96,1,2,106,3656,
20221002,261,262,동광주,창평,1644,23,9,10,0,58,1744,1810,10,8,4,0,64,1896,
20221002,261,263,동광주,옥과,2537,6,77,1,3,86,2710,2465,4,80,0,3,84,2636,
20221002,261,265,동광주,곡성,2002,5,30,6,3,62,2108,1995,3,24,4,4,60,2090,
20221002,261,270,동광주,서순천,1002,7,39,1,2,38,1089,948,8,38,1,1,24,1020,
20221002,261,271,동광주,순천,4469,26,51,8,5,108,4667,4219,31,53,6,4,102,4415,
20221002,262,261,창평,동광주,1810,10,8,4,0,64,1896,1644,23,9,10,0,58,1744,
20221002,263,261,옥과,동광주,2465,4,80,0,3,84,2636,2537,6,77,1,3,86,2710,
20221002,265,261,곡성,동광주,1995,3,24,4,4,60,2090,2002,5,30,6,3,62,2108,
20221002,270,261,서순천,동광주,948,8,38,1,1,24,1020,1002,7,39,1,2,38,1089,
20221002,271,261,순천,동광주,4219,31,53,6,4,102,4415,4469,26,51,8,5,108,4667,
20221002,271,569,순천,북광주,1027,7,5,3,13,25,1080,1031,17,2,2,11,25,1088,
20221002,272,145,광양,산인,1611,7,46,8,3,33,1708,1292,2,35,3,1,35,1368,
20221002,280,519,거창,남대구,2178,8,33,0,1,89,2309,2296,11,34,3,2,101,2447,
20221002,281,253,매송,서서울,2363,14,6,3,11,149,2546,2801,7,6,7,3,182,3006,
20221002,282,253,비봉,서서울,4447,46,30,16,411,212,5162,3708,46,31,17,449,200,4451,
20221002,283,253,발안,서서울,2992,22,13,10,125,179,3341,2853,29,12,11,158,174,3237,
20221002,285,253,서평택,서서울,2377,10,33,49,86,96,2651,1893,5,25,28,69,97,2117,
20221002,286,140,통도사휴게소,부산,1581,1,4,0,0,46,1632,1408,5,3,0,0,51,1467,
20221002,287,253,송악,서서울,4151,8,18,12,84,143,4416,2487,6,10,7,52,106,2668,
20221002,288,253,당진,서서울,2666,7,29,15,7,121,2845,1908,8,32,0,4,97,2049,
20221002,289,140,마산,부산,1298,3,6,1,1,40,1349,1129,2,6,1,0,46,1184,
20221002,289,146,마산,동창원,2317,18,14,3,3,125,2480,1955,19,10,4,5,125,2118,
20221002,289,148,마산,서김해,1837,5,45,0,4,97,1988,1583,7,43,4,3,83,1723,
20221002,289,150,마산,북부산,5773,17,134,3,23,196,6146,3768,4,79,3,7,147,4008,
20221002,289,244,마산,서부산,5528,24,286,6,8,202,6054,4771,16,250,7,10,213,5267,
20221002,289,245,마산,장유,2137,5,29,11,0,97,2279,1539,4,15,6,0,75,1639,
20221002,291,145,사천,산인,2829,12,33,4,0,125,3003,2368,9,28,3,5,99,2512,
20221002,291,292,사천,진주,1730,7,20,6,1,125,1889,2164,18,14,6,4,146,2352,
20221002,292,145,진주,산인,2056,3,140,1,1,119,2320,1514,5,128,3,3,85,1738,
20221002,292,291,진주,사천,2164,18,14,6,4,146,2352,1730,7,20,6,1,125,1889,
20221002,292,516,진주,통영,941,3,18,0,0,64,1026,965,6,20,1,0,72,1064,
20221002,293,145,문산,산인,1393,6,15,3,2,59,1478,1283,7,12,1,1,49,1353,
20221002,298,253,서산,서서울,3877,17,15,18,4,147,4078,4563,10,24,14,2,175,4788,
20221002,508,509,무안,목포,1044,13,9,5,2,45,1118,1341,15,7,9,7,41,1420,
20221002,508,553,무안,동광산,1372,6,12,3,0,41,1434,1646,7,13,7,5,45,1723,
20221002,509,508,목포,무안,1341,15,7,9,7,41,1420,1044,13,9,5,2,45,1118,
20221002,509,553,목포,동광산,10726,53,143,42,22,308,11294,10235,43,138,38,23,306,10783,
20221002,513,515,고성,북통영,2689,8,56,2,1,126,2882,3196,8,52,2,2,137,3397,
20221002,513,516,고성,통영,5402,23,50,7,4,260,5746,5673,27,35,6,6,249,5996,
20221002,514,516,동고성,통영,1174,8,14,5,3,108,1312,1140,2,9,4,1,89,1245,
20221002,515,513,북통영,고성,3196,8,52,2,2,137,3397,2689,8,56,2,1,126,2882,
20221002,516,292,통영,진주,965,6,20,1,0,72,1064,941,3,18,0,0,64,1026,
20221002,516,513,통영,고성,5673,27,35,6,6,249,5996,5402,23,50,7,4,260,5746,
20221002,516,514,통영,동고성,1140,2,9,4,1,89,1245,1174,8,14,5,3,108,1312,
20221002,517,598,양평,북여주,1006,1,2,6,1,34,1050,1263,3,4,3,7,55,1335,
20221002,519,231,남대구,화원옥포,4426,25,24,6,3,300,4784,4485,25,33,6,5,293,4847,
20221002,519,232,남대구,달성,1487,21,12,3,3,118,1644,1417,22,20,4,4,137,1604,
20221002,519,233,남대구,현풍,2957,35,35,21,6,154,3208,3226,41,39,9,4,182,3501,
20221002,519,239,남대구,칠원,2534,15,72,5,3,93,2722,2374,13,71,11,2,97,2568,
20221002,519,241,남대구,동고령,3203,12,38,5,4,141,3403,3888,10,56,5,1,150,4110,
20221002,519,242,남대구,고령,2925,14,27,5,9,137,3117,2827,17,31,2,8,115,3000,
20221002,519,243,남대구,해인사,1221,2,2,0,0,39,1264,1181,1,4,1,0,45,1232,
20221002,519,280,남대구,거창,2296,11,34,3,2,101,2447,2178,8,33,0,1,89,2309,
20221002,519,730,남대구,유천,1593,17,11,1,0,88,1710,1864,13,7,1,0,120,2005,
20221002,519,731,남대구,북현풍,1338,5,13,0,0,67,1423,1240,8,1,0,0,63,1312,
20221002,520,253,평택,서서울,3621,15,19,22,22,151,3850,3720,21,36,18,23,175,3993,
20221002,524,527,청통와촌,포항,1116,22,6,1,4,34,1183,1256,23,4,4,2,56,1345,
20221002,525,230,북영천,팔공산,1080,2,3,0,1,34,1120,1023,1,3,1,0,47,1075,
20221002,526,527,서포항,포항,1375,5,10,1,0,66,1457,1568,6,8,1,0,90,1673,
20221002,527,127,포항,서대구,1884,14,16,1,11,76,2002,2325,9,28,3,12,83,2460,
20221002,527,129,포항,북대구,3893,17,19,9,10,135,4083,2740,11,9,7,4,89,2860,
20221002,527,230,포항,팔공산,2580,10,6,0,2,84,2682,2873,8,4,0,2,95,2982,
20221002,527,524,포항,청통와촌,1256,23,4,4,2,56,1345,1116,22,6,1,4,34,1183,
20221002,527,526,포항,서포항,1568,6,8,1,0,90,1673,1375,5,10,1,0,66,1457,
20221002,527,621,포항,동대구,930,2,59,1,0,28,1020,995,4,59,1,0,28,1087,
20221002,528,101,기흥동탄,서울,5669,12,387,108,5,246,6427,5941,13,380,103,0,237,6674,
20221002,542,101,서안성,서울,1652,20,53,85,19,72,1901,1196,12,48,53,7,51,1367,
20221002,543,101,남안성,서울,1146,32,20,43,10,38,1289,1219,28,19,35,6,39,1346,
20221002,547,553,무안공항,동광산,1397,3,4,1,1,22,1428,976,2,4,1,0,17,1000,
20221002,548,553,북무안,동광산,3243,13,23,14,5,93,3391,3586,15,27,8,3,90,3729,
20221002,549,553,동함평,동광산,3730,12,24,1,9,116,3892,3620,13,21,7,14,109,3784,
20221002,551,553,나주,동광산,1219,4,5,0,3,41,1272,1086,3,8,3,1,44,1145,
20221002,552,553,서광산,동광산,3136,42,69,50,17,98,3412,3888,43,89,48,19,121,4208,
20221002,553,508,동광산,무안,1646,7,13,7,5,45,1723,1372,6,12,3,0,41,1434,
20221002,553,509,동광산,목포,10235,43,138,38,23,306,10783,10726,53,143,42,22,308,11294,
20221002,553,547,동광산,무안공항,976,2,4,1,0,17,1000,1397,3,4,1,1,22,1428,
20221002,553,548,동광산,북무안,3586,15,27,8,3,90,3729,3243,13,23,14,5,93,3391,
20221002,553,549,동광산,동함평,3620,13,21,7,14,109,3784,3730,12,24,1,9,116,3892,
20221002,553,551,동광산,나주,1086,3,8,3,1,44,1145,1219,4,5,0,3,41,1272,
20221002,553,552,동광산,서광산,3888,43,89,48,19,121,4208,3136,42,69,50,17,98,3412,
20221002,554,174,동홍천,춘천,1413,5,9,2,0,52,1481,1081,6,14,3,0,53,1157,
20221002,556,557,동순천,황전,1549,5,16,4,2,30,1606,1238,7,8,1,1,32,1287,
20221002,556,589,동순천,상관,1125,4,8,2,50,18,1207,1186,1,7,2,36,21,1253,
20221002,557,556,황전,동순천,1238,7,8,1,1,32,1287,1549,5,16,4,2,30,1606,
20221002,560,190,감곡,동서울,1330,5,10,8,6,46,1405,1164,8,7,6,5,37,1227,
20221002,567,167,남고창,광주,2167,6,29,1,1,63,2267,1807,11,27,9,1,51,1906,
20221002,569,271,북광주,순천,1031,17,2,2,11,25,1088,1027,7,5,3,13,25,1080,
20221002,573,578,예산수덕사,서세종,1296,10,6,4,6,44,1366,1212,3,5,1,2,30,1253,
20221002,578,573,서세종,예산수덕사,1212,3,5,1,2,30,1253,1296,10,6,4,6,44,1366,
20221002,583,704,동해,근덕,1023,2,26,3,12,58,1124,1189,8,29,4,13,61,1304,
20221002,587,589,오수,상관,1096,4,19,7,6,28,1160,1144,4,21,12,6,28,1215,
20221002,589,556,상관,동순천,1186,1,7,2,36,21,1253,1125,4,8,2,50,18,1207,
20221002,589,587,상관,오수,1144,4,21,12,6,28,1215,1096,4,19,7,6,28,1160,
20221002,597,598,서여주,북여주,890,17,90,14,0,43,1054,1040,12,34,10,1,42,1139,
20221002,598,517,북여주,양평,1263,3,4,3,7,55,1335,1006,1,2,6,1,34,1050,
20221002,598,597,북여주,서여주,1040,12,34,10,1,42,1139,890,17,90,14,0,43,1054,
20221002,601,101,남천안,서울,1425,6,55,19,5,43,1553,938,6,26,2,3,32,1007,
20221002,621,131,동대구,경산,1331,14,9,7,2,60,1423,1442,26,5,1,1,63,1538,
20221002,621,132,동대구,영천,1180,4,16,0,0,55,1255,947,2,18,0,0,33,1000,
20221002,621,135,동대구,경주,1316,0,33,1,0,38,1388,1436,6,42,1,0,54,1539,
20221002,621,527,동대구,포항,995,4,59,1,0,28,1087,930,2,59,1,0,28,1020,
20221002,624,626,청도,남밀양,1150,7,4,9,8,48,1226,1141,4,6,4,7,49,1211,
20221002,625,626,밀양,남밀양,2362,16,4,11,4,99,2496,2237,10,6,12,6,95,2366,
20221002,626,624,남밀양,청도,1141,4,6,4,7,49,1211,1150,7,4,9,8,48,1226,
20221002,626,625,남밀양,밀양,2237,10,6,12,6,95,2366,2362,16,4,11,4,99,2496,
20221002,641,139,울산,서울산,1356,5,45,2,5,68,1481,2139,8,40,2,3,110,2302,
20221002,641,252,울산,대동,1907,10,28,3,3,104,2055,2178,6,35,3,2,110,2334,
20221002,641,648,울산,해운대,1151,2,2,0,0,70,1225,1444,3,2,0,1,82,1532,
20221002,641,706,울산,남경주,1469,0,2,1,1,64,1537,1686,1,2,2,1,73,1765,
20221002,641,707,울산,남포항,1919,8,24,1,14,102,2068,2149,7,22,5,17,109,2309,
20221002,643,648,청량,해운대,3265,7,17,1,2,172,3464,4263,9,53,7,17,225,4574,
20221002,645,648,장안,해운대,1229,1,6,1,0,55,1292,3227,5,12,3,0,155,3402,
20221002,646,648,기장일광,해운대,4604,4,4,0,3,225,4840,6181,15,11,2,17,275,6501,
20221002,648,641,해운대,울산,1444,3,2,0,1,82,1532,1151,2,2,0,0,70,1225,
20221002,648,643,해운대,청량,4263,9,53,7,17,225,4574,3265,7,17,1,2,172,3464,
20221002,648,645,해운대,장안,3227,5,12,3,0,155,3402,1229,1,6,1,0,55,1292,
20221002,648,646,해운대,기장일광,6181,15,11,2,17,275,6501,4604,4,4,0,3,225,4840,
20221002,648,707,해운대,남포항,1743,7,23,5,10,71,1859,1319,2,4,6,0,56,1387,
20221002,651,652,남양주,화도,8271,80,232,155,38,504,9280,11019,102,244,187,41,554,12147,
20221002,651,653,남양주,서종,1956,3,3,3,40,74,2079,5527,10,13,2,46,188,5786,
20221002,651,654,남양주,설악,4719,11,54,0,2,177,4963,5097,5,53,4,1,188,5348,
20221002,651,655,남양주,강촌,3334,11,92,10,7,112,3566,3209,4,81,13,7,115,3429,
20221002,651,656,남양주,남춘천,3247,6,34,3,3,91,3384,2103,5,16,3,3,42,2172,
20221002,652,651,화도,남양주,11019,102,244,187,41,554,12147,8271,80,232,155,38,504,9280,
20221002,652,653,화도,서종,1035,8,2,3,1,68,1117,2146,11,4,10,3,99,2273,
20221002,652,654,화도,설악,1228,6,7,1,0,49,1291,1115,6,3,5,2,53,1184,
20221002,653,651,서종,남양주,5527,10,13,2,46,188,5786,1956,3,3,3,40,74,2079,
20221002,653,652,서종,화도,2146,11,4,10,3,99,2273,1035,8,2,3,1,68,1117,
20221002,654,651,설악,남양주,5097,5,53,4,1,188,5348,4719,11,54,0,2,177,4963,
20221002,654,652,설악,화도,1115,6,3,5,2,53,1184,1228,6,7,1,0,49,1291,
20221002,655,651,강촌,남양주,3209,4,81,13,7,115,3429,3334,11,92,10,7,112,3566,
20221002,656,651,남춘천,남양주,2103,5,16,3,3,42,2172,3247,6,34,3,3,91,3384,
20221002,671,672,봉담,정남,1380,19,14,9,7,69,1498,1663,20,17,12,15,84,1811,
20221002,671,673,봉담,북오산,1392,8,6,3,5,88,1502,1580,13,17,7,5,84,1706,
20221002,671,677,봉담,북평택,8629,36,56,22,12,412,9167,9297,32,42,22,16,363,9772,
20221002,672,671,정남,봉담,1663,20,17,12,15,84,1811,1380,19,14,9,7,69,1498,
20221002,673,101,북오산,서울,1419,12,85,10,1,102,1629,1534,11,84,10,1,105,1745,
20221002,673,671,북오산,봉담,1580,13,17,7,5,84,1706,1392,8,6,3,5,88,1502,
20221002,673,677,북오산,북평택,2187,8,10,4,2,103,2314,1743,9,13,1,1,87,1854,
20221002,675,676,서오산,향남,1390,20,5,0,18,82,1515,1184,17,12,3,18,66,1300,
20221002,675,677,서오산,북평택,10640,54,114,25,48,539,11420,13426,61,102,42,37,551,14219,
20221002,676,675,향남,서오산,1184,17,12,3,18,66,1300,1390,20,5,0,18,82,1515,
20221002,676,677,향남,북평택,1309,19,20,25,29,66,1468,2099,22,24,26,15,92,2278,
20221002,677,101,북평택,서울,2620,13,137,21,15,86,2892,2401,10,194,22,16,103,2746,
20221002,677,671,북평택,봉담,9297,32,42,22,16,363,9772,8629,36,56,22,12,412,9167,
20221002,677,673,북평택,북오산,1743,9,13,1,1,87,1854,2187,8,10,4,2,103,2314,
20221002,677,675,북평택,서오산,13426,61,102,42,37,551,14219,10640,54,114,25,48,539,11420,
20221002,677,676,북평택,향남,2099,22,24,26,15,92,2278,1309,19,20,25,29,66,1468,
20221002,677,876,북평택,양감,3837,25,17,10,11,141,4041,958,9,13,5,8,68,1061,
20221002,682,685,조암,서시흥,1073,21,10,9,40,47,1200,1271,19,16,8,17,66,1397,
20221002,683,684,송산마도,남안산,1600,23,18,8,12,100,1761,1723,24,9,11,8,100,1875,
20221002,683,685,송산마도,서시흥,5130,34,38,25,121,254,5602,5404,42,32,30,110,266,5884,
20221002,684,683,남안산,송산마도,1723,24,9,11,8,100,1875,1600,23,18,8,12,100,1761,
20221002,684,685,남안산,서시흥,2217,94,71,133,137,159,2811,4169,95,78,93,152,264,4851,
20221002,685,682,서시흥,조암,1271,19,16,8,17,66,1397,1073,21,10,9,40,47,1200,
20221002,685,683,서시흥,송산마도,5404,42,32,30,110,266,5884,5130,34,38,25,121,254,5602,
20221002,685,684,서시흥,남안산,4169,95,78,93,152,264,4851,2217,94,71,133,137,159,2811,
20221002,704,583,근덕,동해,1189,8,29,4,13,61,1304,1023,2,26,3,12,58,1124,
20221002,705,190,남이천,동서울,1366,30,13,12,5,44,1470,1439,17,17,16,2,49,1540,
20221002,706,641,남경주,울산,1686,1,2,2,1,73,1765,1469,0,2,1,1,64,1537,
20221002,706,707,남경주,남포항,1921,8,29,4,13,90,2065,2020,10,30,4,12,95,2171,
20221002,707,641,남포항,울산,2149,7,22,5,17,109,2309,1919,8,24,1,14,102,2068,
20221002,707,648,남포항,해운대,1319,2,4,6,0,56,1387,1743,7,23,5,10,71,1859,
20221002,707,706,남포항,남경주,2020,10,30,4,12,95,2171,1921,8,29,4,13,90,2065,
20221002,707,708,남포항,동경주,2490,9,6,3,8,95,2611,2529,10,6,4,7,103,2659,
20221002,708,707,동경주,남포항,2529,10,6,4,7,103,2659,2490,9,6,3,8,95,2611,
20221002,715,749,동안동,영덕,1469,2,20,2,1,48,1542,1560,8,14,1,1,41,1625,
20221002,730,519,유천,남대구,1864,13,7,1,0,120,2005,1593,17,11,1,0,88,1710,
20221002,731,519,북현풍,남대구,1240,8,1,0,0,63,1312,1338,5,13,0,0,67,1423,
20221002,741,253,평택고덕,서서울,1044,9,11,7,5,67,1143,1503,9,8,6,7,112,1645,
20221002,742,107,남사진위,안성,1476,8,29,13,3,76,1605,975,17,27,10,3,43,1075,
20221002,749,715,영덕,동안동,1560,8,14,1,1,41,1625,1469,2,20,2,1,48,1542,
20221002,752,252,기장철마,대동,1762,10,10,1,3,122,1908,1615,6,10,2,5,115,1753,
20221002,755,252,광재,대동,1267,6,12,4,4,68,1361,1396,13,9,2,4,81,1505,
20221002,772,774,북달성,남칠곡,2099,10,11,5,2,87,2214,2527,12,14,8,1,100,2662,
20221002,773,774,북다사,남칠곡,1086,3,2,0,2,41,1134,1183,2,2,0,2,45,1234,
20221002,774,772,남칠곡,북달성,2527,12,14,8,1,100,2662,2099,10,11,5,2,87,2214,
20221002,774,773,남칠곡,북다사,1183,2,2,0,2,45,1234,1086,3,2,0,2,41,1134,
20221002,775,203,동명동호,가산,1494,10,5,4,4,67,1584,1982,7,4,3,3,66,2065,
20221002,775,207,동명동호,남안동,1007,4,3,1,0,38,1053,1059,1,6,1,0,35,1102,
20221002,776,777,연경,파군재,4219,8,7,5,1,196,4436,3559,5,4,3,0,148,3719,
20221002,776,779,연경,율암,4513,19,30,19,17,236,4834,4710,13,33,19,16,255,5046,
20221002,777,776,파군재,연경,3559,5,4,3,0,148,3719,4219,8,7,5,1,196,4436,
20221002,777,779,파군재,율암,2809,1,5,1,1,168,2985,2822,0,3,2,0,166,2993,
20221002,779,776,율암,연경,4710,13,33,19,16,255,5046,4513,19,30,19,17,236,4834,
20221002,779,777,율암,파군재,2822,0,3,2,0,166,2993,2809,1,5,1,1,168,2985,
20221002,876,677,양감,북평택,958,9,13,5,8,68,1061,3837,25,17,10,11,141,4041,
20221002,981,982,서영암,강진무위사,2157,11,56,30,12,62,2328,3256,18,82,29,12,80,3477,
20221002,981,987,서영암,남순천,2798,13,59,16,31,88,3005,2876,9,50,18,19,74,3046,
20221002,982,981,강진무위사,서영암,3256,18,82,29,12,80,3477,2157,11,56,30,12,62,2328,
20221002,982,987,강진무위사,남순천,1518,9,34,11,13,34,1619,1240,6,34,3,7,31,1321,
20221002,983,987,장흥,남순천,1138,2,43,1,4,29,1217,1139,10,29,2,13,25,1218,
20221002,984,985,보성,벌교,2357,11,17,5,8,60,2458,2604,14,19,9,11,62,2719,
20221002,984,987,보성,남순천,2846,11,34,38,37,62,3028,2692,13,26,9,45,64,2849,
20221002,985,984,벌교,보성,2604,14,19,9,11,62,2719,2357,11,17,5,8,60,2458,
20221002,986,987,고흥,남순천,5627,22,93,49,21,166,5978,4954,30,75,26,19,154,5258,
20221002,987,981,남순천,서영암,2876,9,50,18,19,74,3046,2798,13,59,16,31,88,3005,
20221002,987,982,남순천,강진무위사,1240,6,34,3,7,31,1321,1518,9,34,11,13,34,1619,
20221002,987,983,남순천,장흥,1139,10,29,2,13,25,1218,1138,2,43,1,4,29,1217,
20221002,987,984,남순천,보성,2692,13,26,9,45,64,2849,2846,11,34,38,37,62,3028,
20221002,987,986,남순천,고흥,4954,30,75,26,19,154,5258,5627,22,93,49,21,166,5978,
20221003,101,102,서울,동수원,2555,14,150,8,13,115,2855,2915,28,266,17,13,159,3398,
20221003,101,103,서울,수원신갈,9765,350,870,297,119,447,11848,8274,373,879,279,91,344,10240,
20221003,101,105,서울,기흥,4697,43,137,38,11,188,5114,4132,37,151,65,20,179,4584,
20221003,101,106,서울,오산,4300,274,310,118,59,278,5339,3679,313,316,127,59,213,4707,
20221003,101,107,서울,안성,3246,53,261,30,9,167,3766,2323,44,267,14,10,118,2776,
20221003,101,108,서울,천안,4676,34,308,20,9,199,5246,4054,27,324,23,9,173,4610,
20221003,101,171,서울,마성,1053,18,93,45,1,43,1253,1220,10,94,49,0,43,1416,
20221003,101,172,서울,용인,2392,110,56,19,3,160,2740,2658,96,62,23,16,170,3025,
20221003,101,173,서울,양지,2291,154,88,44,16,96,2689,3544,269,102,47,44,111,4117,
20221003,101,528,서울,기흥동탄,5219,24,415,106,2,212,5978,4807,17,432,111,8,218,5593,
20221003,101,542,서울,서안성,1256,21,67,56,20,54,1474,1263,25,62,78,21,55,1504,
20221003,101,543,서울,남안성,1019,43,41,59,44,42,1248,929,53,53,71,21,50,1177,
20221003,101,673,서울,북오산,1453,20,84,18,2,96,1673,1190,23,78,10,7,73,1381,
20221003,101,677,서울,북평택,1701,18,272,32,35,84,2142,2073,26,175,23,45,85,2427,
20221003,102,101,동수원,서울,2915,28,266,17,13,159,3398,2555,14,150,8,13,115,2855,
20221003,102,212,동수원,북수원,1955,7,123,2,2,92,2181,1950,14,127,2,3,103,2199,
20221003,102,253,동수원,서서울,4271,27,27,8,9,213,4555,4303,29,32,11,4,229,4608,
20221003,102,254,동수원,군자,3220,25,37,9,12,140,3443,3932,31,37,11,12,165,4188,
20221003,103,101,수원신갈,서울,8274,373,879,279,91,344,10240,9765,350,870,297,119,447,11848,
20221003,103,105,수원신갈,기흥,1513,7,9,5,10,87,1631,2165,14,8,3,9,124,2323,
20221003,103,253,수원신갈,서서울,1397,68,51,42,17,78,1653,1912,73,68,46,9,110,2218,
20221003,103,254,수원신갈,군자,1315,57,31,41,35,61,1540,1790,68,30,67,40,90,2085,
20221003,105,101,기흥,서울,4132,37,151,65,20,179,4584,4697,43,137,38,11,188,5114,
20221003,105,103,기흥,수원신갈,2165,14,8,3,9,124,2323,1513,7,9,5,10,87,1631,
20221003,106,101,오산,서울,3679,313,316,127,59,213,4707,4300,274,310,118,59,278,5339,
20221003,107,101,안성,서울,2323,44,267,14,10,118,2776,3246,53,261,30,9,167,3766,
20221003,107,108,안성,천안,1535,9,24,2,4,99,1673,1518,13,25,1,4,94,1655,
20221003,108,101,천안,서울,4054,27,324,23,9,173,4610,4676,34,308,20,9,199,5246,
20221003,108,107,천안,안성,1518,13,25,1,4,94,1655,1535,9,24,2,4,99,1673,
20221003,108,229,천안,북천안,1324,35,52,15,11,73,1510,1778,44,62,13,19,81,1997,
20221003,112,115,남청주,대전,1067,61,47,3,4,50,1232,1126,77,49,2,2,79,1335,
20221003,114,153,남대전,서대전,1404,15,24,15,9,74,1541,1036,17,22,19,14,64,1172,
20221003,115,112,대전,남청주,1126,77,49,2,2,79,1335,1067,61,47,3,4,50,1232,
20221003,115,116,대전,옥천,1699,81,15,4,6,110,1915,1731,40,12,7,5,129,1924,
20221003,116,115,옥천,대전,1731,40,12,7,5,129,1924,1699,81,15,4,6,110,1915,
20221003,119,153,판암,서대전,1393,8,5,4,3,113,1526,1404,12,9,4,2,99,1530,
20221003,123,127,구미,서대구,1486,12,14,4,3,78,1597,1548,16,17,9,7,72,1669,
20221003,123,129,구미,북대구,1496,2,44,1,4,65,1612,1698,11,46,5,3,89,1852,
20221003,125,127,남구미,서대구,1274,13,38,15,7,73,1420,1587,17,42,13,7,81,1747,
20221003,125,129,남구미,북대구,1161,7,16,3,1,62,1250,1528,11,12,3,5,65,1624,
20221003,126,127,왜관,서대구,1965,78,38,21,56,117,2275,2058,81,37,16,56,99,2347,
20221003,126,129,왜관,북대구,2416,63,21,8,63,95,2666,2576,69,35,12,90,105,2887,
20221003,127,123,서대구,구미,1548,16,17,9,7,72,1669,1486,12,14,4,3,78,1597,
20221003,127,125,서대구,남구미,1587,17,42,13,7,81,1747,1274,13,38,15,7,73,1420,
20221003,127,126,서대구,왜관,2058,81,37,16,56,99,2347,1965,78,38,21,56,117,2275,
20221003,127,131,서대구,경산,1720,101,43,50,27,92,2033,1213,75,35,18,30,51,1422,
20221003,127,203,서대구,가산,1939,22,36,15,48,98,2158,1774,23,24,7,17,89,1934,
20221003,127,527,서대구,포항,1535,19,22,11,39,76,1702,1405,25,20,6,32,57,1545,
20221003,129,123,북대구,구미,1698,11,46,5,3,89,1852,1496,2,44,1,4,65,1612,
20221003,129,125,북대구,남구미,1528,11,12,3,5,65,1624,1161,7,16,3,1,62,1250,
20221003,129,126,북대구,왜관,2576,69,35,12,90,105,2887,2416,63,21,8,63,95,2666,
20221003,129,131,북대구,경산,1486,63,41,25,24,57,1696,1894,99,61,34,37,92,2217,
20221003,129,527,북대구,포항,1946,21,16,6,32,72,2093,3038,34,18,13,42,109,3254,
20221003,131,127,경산,서대구,1213,75,35,18,30,51,1422,1720,101,43,50,27,92,2033,
20221003,131,129,경산,북대구,1894,99,61,34,37,92,2217,1486,63,41,25,24,57,1696,
20221003,131,621,경산,동대구,1566,40,15,4,34,89,1748,1504,49,19,9,28,89,1698,
20221003,135,140,경주,부산,2412,15,16,3,6,95,2547,2054,10,20,8,7,70,2169,
20221003,135,252,경주,대동,1861,21,56,15,35,85,2073,1871,20,67,18,29,78,2083,
20221003,135,621,경주,동대구,1120,6,40,1,0,40,1207,985,6,41,1,1,42,1076,
20221003,138,140,양산,부산,3481,177,79,32,79,141,3989,3435,196,92,38,65,160,3986,
20221003,138,252,양산,대동,1490,169,71,107,106,61,2004,1626,181,73,110,121,62,2173,
20221003,139,140,서울산,부산,2434,36,16,5,5,76,2572,1421,38,12,5,8,58,1542,
20221003,139,252,서울산,대동,1311,19,15,10,10,58,1423,1055,14,16,8,4,42,1139,
20221003,139,641,서울산,울산,1267,21,33,4,13,71,1409,917,9,30,2,8,42,1008,
20221003,140,135,부산,경주,2054,10,20,8,7,70,2169,2412,15,16,3,6,95,2547,
20221003,140,138,부산,양산,3435,196,92,38,65,160,3986,3481,177,79,32,79,141,3989,
20221003,140,139,부산,서울산,1421,38,12,5,8,58,1542,2434,36,16,5,5,76,2572,
20221003,140,250,부산,남양산,5956,107,156,15,15,391,6640,5874,98,144,24,17,379,6536,
20221003,140,286,부산,통도사휴게소,1095,8,5,0,0,33,1141,1202,8,2,0,0,26,1238,
20221003,142,145,군북,산인,4865,44,70,18,41,263,5301,3377,26,62,18,27,213,3723,
20221003,144,145,함안,산인,1860,26,16,15,49,139,2105,1698,21,13,8,44,121,1905,
20221003,145,142,산인,군북,3377,26,62,18,27,213,3723,4865,44,70,18,41,263,5301,
20221003,145,144,산인,함안,1698,21,13,8,44,121,1905,1860,26,16,15,49,139,2105,
20221003,145,291,산인,사천,1304,32,29,5,7,63,1440,2393,55,40,14,11,92,2605,
20221003,145,292,산인,진주,1142,18,120,4,3,57,1344,1673,23,131,2,5,83,1917,
20221003,145,293,산인,문산,1029,11,9,5,1,52,1107,1126,18,17,14,1,66,1242,
20221003,146,244,동창원,서부산,1152,10,18,7,32,70,1289,1264,20,18,12,48,76,1438,
20221003,146,289,동창원,마산,1727,36,23,59,24,138,2007,2108,52,36,63,20,153,2432,
20221003,147,244,진례,서부산,865,39,25,25,43,66,1063,935,38,27,20,29,70,1119,
20221003,148,150,서김해,북부산,5179,71,50,22,43,378,5743,5030,62,47,25,33,359,5556,
20221003,148,289,서김해,마산,1143,20,37,5,7,65,1277,1551,20,41,6,12,84,1714,
20221003,149,150,동김해,북부산,8038,135,103,18,37,591,8922,6935,110,90,14,14,515,7678,
20221003,150,148,북부산,서김해,5030,62,47,25,33,359,5556,5179,71,50,22,43,378,5743,
20221003,150,149,북부산,동김해,6935,110,90,14,14,515,7678,8038,135,103,18,37,591,8922,
20221003,150,245,북부산,장유,3345,22,71,7,15,221,3681,2610,26,70,1,13,141,2861,
20221003,150,289,북부산,마산,2214,14,62,3,3,92,2388,4530,25,68,5,1,167,4796,
20221003,153,114,서대전,남대전,1036,17,22,19,14,64,1172,1404,15,24,15,9,74,1541,
20221003,153,119,서대전,판암,1404,12,9,4,2,99,1530,1393,8,5,4,3,113,1526,
20221003,159,167,서전주,광주,1624,41,38,20,14,49,1786,1717,41,29,15,20,50,1872,
20221003,166,167,장성,광주,2156,53,52,13,21,69,2364,2846,71,50,18,23,96,3104,
20221003,167,159,광주,서전주,1717,41,29,15,20,50,1872,1624,41,38,20,14,49,1786,
20221003,167,166,광주,장성,2846,71,50,18,23,96,3104,2156,53,52,13,21,69,2364,
20221003,167,567,광주,남고창,1718,21,33,4,8,52,1836,1833,25,33,9,1,65,1966,
20221003,171,101,마성,서울,1220,10,94,49,0,43,1416,1053,18,93,45,1,43,1253,
20221003,172,101,용인,서울,2658,96,62,23,16,170,3025,2392,110,56,19,3,160,2740,
20221003,172,173,용인,양지,1047,113,48,34,20,87,1349,1039,70,53,36,17,71,1286,
20221003,173,101,양지,서울,3544,269,102,47,44,111,4117,2291,154,88,44,16,96,2689,
20221003,173,172,양지,용인,1039,70,53,36,17,71,1286,1047,113,48,34,20,87,1349,
20221003,173,253,양지,서서울,1243,64,26,35,24,50,1442,855,61,19,27,19,38,1019,
20221003,174,179,춘천,홍천,2798,33,41,21,23,204,3120,2247,31,35,25,13,199,2550,
20221003,174,218,춘천,남원주,1100,15,52,5,9,53,1234,1093,7,52,6,13,67,1238,
20221003,176,190,이천,동서울,1078,19,53,19,12,37,1218,1367,31,76,44,20,69,1607,
20221003,179,174,홍천,춘천,2247,31,35,25,13,199,2550,2798,33,41,21,23,204,3120,
20221003,184,189,대관령,강릉,1166,22,46,1,12,63,1310,1213,23,57,4,13,64,1374,
20221003,189,184,강릉,대관령,1213,23,57,4,13,64,1374,1166,22,46,1,12,63,1310,
20221003,190,176,동서울,이천,1367,31,76,44,20,69,1607,1078,19,53,19,12,37,1218,
20221003,190,191,동서울,경기광주,8132,336,278,89,45,454,9334,6652,252,264,72,33,335,7608,
20221003,190,192,동서울,곤지암,2988,237,114,112,30,190,3671,2653,200,74,73,25,151,3176,
20221003,190,193,동서울,일죽,2006,55,94,77,44,75,2351,2360,56,95,92,45,87,2735,
20221003,190,194,동서울,서이천,3308,368,216,137,41,158,4228,2523,276,150,100,46,108,3203,
20221003,190,198,동서울,서청주,1217,6,18,6,7,41,1295,1047,6,21,11,3,30,1118,
20221003,190,199,동서울,오창,1007,4,8,9,19,38,1085,980,5,7,7,10,47,1056,
20221003,190,705,동서울,남이천,979,48,33,37,21,36,1154,1111,40,24,17,22,30,1244,
20221003,191,190,경기광주,동서울,6652,252,264,72,33,335,7608,8132,336,278,89,45,454,9334,
20221003,192,190,곤지암,동서울,2653,200,74,73,25,151,3176,2988,237,114,112,30,190,3671,
20221003,192,194,곤지암,서이천,1209,168,58,48,37,65,1585,1091,83,57,54,40,54,1379,
20221003,193,190,일죽,동서울,2360,56,95,92,45,87,2735,2006,55,94,77,44,75,2351,
20221003,194,190,서이천,동서울,2523,276,150,100,46,108,3203,3308,368,216,137,41,158,4228,
20221003,194,192,서이천,곤지암,1091,83,57,54,40,54,1379,1209,168,58,48,37,65,1585,
20221003,198,190,서청주,동서울,1047,6,21,11,3,30,1118,1217,6,18,6,7,41,1295,
20221003,199,190,오창,동서울,980,5,7,7,10,47,1056,1007,4,8,9,19,38,1085,
20221003,203,127,가산,서대구,1774,23,24,7,17,89,1934,1939,22,36,15,48,98,2158,
20221003,203,775,가산,동명동호,1567,30,15,22,126,78,1838,1641,33,19,22,109,71,1895,
20221003,212,102,북수원,동수원,1950,14,127,2,3,103,2199,1955,7,123,2,2,92,2181,
20221003,212,254,북수원,군자,1592,11,19,4,9,87,1722,1174,12,16,8,12,66,1288,
20221003,215,253,군포,서서울,2782,37,28,11,25,167,3050,2416,53,66,46,39,154,2774,
20221003,215,254,군포,군자,1730,17,23,7,22,100,1899,1838,51,24,34,27,120,2094,
20221003,218,174,남원주,춘천,1093,7,52,6,13,67,1238,1100,15,52,5,9,53,1234,
20221003,218,240,남원주,제천,1718,16,26,5,29,89,1883,1643,27,30,11,16,102,1829,
20221003,229,108,북천안,천안,1778,44,62,13,19,81,1997,1324,35,52,15,11,73,1510,
20221003,230,527,팔공산,포항,2006,15,11,3,21,94,2150,1972,12,8,5,26,86,2109,
20221003,231,519,화원옥포,남대구,4785,111,55,18,183,337,5489,4705,94,56,15,163,326,5359,
20221003,232,519,달성,남대구,1605,60,58,19,16,102,1860,1749,64,57,17,9,116,2012,
20221003,233,519,현풍,남대구,3366,101,87,27,82,239,3902,3064,81,71,57,67,202,3542,
20221003,238,239,칠서,칠원,933,37,34,118,300,56,1478,857,27,43,105,291,60,1383,
20221003,239,238,칠원,칠서,857,27,43,105,291,60,1383,933,37,34,118,300,56,1478,
20221003,239,519,칠원,남대구,1824,23,72,14,23,77,2033,1677,25,70,22,14,90,1898,
20221003,240,218,제천,남원주,1643,27,30,11,16,102,1829,1718,16,26,5,29,89,1883,
20221003,241,519,동고령,남대구,3068,45,49,22,155,160,3499,2484,43,48,14,166,137,2892,
20221003,242,519,고령,남대구,2539,31,45,14,133,118,2880,2337,30,47,9,154,87,2664,
20221003,244,146,서부산,동창원,1264,20,18,12,48,76,1438,1152,10,18,7,32,70,1289,
20221003,244,147,서부산,진례,935,38,27,20,29,70,1119,865,39,25,25,43,66,1063,
20221003,244,245,서부산,장유,11853,111,270,81,65,786,13166,11018,106,263,98,72,749,12306,
20221003,244,289,서부산,마산,2811,28,235,10,12,136,3232,4478,40,275,18,17,212,5040,
20221003,245,150,장유,북부산,2610,26,70,1,13,141,2861,3345,22,71,7,15,221,3681,
20221003,245,244,장유,서부산,11018,106,263,98,72,749,12306,11853,111,270,81,65,786,13166,
20221003,245,289,장유,마산,999,16,19,14,6,66,1120,1866,24,27,18,8,104,2047,
20221003,248,261,순창,동광주,1680,13,14,2,10,74,1793,1642,10,18,3,6,57,1736,
20221003,249,261,담양,동광주,2909,22,110,9,51,91,3192,2609,17,105,6,65,98,2900,
20221003,250,140,남양산,부산,5874,98,144,24,17,379,6536,5956,107,156,15,15,391,6640,
20221003,250,252,남양산,대동,2246,77,59,43,52,118,2595,3001,89,54,47,41,172,3404,
20221003,251,252,물금,대동,2121,145,33,68,204,144,2715,3102,146,31,82,150,209,3720,
20221003,252,135,대동,경주,1871,20,67,18,29,78,2083,1861,21,56,15,35,85,2073,
20221003,252,138,대동,양산,1626,181,73,110,121,62,2173,1490,169,71,107,106,61,2004,
20221003,252,139,대동,서울산,1055,14,16,8,4,42,1139,1311,19,15,10,10,58,1423,
20221003,252,250,대동,남양산,3001,89,54,47,41,172,3404,2246,77,59,43,52,118,2595,
20221003,252,251,대동,물금,3102,146,31,82,150,209,3720,2121,145,33,68,204,144,2715,
20221003,252,641,대동,울산,2014,23,43,10,29,116,2235,1485,26,31,9,31,86,1668,
20221003,252,752,대동,기장철마,1590,27,25,10,60,113,1825,1457,26,29,12,38,103,1665,
20221003,252,753,대동,금정,1479,34,34,51,70,90,1758,838,20,33,40,43,51,1025,
20221003,252,755,대동,광재,1570,43,38,69,172,96,1988,1519,29,37,75,229,92,1981,
20221003,253,102,서서울,동수원,4303,29,32,11,4,229,4608,4271,27,27,8,9,213,4555,
20221003,253,103,서서울,수원신갈,1912,73,68,46,9,110,2218,1397,68,51,42,17,78,1653,
20221003,253,173,서서울,양지,855,61,19,27,19,38,1019,1243,64,26,35,24,50,1442,
20221003,253,215,서서울,군포,2416,53,66,46,39,154,2774,2782,37,28,11,25,167,3050,
20221003,253,255,서서울,서안산,7725,155,88,109,106,430,8613,7014,161,69,106,144,387,7881,
20221003,253,256,서서울,안산,6235,59,30,22,13,429,6788,3918,39,21,19,24,244,4265,
20221003,253,281,서서울,매송,2522,21,10,2,8,153,2716,2226,19,10,2,15,139,2411,
20221003,253,282,서서울,비봉,3727,75,52,46,59,184,4143,3699,91,53,54,130,188,4215,
20221003,253,283,서서울,발안,3125,50,34,31,180,183,3603,2448,65,36,33,121,119,2822,
20221003,253,285,서서울,서평택,1850,13,29,41,98,114,2145,1295,15,28,56,152,77,1623,
20221003,253,287,서서울,송악,2295,11,24,29,119,80,2558,3419,19,18,27,169,141,3793,
20221003,253,288,서서울,당진,1834,12,33,16,15,74,1984,2244,7,34,20,23,98,2426,
20221003,253,298,서서울,서산,2478,15,23,24,13,105,2658,4033,18,24,24,4,143,4246,
20221003,253,520,서서울,평택,3724,28,57,51,73,159,4092,3460,34,54,60,47,130,3785,
20221003,254,102,군자,동수원,3932,31,37,11,12,165,4188,3220,25,37,9,12,140,3443,
20221003,254,103,군자,수원신갈,1790,68,30,67,40,90,2085,1315,57,31,41,35,61,1540,
20221003,254,212,군자,북수원,1174,12,16,8,12,66,1288,1592,11,19,4,9,87,1722,
20221003,254,215,군자,군포,1838,51,24,34,27,120,2094,1730,17,23,7,22,100,1899,
20221003,254,255,군자,서안산,5625,97,38,58,77,371,6266,6588,119,37,49,98,410,7301,
20221003,254,256,군자,안산,3449,69,88,9,22,209,3846,3968,63,93,22,30,289,4465,
20221003,255,253,서안산,서서울,7014,161,69,106,144,387,7881,7725,155,88,109,106,430,8613,
20221003,255,254,서안산,군자,6588,119,37,49,98,410,7301,5625,97,38,58,77,371,6266,
20221003,256,253,안산,서서울,3918,39,21,19,24,244,4265,6235,59,30,22,13,429,6788,
20221003,256,254,안산,군자,3968,63,93,22,30,289,4465,3449,69,88,9,22,209,3846,
20221003,261,248,동광주,순창,1642,10,18,3,6,57,1736,1680,13,14,2,10,74,1793,
20221003,261,249,동광주,담양,2609,17,105,6,65,98,2900,2909,22,110,9,51,91,3192,
20221003,261,262,동광주,창평,1573,61,14,12,43,46,1749,1691,47,13,11,40,54,1856,
20221003,261,263,동광주,옥과,2338,25,88,11,23,72,2557,2442,19,95,9,40,96,2701,
20221003,261,265,동광주,곡성,1667,15,40,5,20,53,1800,1908,10,29,10,9,53,2019,
20221003,261,271,동광주,순천,3845,64,84,13,28,109,4143,4065,76,64,7,17,145,4374,
20221003,262,261,창평,동광주,1691,47,13,11,40,54,1856,1573,61,14,12,43,46,1749,
20221003,263,261,옥과,동광주,2442,19,95,9,40,96,2701,2338,25,88,11,23,72,2557,
20221003,265,261,곡성,동광주,1908,10,29,10,9,53,2019,1667,15,40,5,20,53,1800,
20221003,271,261,순천,동광주,4065,76,64,7,17,145,4374,3845,64,84,13,28,109,4143,
20221003,280,519,거창,남대구,1798,17,36,5,9,69,1934,1552,17,39,3,10,67,1688,
20221003,281,253,매송,서서울,2226,19,10,2,15,139,2411,2522,21,10,2,8,153,2716,
20221003,282,253,비봉,서서울,3699,91,53,54,130,188,4215,3727,75,52,46,59,184,4143,
20221003,283,253,발안,서서울,2448,65,36,33,121,119,2822,3125,50,34,31,180,183,3603,
20221003,285,253,서평택,서서울,1295,15,28,56,152,77,1623,1850,13,29,41,98,114,2145,
20221003,286,140,통도사휴게소,부산,1202,8,2,0,0,26,1238,1095,8,5,0,0,33,1141,
20221003,287,253,송악,서서울,3419,19,18,27,169,141,3793,2295,11,24,29,119,80,2558,
20221003,288,253,당진,서서울,2244,7,34,20,23,98,2426,1834,12,33,16,15,74,1984,
20221003,289,146,마산,동창원,2108,52,36,63,20,153,2432,1727,36,23,59,24,138,2007,
20221003,289,148,마산,서김해,1551,20,41,6,12,84,1714,1143,20,37,5,7,65,1277,
20221003,289,150,마산,북부산,4530,25,68,5,1,167,4796,2214,14,62,3,3,92,2388,
20221003,289,244,마산,서부산,4478,40,275,18,17,212,5040,2811,28,235,10,12,136,3232,
20221003,289,245,마산,장유,1866,24,27,18,8,104,2047,999,16,19,14,6,66,1120,
20221003,291,145,사천,산인,2393,55,40,14,11,92,2605,1304,32,29,5,7,63,1440,
20221003,291,292,사천,진주,1728,27,33,20,19,109,1936,2164,44,42,21,28,152,2451,
20221003,292,145,진주,산인,1673,23,131,2,5,83,1917,1142,18,120,4,3,57,1344,
20221003,292,291,진주,사천,2164,44,42,21,28,152,2451,1728,27,33,20,19,109,1936,
20221003,293,145,문산,산인,1126,18,17,14,1,66,1242,1029,11,9,5,1,52,1107,
20221003,298,253,서산,서서울,4033,18,24,24,4,143,4246,2478,15,23,24,13,105,2658,
20221003,508,509,무안,목포,1068,26,21,16,38,32,1201,1358,24,21,19,31,43,1496,
20221003,508,553,무안,동광산,1434,16,24,10,5,45,1534,1533,26,19,12,11,46,1647,
20221003,509,508,목포,무안,1358,24,21,19,31,43,1496,1068,26,21,16,38,32,1201,
20221003,509,553,목포,동광산,9330,112,176,73,207,290,10188,8593,98,170,79,186,291,9417,
20221003,513,515,고성,북통영,1641,20,65,9,7,88,1830,2569,26,64,9,8,131,2807,
20221003,513,516,고성,통영,3530,52,79,22,71,236,3990,4597,58,86,25,75,264,5105,
20221003,514,516,동고성,통영,1002,17,18,27,42,116,1222,991,3,23,27,44,113,1201,
20221003,515,513,북통영,고성,2569,26,64,9,8,131,2807,1641,20,65,9,7,88,1830,
20221003,516,513,통영,고성,4597,58,86,25,75,264,5105,3530,52,79,22,71,236,3990,
20221003,516,514,통영,동고성,991,3,23,27,44,113,1201,1002,17,18,27,42,116,1222,
20221003,519,231,남대구,화원옥포,4705,94,56,15,163,326,5359,4785,111,55,18,183,337,5489,
20221003,519,232,남대구,달성,1749,64,57,17,9,116,2012,1605,60,58,19,16,102,1860,
20221003,519,233,남대구,현풍,3064,81,71,57,67,202,3542,3366,101,87,27,82,239,3902,
20221003,519,239,남대구,칠원,1677,25,70,22,14,90,1898,1824,23,72,14,23,77,2033,
20221003,519,241,남대구,동고령,2484,43,48,14,166,137,2892,3068,45,49,22,155,160,3499,
20221003,519,242,남대구,고령,2337,30,47,9,154,87,2664,2539,31,45,14,133,118,2880,
20221003,519,280,남대구,거창,1552,17,39,3,10,67,1688,1798,17,36,5,9,69,1934,
20221003,519,730,남대구,유천,1739,33,4,0,4,117,1897,2097,33,6,0,0,124,2260,
20221003,519,731,남대구,북현풍,1446,14,16,0,25,68,1569,1249,11,5,0,0,69,1334,
20221003,520,253,평택,서서울,3460,34,54,60,47,130,3785,3724,28,57,51,73,159,4092,
20221003,526,527,서포항,포항,1118,6,11,3,18,67,1223,988,6,14,2,13,65,1088,
20221003,527,127,포항,서대구,1405,25,20,6,32,57,1545,1535,19,22,11,39,76,1702,
20221003,527,129,포항,북대구,3038,34,18,13,42,109,3254,1946,21,16,6,32,72,2093,
20221003,527,230,포항,팔공산,1972,12,8,5,26,86,2109,2006,15,11,3,21,94,2150,
20221003,527,526,포항,서포항,988,6,14,2,13,65,1088,1118,6,11,3,18,67,1223,
20221003,528,101,기흥동탄,서울,4807,17,432,111,8,218,5593,5219,24,415,106,2,212,5978,
20221003,542,101,서안성,서울,1263,25,62,78,21,55,1504,1256,21,67,56,20,54,1474,
20221003,543,101,남안성,서울,929,53,53,71,21,50,1177,1019,43,41,59,44,42,1248,
20221003,548,553,북무안,동광산,2866,22,31,26,16,74,3035,2320,17,33,17,8,65,2460,
20221003,549,553,동함평,동광산,3584,20,38,14,18,107,3781,3229,25,37,20,14,85,3410,
20221003,551,553,나주,동광산,1197,10,9,18,23,62,1319,1037,15,6,11,29,54,1152,
20221003,552,553,서광산,동광산,3583,107,113,98,89,117,4107,4094,120,156,114,66,134,4684,
20221003,553,508,동광산,무안,1533,26,19,12,11,46,1647,1434,16,24,10,5,45,1534,
20221003,553,509,동광산,목포,8593,98,170,79,186,291,9417,9330,112,176,73,207,290,10188,
20221003,553,548,동광산,북무안,2320,17,33,17,8,65,2460,2866,22,31,26,16,74,3035,
20221003,553,549,동광산,동함평,3229,25,37,20,14,85,3410,3584,20,38,14,18,107,3781,
20221003,553,551,동광산,나주,1037,15,6,11,29,54,1152,1197,10,9,18,23,62,1319,
20221003,553,552,동광산,서광산,4094,120,156,114,66,134,4684,3583,107,113,98,89,117,4107,
20221003,556,557,동순천,황전,1370,8,15,3,16,36,1448,1112,6,10,1,16,37,1182,
20221003,557,556,황전,동순천,1112,6,10,1,16,37,1182,1370,8,15,3,16,36,1448,
20221003,567,167,남고창,광주,1833,25,33,9,1,65,1966,1718,21,33,4,8,52,1836,
20221003,583,704,동해,근덕,966,5,25,5,81,58,1140,1035,7,21,5,57,52,1177,
20221003,587,589,오수,상관,976,8,33,25,41,30,1113,1035,9,36,16,101,28,1225,
20221003,589,587,상관,오수,1035,9,36,16,101,28,1225,976,8,33,25,41,30,1113,
20221003,621,131,동대구,경산,1504,49,19,9,28,89,1698,1566,40,15,4,34,89,1748,
20221003,621,135,동대구,경주,985,6,41,1,1,42,1076,1120,6,40,1,0,40,1207,
20221003,625,626,밀양,남밀양,1933,41,35,22,45,97,2173,1502,37,30,26,42,51,1688,
20221003,626,625,남밀양,밀양,1502,37,30,26,42,51,1688,1933,41,35,22,45,97,2173,
20221003,641,139,울산,서울산,917,9,30,2,8,42,1008,1267,21,33,4,13,71,1409,
20221003,641,252,울산,대동,1485,26,31,9,31,86,1668,2014,23,43,10,29,116,2235,
20221003,641,648,울산,해운대,1070,3,1,0,3,70,1147,1255,8,3,0,3,86,1355,
20221003,641,706,울산,남경주,1116,7,7,3,7,53,1193,1390,6,6,9,5,74,1490,
20221003,641,707,울산,남포항,1432,15,14,9,87,82,1639,2033,21,13,19,68,93,2247,
20221003,643,648,청량,해운대,2969,5,15,7,23,152,3171,3688,18,47,13,102,178,4046,
20221003,645,648,장안,해운대,1375,3,7,0,2,57,1444,2842,15,11,109,50,132,3159,
20221003,646,648,기장일광,해운대,4821,9,11,88,45,247,5221,5213,16,11,9,37,249,5535,
20221003,648,641,해운대,울산,1255,8,3,0,3,86,1355,1070,3,1,0,3,70,1147,
20221003,648,643,해운대,청량,3688,18,47,13,102,178,4046,2969,5,15,7,23,152,3171,
20221003,648,645,해운대,장안,2842,15,11,109,50,132,3159,1375,3,7,0,2,57,1444,
20221003,648,646,해운대,기장일광,5213,16,11,9,37,249,5535,4821,9,11,88,45,247,5221,
20221003,648,707,해운대,남포항,1372,6,25,11,18,50,1482,1281,8,12,3,12,61,1377,
20221003,651,652,남양주,화도,9802,230,313,235,86,604,11270,12209,240,327,253,100,694,13823,
20221003,651,653,남양주,서종,1628,3,1,1,1,73,1707,3783,4,6,2,0,132,3927,
20221003,651,654,남양주,설악,2967,20,68,12,6,99,3172,4642,18,57,15,8,139,4879,
20221003,651,655,남양주,강촌,1839,24,90,17,23,60,2053,2918,16,80,20,25,92,3151,
20221003,651,656,남양주,남춘천,2091,18,40,13,9,56,2227,1540,9,22,8,7,38,1624,
20221003,652,651,화도,남양주,12209,240,327,253,100,694,13823,9802,230,313,235,86,604,11270,
20221003,652,653,화도,서종,970,10,1,5,3,56,1045,2097,10,1,7,3,105,2223,
20221003,653,651,서종,남양주,3783,4,6,2,0,132,3927,1628,3,1,1,1,73,1707,
20221003,653,652,서종,화도,2097,10,1,7,3,105,2223,970,10,1,5,3,56,1045,
20221003,654,651,설악,남양주,4642,18,57,15,8,139,4879,2967,20,68,12,6,99,3172,
20221003,655,651,강촌,남양주,2918,16,80,20,25,92,3151,1839,24,90,17,23,60,2053,
20221003,656,651,남춘천,남양주,1540,9,22,8,7,38,1624,2091,18,40,13,9,56,2227,
20221003,671,672,봉담,정남,1491,61,18,17,52,88,1727,1663,50,16,20,99,89,1937,
20221003,671,673,봉담,북오산,1329,29,22,2,5,82,1469,1460,32,26,11,15,81,1625,
20221003,671,677,봉담,북평택,6872,66,65,39,52,372,7466,9339,61,68,57,42,434,10001,
20221003,672,671,정남,봉담,1663,50,16,20,99,89,1937,1491,61,18,17,52,88,1727,
20221003,673,101,북오산,서울,1190,23,78,10,7,73,1381,1453,20,84,18,2,96,1673,
20221003,673,671,북오산,봉담,1460,32,26,11,15,81,1625,1329,29,22,2,5,82,1469,
20221003,673,677,북오산,북평택,1528,8,16,3,2,72,1629,1748,20,22,6,5,60,1861,
20221003,675,676,서오산,향남,1497,33,22,9,25,91,1677,1305,48,19,6,29,80,1487,
20221003,675,677,서오산,북평택,7967,66,155,67,94,426,8775,12419,80,124,80,67,561,13331,
20221003,676,675,향남,서오산,1305,48,19,6,29,80,1487,1497,33,22,9,25,91,1677,
20221003,676,677,향남,북평택,909,64,53,52,81,50,1209,1689,70,51,61,75,58,2004,
20221003,677,101,북평택,서울,2073,26,175,23,45,85,2427,1701,18,272,32,35,84,2142,
20221003,677,671,북평택,봉담,9339,61,68,57,42,434,10001,6872,66,65,39,52,372,7466,
20221003,677,673,북평택,북오산,1748,20,22,6,5,60,1861,1528,8,16,3,2,72,1629,
20221003,677,675,북평택,서오산,12419,80,124,80,67,561,13331,7967,66,155,67,94,426,8775,
20221003,677,676,북평택,향남,1689,70,51,61,75,58,2004,909,64,53,52,81,50,1209,
20221003,677,876,북평택,양감,3438,42,35,33,30,144,3722,1052,33,32,22,33,53,1225,
20221003,682,685,조암,서시흥,914,37,55,33,87,41,1167,1447,42,57,36,86,73,1741,
20221003,683,684,송산마도,남안산,1282,45,21,28,61,61,1498,1385,47,26,27,26,62,1573,
20221003,683,685,송산마도,서시흥,3525,47,70,41,307,169,4159,3621,46,61,60,302,177,4267,
20221003,684,683,남안산,송산마도,1385,47,26,27,26,62,1573,1282,45,21,28,61,61,1498,
20221003,684,685,남안산,서시흥,2327,134,97,184,195,156,3093,3815,134,112,163,193,272,4689,
20221003,685,682,서시흥,조암,1447,42,57,36,86,73,1741,914,37,55,33,87,41,1167,
20221003,685,683,서시흥,송산마도,3621,46,61,60,302,177,4267,3525,47,70,41,307,169,4159,
20221003,685,684,서시흥,남안산,3815,134,112,163,193,272,4689,2327,134,97,184,195,156,3093,
20221003,704,583,근덕,동해,1035,7,21,5,57,52,1177,966,5,25,5,81,58,1140,
20221003,705,190,남이천,동서울,1111,40,24,17,22,30,1244,979,48,33,37,21,36,1154,
20221003,706,641,남경주,울산,1390,6,6,9,5,74,1490,1116,7,7,3,7,53,1193,
20221003,706,707,남경주,남포항,1351,20,29,8,120,54,1582,1737,24,25,8,105,80,1979,
20221003,707,641,남포항,울산,2033,21,13,19,68,93,2247,1432,15,14,9,87,82,1639,
20221003,707,648,남포항,해운대,1281,8,12,3,12,61,1377,1372,6,25,11,18,50,1482,
20221003,707,706,남포항,남경주,1737,24,25,8,105,80,1979,1351,20,29,8,120,54,1582,
20221003,707,708,남포항,동경주,1795,11,10,7,182,77,2082,1937,13,18,9,201,71,2249,
20221003,708,707,동경주,남포항,1937,13,18,9,201,71,2249,1795,11,10,7,182,77,2082,
20221003,730,519,유천,남대구,2097,33,6,0,0,124,2260,1739,33,4,0,4,117,1897,
20221003,731,519,북현풍,남대구,1249,11,5,0,0,69,1334,1446,14,16,0,25,68,1569,
20221003,752,252,기장철마,대동,1457,26,29,12,38,103,1665,1590,27,25,10,60,113,1825,
20221003,753,252,금정,대동,838,20,33,40,43,51,1025,1479,34,34,51,70,90,1758,
20221003,755,252,광재,대동,1519,29,37,75,229,92,1981,1570,43,38,69,172,96,1988,
20221003,772,774,북달성,남칠곡,1720,20,24,8,8,78,1858,2080,14,25,10,15,88,2232,
20221003,773,774,북다사,남칠곡,1047,13,8,1,5,55,1129,1129,13,9,8,5,39,1203,
20221003,774,772,남칠곡,북달성,2080,14,25,10,15,88,2232,1720,20,24,8,8,78,1858,
20221003,774,773,남칠곡,북다사,1129,13,9,8,5,39,1203,1047,13,8,1,5,55,1129,
20221003,775,203,동명동호,가산,1641,33,19,22,109,71,1895,1567,30,15,22,126,78,1838,
20221003,776,777,연경,파군재,3348,15,10,6,42,185,3606,2915,12,10,9,43,164,3153,
20221003,776,779,연경,율암,4569,53,27,31,134,273,5087,4708,54,45,37,146,257,5247,
20221003,777,776,파군재,연경,2915,12,10,9,43,164,3153,3348,15,10,6,42,185,3606,
20221003,777,779,파군재,율암,2399,10,4,1,4,148,2566,2402,6,7,0,5,141,2561,
20221003,779,776,율암,연경,4708,54,45,37,146,257,5247,4569,53,27,31,134,273,5087,
20221003,779,777,율암,파군재,2402,6,7,0,5,141,2561,2399,10,4,1,4,148,2566,
20221003,876,677,양감,북평택,1052,33,32,22,33,53,1225,3438,42,35,33,30,144,3722,
20221003,981,982,서영암,강진무위사,1867,17,83,25,19,63,2074,3325,19,92,57,28,93,3614,
20221003,981,987,서영암,남순천,2588,19,57,35,100,64,2863,2668,18,62,32,108,98,2986,
20221003,982,981,강진무위사,서영암,3325,19,92,57,28,93,3614,1867,17,83,25,19,63,2074,
20221003,982,987,강진무위사,남순천,1386,9,29,22,21,42,1509,1095,12,18,15,43,41,1224,
20221003,983,987,장흥,남순천,1129,6,29,12,11,37,1224,981,8,36,6,11,29,1071,
20221003,984,985,보성,벌교,1658,33,37,8,29,43,1808,2352,42,33,21,23,53,2524,
20221003,984,987,보성,남순천,2551,24,62,46,121,61,2865,2415,32,72,45,113,72,2749,
20221003,985,984,벌교,보성,2352,42,33,21,23,53,2524,1658,33,37,8,29,43,1808,
20221003,986,987,고흥,남순천,5605,54,102,88,129,160,6138,3882,43,96,67,133,128,4349,
20221003,987,981,남순천,서영암,2668,18,62,32,108,98,2986,2588,19,57,35,100,64,2863,
20221003,987,982,남순천,강진무위사,1095,12,18,15,43,41,1224,1386,9,29,22,21,42,1509,
20221003,987,983,남순천,장흥,981,8,36,6,11,29,1071,1129,6,29,12,11,37,1224,
20221003,987,984,남순천,보성,2415,32,72,45,113,72,2749,2551,24,62,46,121,61,2865,
20221003,987,986,남순천,고흥,3882,43,96,67,133,128,4349,5605,54,102,88,129,160,6138,
20221004,101,102,서울,동수원,4154,37,246,10,4,250,4701,5615,51,379,19,9,330,6403,
20221004,101,103,서울,수원신갈,15065,640,1590,412,149,789,18645,15059,680,1586,378,128,684,18515,
20221004,101,105,서울,기흥,7025,97,430,68,26,346,7992,5971,96,338,82,33,309,6829,
20221004,101,106,서울,오산,4618,377,443,162,111,310,6021,4227,432,452,163,129,293,5696,
20221004,101,107,서울,안성,3414,81,311,40,5,206,4057,2712,65,290,32,17,164,3280,
20221004,101,108,서울,천안,4307,49,331,33,10,163,4893,3802,53,331,50,15,148,4399,
20221004,101,111,서울,청주,1006,17,180,21,24,43,1291,871,15,208,19,16,35,1164,
20221004,101,171,서울,마성,1818,31,185,56,9,99,2198,2335,22,222,63,3,135,2780,
20221004,101,172,서울,용인,3499,143,112,35,48,235,4072,3720,165,118,58,32,236,4329,
20221004,101,173,서울,양지,3310,204,122,122,61,156,3975,4125,337,119,125,90,156,4952,
20221004,101,229,서울,북천안,1004,51,41,31,15,47,1189,822,53,40,55,17,38,1025,
20221004,101,528,서울,기흥동탄,6921,67,1145,128,8,351,8620,7154,60,1278,130,9,340,8971,
20221004,101,542,서울,서안성,1434,31,74,87,29,74,1729,1856,47,80,119,35,87,2224,
20221004,101,543,서울,남안성,1171,73,54,65,53,36,1452,1190,89,67,99,88,46,1579,
20221004,101,673,서울,북오산,1707,30,125,22,12,109,2005,1596,33,123,21,16,100,1889,
20221004,101,677,서울,북평택,1855,38,243,75,86,91,2388,1493,59,252,70,106,84,2064,
20221004,102,101,동수원,서울,5615,51,379,19,9,330,6403,4154,37,246,10,4,250,4701,
20221004,102,172,동수원,용인,1007,23,14,4,7,92,1147,993,35,16,2,3,85,1134,
20221004,102,173,동수원,양지,1215,41,35,8,20,61,1380,1322,36,37,8,4,73,1480,
20221004,102,212,동수원,북수원,4582,18,219,17,27,271,5134,4870,44,218,13,20,281,5446,
20221004,102,213,동수원,부곡,1059,14,15,6,19,83,1196,1040,18,14,1,26,84,1183,
20221004,102,214,동수원,동군포,1499,23,20,9,5,93,1649,1617,16,12,9,6,100,1760,
20221004,102,215,동수원,군포,1640,19,24,6,4,100,1793,2310,14,45,7,0,169,2545,
20221004,102,253,동수원,서서울,5805,60,56,11,12,342,6286,5184,49,74,15,8,318,5648,
20221004,102,254,동수원,군자,3774,49,66,18,29,221,4157,4224,69,69,28,28,241,4659,
20221004,102,255,동수원,서안산,1739,34,19,10,4,99,1905,1915,31,22,16,5,120,2109,
20221004,103,101,수원신갈,서울,15059,680,1586,378,128,684,18515,15065,640,1590,412,149,789,18645,
20221004,103,105,수원신갈,기흥,1546,31,52,65,15,112,1821,1967,29,32,65,17,125,2235,
20221004,103,106,수원신갈,오산,1056,66,58,78,11,67,1336,1241,81,75,86,8,83,1574,
20221004,103,107,수원신갈,안성,871,16,44,6,2,63,1002,929,19,40,5,4,61,1058,
20221004,103,108,수원신갈,천안,1031,5,53,11,2,35,1137,1159,6,51,19,1,50,1286,
20221004,103,253,수원신갈,서서울,2125,153,66,68,25,113,2550,1935,143,74,70,29,106,2357,
20221004,103,254,수원신갈,군자,1495,104,65,60,70,98,1892,1708,125,82,113,106,104,2238,
20221004,103,528,수원신갈,기흥동탄,1334,14,188,0,6,96,1638,1899,27,162,5,5,99,2197,
20221004,105,101,기흥,서울,5971,96,338,82,33,309,6829,7025,97,430,68,26,346,7992,
20221004,105,103,기흥,수원신갈,1967,29,32,65,17,125,2235,1546,31,52,65,15,112,1821,
20221004,105,253,기흥,서서울,919,21,6,14,9,62,1031,966,19,15,4,7,56,1067,
20221004,106,101,오산,서울,4227,432,452,163,129,293,5696,4618,377,443,162,111,310,6021,
20221004,106,103,오산,수원신갈,1241,81,75,86,8,83,1574,1056,66,58,78,11,67,1336,
20221004,106,107,오산,안성,1607,56,43,20,17,143,1886,1328,49,20,17,7,139,1560,
20221004,106,108,오산,천안,1037,29,24,10,14,60,1174,985,28,28,14,7,59,1121,
20221004,106,528,오산,기흥동탄,848,28,31,21,10,70,1008,976,42,52,15,11,73,1169,
20221004,107,101,안성,서울,2712,65,290,32,17,164,3280,3414,81,311,40,5,206,4057,
20221004,107,103,안성,수원신갈,929,19,40,5,4,61,1058,871,16,44,6,2,63,1002,
20221004,107,106,안성,오산,1328,49,20,17,7,139,1560,1607,56,43,20,17,143,1886,
20221004,107,108,안성,천안,1562,22,36,6,5,119,1750,1524,18,42,10,1,122,1717,
20221004,107,528,안성,기흥동탄,963,12,20,9,2,100,1106,1160,21,23,4,6,102,1316,
20221004,107,742,안성,남사진위,1113,41,46,17,6,106,1329,1285,48,47,24,7,118,1529,
20221004,108,101,천안,서울,3802,53,331,50,15,148,4399,4307,49,331,33,10,163,4893,
20221004,108,103,천안,수원신갈,1159,6,51,19,1,50,1286,1031,5,53,11,2,35,1137,
20221004,108,106,천안,오산,985,28,28,14,7,59,1121,1037,29,24,10,14,60,1174,
20221004,108,107,천안,안성,1524,18,42,10,1,122,1717,1562,22,36,6,5,119,1750,
20221004,108,111,천안,청주,1088,37,60,17,43,57,1302,1094,27,52,26,29,69,1297,
20221004,108,229,천안,북천안,3448,63,112,48,35,193,3899,3682,73,139,51,43,216,4204,
20221004,108,528,천안,기흥동탄,1041,12,101,4,16,75,1249,1080,20,121,4,15,81,1321,
20221004,108,541,천안,송탄,853,36,24,19,15,60,1007,839,41,27,19,13,61,1000,
20221004,108,742,천안,남사진위,1034,25,31,15,10,71,1186,1010,36,32,29,8,73,1188,
20221004,111,101,청주,서울,871,15,208,19,16,35,1164,1006,17,180,21,24,43,1291,
20221004,111,108,청주,천안,1094,27,52,26,29,69,1297,1088,37,60,17,43,57,1302,
20221004,112,115,남청주,대전,1558,79,68,6,13,119,1843,1613,87,64,12,5,132,1913,
20221004,113,115,신탄진,대전,931,19,9,3,4,104,1070,1094,19,22,7,12,120,1274,
20221004,114,153,남대전,서대전,1785,43,48,46,11,122,2055,1713,35,74,61,16,122,2021,
20221004,115,112,대전,남청주,1613,87,64,12,5,132,1913,1558,79,68,6,13,119,1843,
20221004,115,113,대전,신탄진,1094,19,22,7,12,120,1274,931,19,9,3,4,104,1070,
20221004,115,116,대전,옥천,2298,104,34,22,23,169,2650,2015,56,31,24,25,157,2308,
20221004,115,151,대전,북대전,1071,11,8,4,3,113,1210,876,12,10,1,4,119,1022,
20221004,115,152,대전,유성,960,6,18,1,1,78,1064,928,13,16,2,0,54,1013,
20221004,115,153,대전,서대전,927,17,8,0,3,68,1023,910,21,8,6,0,73,1018,
20221004,115,579,대전,남세종,1063,10,20,7,2,88,1190,1125,12,20,3,3,94,1257,
20221004,116,115,옥천,대전,2015,56,31,24,25,157,2308,2298,104,34,22,23,169,2650,
20221004,119,153,판암,서대전,1658,21,17,7,4,134,1841,1725,25,21,7,3,143,1924,
20221004,123,127,구미,서대구,1566,18,19,14,3,94,1714,1627,26,35,9,7,94,1798,
20221004,123,129,구미,북대구,1726,9,50,7,8,90,1890,1878,7,55,8,4,102,2054,
20221004,123,130,구미,동김천,1174,17,34,29,21,82,1357,1115,24,29,21,21,75,1285,
20221004,125,127,남구미,서대구,1793,58,107,31,18,95,2102,2048,81,113,42,20,119,2423,
20221004,125,129,남구미,북대구,1781,19,58,9,5,113,1985,2116,18,70,13,5,130,2352,
20221004,126,127,왜관,서대구,2523,107,68,38,82,123,2941,2703,110,57,37,50,143,3100,
20221004,126,129,왜관,북대구,2879,90,34,14,81,133,3231,3310,84,49,27,87,151,3708,
20221004,127,123,서대구,구미,1627,26,35,9,7,94,1798,1566,18,19,14,3,94,1714,
20221004,127,125,서대구,남구미,2048,81,113,42,20,119,2423,1793,58,107,31,18,95,2102,
20221004,127,126,서대구,왜관,2703,110,57,37,50,143,3100,2523,107,68,38,82,123,2941,
20221004,127,131,서대구,경산,2419,197,125,96,71,155,3063,1775,153,99,70,47,105,2249,
20221004,127,203,서대구,가산,2059,62,79,45,85,97,2427,1850,48,49,37,80,97,2161,
20221004,127,230,서대구,팔공산,1415,45,37,17,14,108,1636,1002,39,32,10,11,84,1178,
20221004,127,518,서대구,칠곡물류,905,112,77,106,24,45,1269,723,87,59,77,19,35,1000,
20221004,127,621,서대구,동대구,1738,63,74,35,38,124,2072,1312,46,29,35,39,85,1546,
20221004,129,123,북대구,구미,1878,7,55,8,4,102,2054,1726,9,50,7,8,90,1890,
20221004,129,125,북대구,남구미,2116,18,70,13,5,130,2352,1781,19,58,9,5,113,1985,
20221004,129,126,북대구,왜관,3310,84,49,27,87,151,3708,2879,90,34,14,81,133,3231,
20221004,129,131,북대구,경산,2271,144,82,47,31,105,2680,2804,183,108,67,50,155,3367,
20221004,129,524,북대구,청통와촌,880,34,26,8,17,47,1012,1049,63,28,17,27,50,1234,
20221004,129,527,북대구,포항,1365,21,23,15,45,76,1545,1788,41,33,21,75,97,2055,
20221004,130,123,동김천,구미,1115,24,29,21,21,75,1285,1174,17,34,29,21,82,1357,
20221004,131,127,경산,서대구,1775,153,99,70,47,105,2249,2419,197,125,96,71,155,3063,
20221004,131,129,경산,북대구,2804,183,108,67,50,155,3367,2271,144,82,47,31,105,2680,
20221004,131,132,경산,영천,892,41,58,37,55,51,1134,783,46,59,46,41,39,1014,
20221004,131,230,경산,팔공산,1281,84,35,25,13,91,1529,1487,73,56,59,17,101,1793,
20221004,131,621,경산,동대구,2234,73,34,163,85,132,2721,2390,60,48,146,31,139,2814,
20221004,132,131,영천,경산,783,46,59,46,41,39,1014,892,41,58,37,55,51,1134,
20221004,132,621,영천,동대구,1041,10,23,2,40,51,1167,1144,13,25,0,36,60,1278,
20221004,135,140,경주,부산,963,17,26,7,39,42,1094,1139,20,32,13,33,62,1299,
20221004,135,252,경주,대동,837,18,72,44,139,38,1148,958,35,70,38,73,56,1230,
20221004,138,140,양산,부산,4803,241,179,199,247,274,5943,5053,288,201,219,254,274,6289,
20221004,138,252,양산,대동,2465,322,186,282,282,122,3659,2697,311,188,262,281,144,3883,
20221004,139,140,서울산,부산,1124,49,28,6,14,70,1291,1156,42,18,2,20,64,1302,
20221004,139,641,서울산,울산,901,31,51,27,30,81,1121,942,20,40,14,22,61,1099,
20221004,140,135,부산,경주,1139,20,32,13,33,62,1299,963,17,26,7,39,42,1094,
20221004,140,138,부산,양산,5053,288,201,219,254,274,6289,4803,241,179,199,247,274,5943,
20221004,140,139,부산,서울산,1156,42,18,2,20,64,1302,1124,49,28,6,14,70,1291,
20221004,140,250,부산,남양산,7783,125,216,27,24,638,8813,7611,122,197,27,35,644,8636,
20221004,140,251,부산,물금,933,116,31,26,62,77,1245,933,96,23,26,52,63,1193,
20221004,140,252,부산,대동,1763,49,56,52,66,91,2077,1386,34,39,35,85,83,1662,
20221004,140,755,부산,광재,1059,16,15,3,18,72,1183,931,15,8,5,26,66,1051,
20221004,142,145,군북,산인,3704,62,107,42,62,277,4254,3802,75,106,41,67,278,4369,
20221004,143,145,장지,산인,1193,26,34,23,55,94,1425,1260,26,25,27,43,96,1477,
20221004,144,145,함안,산인,1769,49,33,28,73,119,2071,1788,44,41,33,71,121,2098,
20221004,145,142,산인,군북,3802,75,106,41,67,278,4369,3704,62,107,42,62,277,4254,
20221004,145,143,산인,장지,1260,26,25,27,43,96,1477,1193,26,34,23,55,94,1425,
20221004,145,144,산인,함안,1788,44,41,33,71,121,2098,1769,49,33,28,73,119,2071,
20221004,145,291,산인,사천,1116,38,56,16,16,48,1290,1084,58,57,21,16,59,1295,
20221004,145,292,산인,진주,1163,18,138,11,19,69,1418,1321,27,134,12,20,81,1595,
20221004,145,293,산인,문산,1086,17,23,7,6,70,1209,948,25,24,19,2,67,1085,
20221004,146,150,동창원,북부산,926,20,11,1,12,68,1038,918,14,14,2,8,72,1028,
20221004,146,244,동창원,서부산,1122,21,24,17,27,68,1279,1260,27,31,18,35,74,1445,
20221004,146,289,동창원,마산,2547,78,68,81,82,228,3084,2340,95,56,77,45,198,2811,
20221004,147,150,진례,북부산,1428,44,21,11,46,84,1634,1656,49,20,11,37,106,1879,
20221004,147,244,진례,서부산,1647,108,76,59,79,98,2067,1831,113,68,71,94,107,2284,
20221004,147,245,진례,장유,1043,70,88,64,21,97,1383,1420,59,82,57,15,121,1754,
20221004,147,289,진례,마산,1196,82,82,50,69,84,1563,1206,85,79,52,53,89,1564,
20221004,148,150,서김해,북부산,6480,118,83,47,78,520,7326,6441,120,63,30,57,497,7208,
20221004,148,251,서김해,물금,900,39,30,28,9,84,1090,841,40,21,28,17,85,1032,
20221004,148,289,서김해,마산,1302,31,53,6,4,101,1497,1277,22,51,7,9,83,1449,
20221004,149,150,동김해,북부산,10382,189,170,38,82,852,11713,9022,168,121,21,36,726,10094,
20221004,149,250,동김해,남양산,1053,23,57,7,6,85,1231,922,14,47,7,6,82,1078,
20221004,149,251,동김해,물금,1083,39,10,8,5,115,1260,1072,33,15,8,7,110,1245,
20221004,150,146,북부산,동창원,918,14,14,2,8,72,1028,926,20,11,1,12,68,1038,
20221004,150,147,북부산,진례,1656,49,20,11,37,106,1879,1428,44,21,11,46,84,1634,
20221004,150,148,북부산,서김해,6441,120,63,30,57,497,7208,6480,118,83,47,78,520,7326,
20221004,150,149,북부산,동김해,9022,168,121,21,36,726,10094,10382,189,170,38,82,852,11713,
20221004,150,245,북부산,장유,3607,41,83,12,29,263,4035,2942,47,85,7,24,213,3318,
20221004,150,289,북부산,마산,2209,32,70,11,24,125,2471,2283,40,63,11,25,127,2549,
20221004,151,115,북대전,대전,876,12,10,1,4,119,1022,1071,11,8,4,3,113,1210,
20221004,151,153,북대전,서대전,1129,15,18,7,28,97,1294,1236,14,21,24,26,102,1423,
20221004,152,115,유성,대전,928,13,16,2,0,54,1013,960,6,18,1,1,78,1064,
20221004,153,114,서대전,남대전,1713,35,74,61,16,122,2021,1785,43,48,46,11,122,2055,
20221004,153,115,서대전,대전,910,21,8,6,0,73,1018,927,17,8,0,3,68,1023,
20221004,153,119,서대전,판암,1725,25,21,7,3,143,1924,1658,21,17,7,4,134,1841,
20221004,153,151,서대전,북대전,1236,14,21,24,26,102,1423,1129,15,18,7,28,97,1294,
20221004,153,154,서대전,안영,1044,29,25,89,23,70,1280,1043,43,30,86,16,64,1282,
20221004,153,579,서대전,남세종,1218,17,16,7,11,105,1374,997,17,18,7,13,82,1134,
20221004,154,153,안영,서대전,1043,43,30,86,16,64,1282,1044,29,25,89,23,70,1280,
20221004,159,167,서전주,광주,1327,68,72,56,48,54,1625,1313,78,60,45,35,51,1582,
20221004,166,167,장성,광주,1823,71,55,33,29,89,2100,2311,104,63,37,18,110,2643,
20221004,167,159,광주,서전주,1313,78,60,45,35,51,1582,1327,68,72,56,48,54,1625,
20221004,167,166,광주,장성,2311,104,63,37,18,110,2643,1823,71,55,33,29,89,2100,
20221004,167,567,광주,남고창,1299,32,39,12,22,48,1452,1327,15,33,14,22,44,1455,
20221004,171,101,마성,서울,2335,22,222,63,3,135,2780,1818,31,185,56,9,99,2198,
20221004,172,101,용인,서울,3720,165,118,58,32,236,4329,3499,143,112,35,48,235,4072,
20221004,172,102,용인,동수원,993,35,16,2,3,85,1134,1007,23,14,4,7,92,1147,
20221004,172,173,용인,양지,1879,234,121,138,57,134,2563,1792,184,136,124,59,151,2446,
20221004,172,212,용인,북수원,959,34,12,12,20,59,1096,1124,56,23,23,15,79,1320,
20221004,172,253,용인,서서울,1080,61,19,17,13,60,1250,1061,61,23,27,10,69,1251,
20221004,173,101,양지,서울,4125,337,119,125,90,156,4952,3310,204,122,122,61,156,3975,
20221004,173,102,양지,동수원,1322,36,37,8,4,73,1480,1215,41,35,8,20,61,1380,
20221004,173,172,양지,용인,1792,184,136,124,59,151,2446,1879,234,121,138,57,134,2563,
20221004,173,212,양지,북수원,1207,82,51,48,20,66,1474,1311,89,50,52,33,60,1595,
20221004,173,253,양지,서서울,1151,154,60,87,41,60,1553,958,134,47,99,41,40,1319,
20221004,173,254,양지,군자,730,109,80,175,174,35,1303,732,108,92,143,172,39,1286,
20221004,174,179,춘천,홍천,3230,49,65,37,21,308,3710,3062,66,62,37,13,307,3547,
20221004,174,216,춘천,횡성,975,38,26,11,33,74,1157,1008,42,21,9,20,79,1179,
20221004,174,218,춘천,남원주,1063,25,63,14,23,87,1275,1050,13,57,11,18,75,1224,
20221004,174,554,춘천,동홍천,1153,14,13,16,5,82,1283,1090,12,17,6,6,79,1210,
20221004,176,190,이천,동서울,1367,56,180,87,101,72,1863,1624,53,184,144,93,90,2188,
20221004,179,174,홍천,춘천,3062,66,62,37,13,307,3547,3230,49,65,37,21,308,3710,
20221004,184,189,대관령,강릉,1016,31,38,5,3,61,1154,1041,27,39,3,6,64,1180,
20221004,189,184,강릉,대관령,1041,27,39,3,6,64,1180,1016,31,38,5,3,61,1154,
20221004,190,176,동서울,이천,1624,53,184,144,93,90,2188,1367,56,180,87,101,72,1863,
20221004,190,191,동서울,경기광주,10430,670,428,407,189,704,12828,10250,631,404,325,168,710,12488,
20221004,190,192,동서울,곤지암,5537,519,243,159,77,360,6895,5056,467,190,179,57,320,6269,
20221004,190,193,동서울,일죽,2501,151,200,189,100,101,3242,2273,162,173,239,84,100,3031,
20221004,190,194,동서울,서이천,4212,541,320,254,152,243,5722,3020,419,249,196,106,179,4169,
20221004,190,560,동서울,감곡,894,24,32,42,60,28,1080,816,35,31,32,100,32,1046,
20221004,190,705,동서울,남이천,1384,88,71,98,105,41,1787,1291,94,51,94,51,43,1624,
20221004,191,190,경기광주,동서울,10250,631,404,325,168,710,12488,10430,670,428,407,189,704,12828,
20221004,192,190,곤지암,동서울,5056,467,190,179,57,320,6269,5537,519,243,159,77,360,6895,
20221004,192,194,곤지암,서이천,1316,263,107,123,103,103,2015,1013,166,89,90,114,70,1542,
20221004,193,190,일죽,동서울,2273,162,173,239,84,100,3031,2501,151,200,189,100,101,3242,
20221004,194,190,서이천,동서울,3020,419,249,196,106,179,4169,4212,541,320,254,152,243,5722,
20221004,194,192,서이천,곤지암,1013,166,89,90,114,70,1542,1316,263,107,123,103,103,2015,
20221004,196,198,진천,서청주,1381,33,72,31,28,77,1622,1239,32,74,30,26,66,1467,
20221004,198,196,서청주,진천,1239,32,74,30,26,66,1467,1381,33,72,31,28,77,1622,
20221004,201,203,칠곡,가산,830,36,26,57,158,43,1150,838,41,38,49,199,50,1215,
20221004,203,127,가산,서대구,1850,48,49,37,80,97,2161,2059,62,79,45,85,97,2427,
20221004,203,201,가산,칠곡,838,41,38,49,199,50,1215,830,36,26,57,158,43,1150,
20221004,203,775,가산,동명동호,1617,44,39,46,233,75,2054,1574,64,36,48,181,72,1975,
20221004,212,102,북수원,동수원,4870,44,218,13,20,281,5446,4582,18,219,17,27,271,5134,
20221004,212,172,북수원,용인,1124,56,23,23,15,79,1320,959,34,12,12,20,59,1096,
20221004,212,173,북수원,양지,1311,89,50,52,33,60,1595,1207,82,51,48,20,66,1474,
20221004,212,253,북수원,서서울,2573,41,24,5,2,166,2811,951,18,9,9,5,60,1052,
20221004,212,254,북수원,군자,1653,37,31,11,27,92,1851,1074,30,27,13,16,58,1218,
20221004,213,102,부곡,동수원,1040,18,14,1,26,84,1183,1059,14,15,6,19,83,1196,
20221004,213,253,부곡,서서울,1417,64,32,21,176,101,1811,981,48,27,43,149,81,1329,
20221004,213,254,부곡,군자,982,33,26,44,522,59,1666,811,36,28,48,444,53,1420,
20221004,214,102,동군포,동수원,1617,16,12,9,6,100,1760,1499,23,20,9,5,93,1649,
20221004,215,102,군포,동수원,2310,14,45,7,0,169,2545,1640,19,24,6,4,100,1793,
20221004,215,253,군포,서서울,3058,74,60,30,48,217,3487,3823,146,142,172,81,269,4633,
20221004,215,254,군포,군자,1969,58,60,39,60,149,2335,2839,138,98,151,120,209,3555,
20221004,215,255,군포,서안산,1340,49,37,18,15,92,1551,1526,81,64,102,83,114,1970,
20221004,216,174,횡성,춘천,1008,42,21,9,20,79,1179,975,38,26,11,33,74,1157,
20221004,218,174,남원주,춘천,1050,13,57,11,18,75,1224,1063,25,63,14,23,87,1275,
20221004,218,240,남원주,제천,2123,44,45,26,56,136,2430,2072,48,35,26,32,124,2337,
20221004,225,291,서진주,사천,918,19,17,13,21,58,1046,905,26,26,11,23,62,1053,
20221004,229,101,북천안,서울,822,53,40,55,17,38,1025,1004,51,41,31,15,47,1189,
20221004,229,108,북천안,천안,3682,73,139,51,43,216,4204,3448,63,112,48,35,193,3899,
20221004,230,127,팔공산,서대구,1002,39,32,10,11,84,1178,1415,45,37,17,14,108,1636,
20221004,230,131,팔공산,경산,1487,73,56,59,17,101,1793,1281,84,35,25,13,91,1529,
20221004,230,524,팔공산,청통와촌,1077,38,22,11,9,59,1216,953,36,13,13,16,55,1086,
20221004,230,527,팔공산,포항,1401,18,11,4,22,61,1517,1149,20,14,6,28,54,1271,
20221004,231,519,화원옥포,남대구,6176,152,81,103,103,478,7093,5938,129,93,98,75,460,6793,
20221004,232,519,달성,남대구,2697,124,131,47,28,191,3218,2970,126,153,42,17,203,3511,
20221004,233,519,현풍,남대구,4882,215,191,67,119,339,5813,4297,186,168,94,93,280,5118,
20221004,238,239,칠서,칠원,1439,103,108,127,222,96,2095,1581,94,101,112,250,96,2234,
20221004,239,238,칠원,칠서,1581,94,101,112,250,96,2234,1439,103,108,127,222,96,2095,
20221004,239,519,칠원,남대구,973,48,86,26,69,30,1232,1033,49,74,34,48,36,1274,
20221004,240,218,제천,남원주,2072,48,35,26,32,124,2337,2123,44,45,26,56,136,2430,
20221004,241,519,동고령,남대구,3001,84,76,223,39,134,3557,2981,81,84,195,54,155,3550,
20221004,242,519,고령,남대구,1506,36,57,31,162,69,1861,1563,26,59,19,174,69,1910,
20221004,244,146,서부산,동창원,1260,27,31,18,35,74,1445,1122,21,24,17,27,68,1279,
20221004,244,147,서부산,진례,1831,113,68,71,94,107,2284,1647,108,76,59,79,98,2067,
20221004,244,245,서부산,장유,12441,227,350,112,315,968,14413,11707,219,348,106,342,964,13686,
20221004,244,289,서부산,마산,2677,55,229,39,68,148,3216,2450,71,227,35,64,119,2966,
20221004,245,147,장유,진례,1420,59,82,57,15,121,1754,1043,70,88,64,21,97,1383,
20221004,245,150,장유,북부산,2942,47,85,7,24,213,3318,3607,41,83,12,29,263,4035,
20221004,245,244,장유,서부산,11707,219,348,106,342,964,13686,12441,227,350,112,315,968,14413,
20221004,245,289,장유,마산,1337,25,35,17,12,116,1542,1169,33,40,17,9,99,1367,
20221004,248,261,순창,동광주,1209,23,21,11,9,52,1325,1188,17,24,14,9,48,1300,
20221004,249,261,담양,동광주,2093,31,111,18,24,93,2370,1646,30,105,12,26,82,1901,
20221004,250,140,남양산,부산,7611,122,197,27,35,644,8636,7783,125,216,27,24,638,8813,
20221004,250,149,남양산,동김해,922,14,47,7,6,82,1078,1053,23,57,7,6,85,1231,
20221004,250,252,남양산,대동,3265,143,101,92,95,238,3934,3809,154,105,88,101,289,4546,
20221004,251,140,물금,부산,933,96,23,26,52,63,1193,933,116,31,26,62,77,1245,
20221004,251,148,물금,서김해,841,40,21,28,17,85,1032,900,39,30,28,9,84,1090,
20221004,251,149,물금,동김해,1072,33,15,8,7,110,1245,1083,39,10,8,5,115,1260,
20221004,251,252,물금,대동,3086,211,101,126,449,237,4210,3663,204,98,139,537,262,4903,
20221004,252,135,대동,경주,958,35,70,38,73,56,1230,837,18,72,44,139,38,1148,
20221004,252,138,대동,양산,2697,311,188,262,281,144,3883,2465,322,186,282,282,122,3659,
20221004,252,140,대동,부산,1386,34,39,35,85,83,1662,1763,49,56,52,66,91,2077,
20221004,252,250,대동,남양산,3809,154,105,88,101,289,4546,3265,143,101,92,95,238,3934,
20221004,252,251,대동,물금,3663,204,98,139,537,262,4903,3086,211,101,126,449,237,4210,
20221004,252,641,대동,울산,1431,50,84,28,27,86,1706,1334,73,91,28,61,71,1658,
20221004,252,752,대동,기장철마,1756,56,44,39,111,128,2134,1818,54,58,35,64,141,2170,
20221004,252,753,대동,금정,1727,84,93,97,177,112,2290,1071,55,69,69,88,60,1412,
20221004,252,755,대동,광재,2261,102,74,113,277,147,2974,2300,106,76,113,377,126,3098,
20221004,253,102,서서울,동수원,5184,49,74,15,8,318,5648,5805,60,56,11,12,342,6286,
20221004,253,103,서서울,수원신갈,1935,143,74,70,29,106,2357,2125,153,66,68,25,113,2550,
20221004,253,105,서서울,기흥,966,19,15,4,7,56,1067,919,21,6,14,9,62,1031,
20221004,253,172,서서울,용인,1061,61,23,27,10,69,1251,1080,61,19,17,13,60,1250,
20221004,253,173,서서울,양지,958,134,47,99,41,40,1319,1151,154,60,87,41,60,1553,
20221004,253,212,서서울,북수원,951,18,9,9,5,60,1052,2573,41,24,5,2,166,2811,
20221004,253,213,서서울,부곡,981,48,27,43,149,81,1329,1417,64,32,21,176,101,1811,
20221004,253,215,서서울,군포,3823,146,142,172,81,269,4633,3058,74,60,30,48,217,3487,
20221004,253,255,서서울,서안산,14885,492,520,495,222,863,17477,14384,496,501,444,224,890,16939,
20221004,253,256,서서울,안산,9130,142,75,34,39,642,10062,5909,99,56,26,48,434,6572,
20221004,253,281,서서울,매송,3471,63,46,17,18,225,3840,3555,58,42,14,37,222,3928,
20221004,253,282,서서울,비봉,5706,245,248,125,267,344,6935,5374,312,292,146,328,339,6791,
20221004,253,283,서서울,발안,3524,175,170,134,139,208,4350,3403,222,168,161,135,208,4297,
20221004,253,285,서서울,서평택,1717,67,108,233,332,92,2549,1381,94,99,307,436,69,2386,
20221004,253,287,서서울,송악,2022,35,52,84,228,80,2501,1585,44,62,104,398,66,2259,
20221004,253,288,서서울,당진,1389,21,46,27,33,57,1573,1231,29,50,41,49,59,1459,
20221004,253,298,서서울,서산,2051,20,71,42,20,68,2272,1954,25,70,53,45,75,2222,
20221004,253,520,서서울,평택,2354,90,132,166,128,106,2976,2315,137,135,222,141,96,3046,
20221004,253,540,서서울,청북,851,45,64,97,60,48,1165,926,60,46,94,73,50,1249,
20221004,253,741,서서울,평택고덕,1276,17,20,28,8,95,1444,985,34,24,27,15,82,1167,
20221004,254,102,군자,동수원,4224,69,69,28,28,241,4659,3774,49,66,18,29,221,4157,
20221004,254,103,군자,수원신갈,1708,125,82,113,106,104,2238,1495,104,65,60,70,98,1892,
20221004,254,173,군자,양지,732,108,92,143,172,39,1286,730,109,80,175,174,35,1303,
20221004,254,212,군자,북수원,1074,30,27,13,16,58,1218,1653,37,31,11,27,92,1851,
20221004,254,213,군자,부곡,811,36,28,48,444,53,1420,982,33,26,44,522,59,1666,
20221004,254,215,군자,군포,2839,138,98,151,120,209,3555,1969,58,60,39,60,149,2335,
20221004,254,255,군자,서안산,9795,397,178,226,260,668,11524,9253,361,160,181,216,612,10783,
20221004,254,256,군자,안산,4620,123,123,34,45,385,5330,4918,107,115,53,57,390,5640,
20221004,254,281,군자,매송,1028,37,17,17,65,68,1232,889,32,19,15,61,64,1080,
20221004,254,282,군자,비봉,1266,130,87,78,166,81,1808,1068,123,70,62,161,78,1562,
20221004,254,283,군자,발안,1276,93,71,76,130,77,1723,1010,96,61,51,89,64,1371,
20221004,255,102,서안산,동수원,1915,31,22,16,5,120,2109,1739,34,19,10,4,99,1905,
20221004,255,215,서안산,군포,1526,81,64,102,83,114,1970,1340,49,37,18,15,92,1551,
20221004,255,253,서안산,서서울,14384,496,501,444,224,890,16939,14885,492,520,495,222,863,17477,
20221004,255,254,서안산,군자,9253,361,160,181,216,612,10783,9795,397,178,226,260,668,11524,
20221004,256,253,안산,서서울,5909,99,56,26,48,434,6572,9130,142,75,34,39,642,10062,
20221004,256,254,안산,군자,4918,107,115,53,57,390,5640,4620,123,123,34,45,385,5330,
20221004,261,248,동광주,순창,1188,17,24,14,9,48,1300,1209,23,21,11,9,52,1325,
20221004,261,249,동광주,담양,1646,30,105,12,26,82,1901,2093,31,111,18,24,93,2370,
20221004,261,262,동광주,창평,1318,76,22,23,8,50,1497,1511,62,24,29,5,65,1696,
20221004,261,263,동광주,옥과,2445,23,113,8,30,102,2721,2509,18,112,7,44,108,2798,
20221004,261,265,동광주,곡성,1307,28,29,5,40,65,1474,1317,15,27,6,42,56,1463,
20221004,261,271,동광주,순천,3055,67,83,25,114,107,3451,2781,85,74,26,121,86,3173,
20221004,262,261,창평,동광주,1511,62,24,29,5,65,1696,1318,76,22,23,8,50,1497,
20221004,263,261,옥과,동광주,2509,18,112,7,44,108,2798,2445,23,113,8,30,102,2721,
20221004,265,261,곡성,동광주,1317,15,27,6,42,56,1463,1307,28,29,5,40,65,1474,
20221004,271,261,순천,동광주,2781,85,74,26,121,86,3173,3055,67,83,25,114,107,3451,
20221004,271,569,순천,북광주,713,59,21,32,150,27,1002,777,56,30,28,129,27,1047,
20221004,280,519,거창,남대구,877,21,49,3,5,50,1005,909,28,50,6,5,57,1055,
20221004,281,253,매송,서서울,3555,58,42,14,37,222,3928,3471,63,46,17,18,225,3840,
20221004,281,254,매송,군자,889,32,19,15,61,64,1080,1028,37,17,17,65,68,1232,
20221004,282,253,비봉,서서울,5374,312,292,146,328,339,6791,5706,245,248,125,267,344,6935,
20221004,282,254,비봉,군자,1068,123,70,62,161,78,1562,1266,130,87,78,166,81,1808,
20221004,283,253,발안,서서울,3403,222,168,161,135,208,4297,3524,175,170,134,139,208,4350,
20221004,283,254,발안,군자,1010,96,61,51,89,64,1371,1276,93,71,76,130,77,1723,
20221004,285,253,서평택,서서울,1381,94,99,307,436,69,2386,1717,67,108,233,332,92,2549,
20221004,285,287,서평택,송악,679,29,99,81,627,44,1559,625,38,90,76,492,41,1362,
20221004,287,253,송악,서서울,1585,44,62,104,398,66,2259,2022,35,52,84,228,80,2501,
20221004,287,285,송악,서평택,625,38,90,76,492,41,1362,679,29,99,81,627,44,1559,
20221004,288,253,당진,서서울,1231,29,50,41,49,59,1459,1389,21,46,27,33,57,1573,
20221004,289,146,마산,동창원,2340,95,56,77,45,198,2811,2547,78,68,81,82,228,3084,
20221004,289,147,마산,진례,1206,85,79,52,53,89,1564,1196,82,82,50,69,84,1563,
20221004,289,148,마산,서김해,1277,22,51,7,9,83,1449,1302,31,53,6,4,101,1497,
20221004,289,150,마산,북부산,2283,40,63,11,25,127,2549,2209,32,70,11,24,125,2471,
20221004,289,244,마산,서부산,2450,71,227,35,64,119,2966,2677,55,229,39,68,148,3216,
20221004,289,245,마산,장유,1169,33,40,17,9,99,1367,1337,25,35,17,12,116,1542,
20221004,291,145,사천,산인,1084,58,57,21,16,59,1295,1116,38,56,16,16,48,1290,
20221004,291,225,사천,서진주,905,26,26,11,23,62,1053,918,19,17,13,21,58,1046,
20221004,291,292,사천,진주,2627,59,97,34,44,244,3105,3430,86,100,37,46,273,3972,
20221004,292,145,진주,산인,1321,27,134,12,20,81,1595,1163,18,138,11,19,69,1418,
20221004,292,291,진주,사천,3430,86,100,37,46,273,3972,2627,59,97,34,44,244,3105,
20221004,293,145,문산,산인,948,25,24,19,2,67,1085,1086,17,23,7,6,70,1209,
20221004,298,253,서산,서서울,1954,25,70,53,45,75,2222,2051,20,71,42,20,68,2272,
20221004,508,509,무안,목포,1255,38,36,33,53,62,1477,1591,40,40,31,60,85,1847,
20221004,508,553,무안,동광산,1396,28,25,13,17,55,1534,1538,25,28,25,22,58,1696,
20221004,509,508,목포,무안,1591,40,40,31,60,85,1847,1255,38,36,33,53,62,1477,
20221004,509,553,목포,동광산,6260,167,193,90,339,240,7289,6820,148,186,133,358,245,7890,
20221004,513,515,고성,북통영,1163,28,66,9,20,94,1380,1479,29,51,13,19,113,1704,
20221004,513,516,고성,통영,2701,77,112,83,153,187,3313,2693,77,131,88,150,182,3321,
20221004,514,516,동고성,통영,1125,25,56,30,127,152,1515,1142,18,47,35,135,148,1525,
20221004,515,513,북통영,고성,1479,29,51,13,19,113,1704,1163,28,66,9,20,94,1380,
20221004,516,513,통영,고성,2693,77,131,88,150,182,3321,2701,77,112,83,153,187,3313,
20221004,516,514,통영,동고성,1142,18,47,35,135,148,1525,1125,25,56,30,127,152,1515,
20221004,518,127,칠곡물류,서대구,723,87,59,77,19,35,1000,905,112,77,106,24,45,1269,
20221004,519,231,남대구,화원옥포,5938,129,93,98,75,460,6793,6176,152,81,103,103,478,7093,
20221004,519,232,남대구,달성,2970,126,153,42,17,203,3511,2697,124,131,47,28,191,3218,
20221004,519,233,남대구,현풍,4297,186,168,94,93,280,5118,4882,215,191,67,119,339,5813,
20221004,519,239,남대구,칠원,1033,49,74,34,48,36,1274,973,48,86,26,69,30,1232,
20221004,519,241,남대구,동고령,2981,81,84,195,54,155,3550,3001,84,76,223,39,134,3557,
20221004,519,242,남대구,고령,1563,26,59,19,174,69,1910,1506,36,57,31,162,69,1861,
20221004,519,280,남대구,거창,909,28,50,6,5,57,1055,877,21,49,3,5,50,1005,
20221004,519,730,남대구,유천,2333,54,19,1,3,176,2586,2759,47,14,1,0,218,3039,
20221004,519,731,남대구,북현풍,1885,30,31,0,0,117,2063,1508,22,6,0,0,104,1640,
20221004,520,253,평택,서서울,2315,137,135,222,141,96,3046,2354,90,132,166,128,106,2976,
20221004,520,540,평택,청북,963,108,154,141,94,68,1528,764,102,148,105,84,37,1240,
20221004,524,129,청통와촌,북대구,1049,63,28,17,27,50,1234,880,34,26,8,17,47,1012,
20221004,524,230,청통와촌,팔공산,953,36,13,13,16,55,1086,1077,38,22,11,9,59,1216,
20221004,527,129,포항,북대구,1788,41,33,21,75,97,2055,1365,21,23,15,45,76,1545,
20221004,527,230,포항,팔공산,1149,20,14,6,28,54,1271,1401,18,11,4,22,61,1517,
20221004,528,101,기흥동탄,서울,7154,60,1278,130,9,340,8971,6921,67,1145,128,8,351,8620,
20221004,528,103,기흥동탄,수원신갈,1899,27,162,5,5,99,2197,1334,14,188,0,6,96,1638,
20221004,528,106,기흥동탄,오산,976,42,52,15,11,73,1169,848,28,31,21,10,70,1008,
20221004,528,107,기흥동탄,안성,1160,21,23,4,6,102,1316,963,12,20,9,2,100,1106,
20221004,528,108,기흥동탄,천안,1080,20,121,4,15,81,1321,1041,12,101,4,16,75,1249,
20221004,540,253,청북,서서울,926,60,46,94,73,50,1249,851,45,64,97,60,48,1165,
20221004,540,520,청북,평택,764,102,148,105,84,37,1240,963,108,154,141,94,68,1528,
20221004,540,741,청북,평택고덕,823,24,43,43,15,82,1030,816,29,47,55,16,80,1043,
20221004,541,108,송탄,천안,839,41,27,19,13,61,1000,853,36,24,19,15,60,1007,
20221004,542,101,서안성,서울,1856,47,80,119,35,87,2224,1434,31,74,87,29,74,1729,
20221004,542,543,서안성,남안성,1056,50,78,124,103,93,1504,1108,50,89,151,85,106,1589,
20221004,543,101,남안성,서울,1190,89,67,99,88,46,1579,1171,73,54,65,53,36,1452,
20221004,543,542,남안성,서안성,1108,50,89,151,85,106,1589,1056,50,78,124,103,93,1504,
20221004,543,555,남안성,북진천,807,110,145,167,146,47,1422,806,103,139,142,152,53,1395,
20221004,548,553,북무안,동광산,1166,20,17,19,7,20,1249,1289,20,18,14,7,33,1381,
20221004,549,553,동함평,동광산,2848,28,54,36,56,97,3119,2874,41,68,38,42,96,3159,
20221004,551,553,나주,동광산,1187,18,34,50,41,56,1386,1201,19,38,50,49,52,1409,
20221004,552,553,서광산,동광산,4166,151,168,192,168,174,5019,5513,186,188,192,169,219,6467,
20221004,553,508,동광산,무안,1538,25,28,25,22,58,1696,1396,28,25,13,17,55,1534,
20221004,553,509,동광산,목포,6820,148,186,133,358,245,7890,6260,167,193,90,339,240,7289,
20221004,553,548,동광산,북무안,1289,20,18,14,7,33,1381,1166,20,17,19,7,20,1249,
20221004,553,549,동광산,동함평,2874,41,68,38,42,96,3159,2848,28,54,36,56,97,3119,
20221004,553,551,동광산,나주,1201,19,38,50,49,52,1409,1187,18,34,50,41,56,1386,
20221004,553,552,동광산,서광산,5513,186,188,192,169,219,6467,4166,151,168,192,168,174,5019,
20221004,554,174,동홍천,춘천,1090,12,17,6,6,79,1210,1153,14,13,16,5,82,1283,
20221004,555,543,북진천,남안성,806,103,139,142,152,53,1395,807,110,145,167,146,47,1422,
20221004,560,190,감곡,동서울,816,35,31,32,100,32,1046,894,24,32,42,60,28,1080,
20221004,567,167,남고창,광주,1327,15,33,14,22,44,1455,1299,32,39,12,22,48,1452,
20221004,569,271,북광주,순천,777,56,30,28,129,27,1047,713,59,21,32,150,27,1002,
20221004,579,115,남세종,대전,1125,12,20,3,3,94,1257,1063,10,20,7,2,88,1190,
20221004,579,153,남세종,서대전,997,17,18,7,13,82,1134,1218,17,16,7,11,105,1374,
20221004,587,589,오수,상관,972,17,58,31,34,35,1147,1156,20,50,25,120,60,1431,
20221004,589,587,상관,오수,1156,20,50,25,120,60,1431,972,17,58,31,34,35,1147,
20221004,597,598,서여주,북여주,870,38,114,28,48,39,1137,935,49,94,32,42,50,1202,
20221004,598,597,북여주,서여주,935,49,94,32,42,50,1202,870,38,114,28,48,39,1137,
20221004,621,127,동대구,서대구,1312,46,29,35,39,85,1546,1738,63,74,35,38,124,2072,
20221004,621,131,동대구,경산,2390,60,48,146,31,139,2814,2234,73,34,163,85,132,2721,
20221004,621,132,동대구,영천,1144,13,25,0,36,60,1278,1041,10,23,2,40,51,1167,
20221004,625,626,밀양,남밀양,969,69,45,42,42,44,1211,929,57,48,34,64,42,1174,
20221004,626,625,남밀양,밀양,929,57,48,34,64,42,1174,969,69,45,42,42,44,1211,
20221004,626,627,남밀양,삼랑진,965,22,32,16,46,101,1182,995,26,36,15,47,96,1215,
20221004,627,626,삼랑진,남밀양,995,26,36,15,47,96,1215,965,22,32,16,46,101,1182,
20221004,641,139,울산,서울산,942,20,40,14,22,61,1099,901,31,51,27,30,81,1121,
20221004,641,252,울산,대동,1334,73,91,28,61,71,1658,1431,50,84,28,27,86,1706,
20221004,641,643,울산,청량,1128,11,10,16,43,101,1309,1165,10,13,13,36,122,1359,
20221004,641,706,울산,남경주,957,6,12,10,16,62,1063,969,7,23,12,21,61,1093,
20221004,641,707,울산,남포항,974,9,18,10,127,57,1195,1004,13,14,29,97,69,1226,
20221004,643,641,청량,울산,1165,10,13,13,36,122,1359,1128,11,10,16,43,101,1309,
20221004,643,648,청량,해운대,2761,13,35,24,50,160,3043,3224,21,70,60,455,193,4023,
20221004,645,648,장안,해운대,1498,9,15,4,8,92,1626,2642,24,37,94,57,159,3013,
20221004,646,648,기장일광,해운대,4374,11,20,24,39,257,4725,4952,36,19,16,181,314,5518,
20221004,648,643,해운대,청량,3224,21,70,60,455,193,4023,2761,13,35,24,50,160,3043,
20221004,648,645,해운대,장안,2642,24,37,94,57,159,3013,1498,9,15,4,8,92,1626,
20221004,648,646,해운대,기장일광,4952,36,19,16,181,314,5518,4374,11,20,24,39,257,4725,
20221004,651,652,남양주,화도,14197,558,490,437,207,1077,16966,16173,546,537,475,195,1287,19213,
20221004,651,653,남양주,서종,1848,14,8,2,3,86,1961,1927,10,3,1,2,82,2025,
20221004,651,654,남양주,설악,3201,24,53,12,6,111,3407,3393,20,51,14,7,123,3608,
20221004,651,655,남양주,강촌,2114,41,99,25,20,99,2398,2441,40,105,36,27,83,2732,
20221004,651,656,남양주,남춘천,2462,27,37,20,39,83,2668,2101,14,29,14,35,53,2246,
20221004,652,651,화도,남양주,16173,546,537,475,195,1287,19213,14197,558,490,437,207,1077,16966,
20221004,652,653,화도,서종,1331,22,17,14,11,90,1485,1354,24,15,19,3,100,1515,
20221004,652,654,화도,설악,1099,22,10,6,1,78,1216,1201,20,12,6,2,85,1326,
20221004,653,651,서종,남양주,1927,10,3,1,2,82,2025,1848,14,8,2,3,86,1961,
20221004,653,652,서종,화도,1354,24,15,19,3,100,1515,1331,22,17,14,11,90,1485,
20221004,654,651,설악,남양주,3393,20,51,14,7,123,3608,3201,24,53,12,6,111,3407,
20221004,654,652,설악,화도,1201,20,12,6,2,85,1326,1099,22,10,6,1,78,1216,
20221004,655,651,강촌,남양주,2441,40,105,36,27,83,2732,2114,41,99,25,20,99,2398,
20221004,656,651,남춘천,남양주,2101,14,29,14,35,53,2246,2462,27,37,20,39,83,2668,
20221004,671,672,봉담,정남,3434,164,82,67,99,243,4089,3631,161,92,72,115,271,4342,
20221004,671,673,봉담,북오산,1893,55,42,24,5,173,2192,1920,46,43,28,18,136,2191,
20221004,671,675,봉담,서오산,930,19,21,5,9,76,1060,933,21,22,7,16,72,1071,
20221004,671,676,봉담,향남,1401,118,58,27,39,113,1756,1176,104,49,34,28,89,1480,
20221004,671,677,봉담,북평택,7695,161,219,163,238,445,8921,6741,162,186,117,197,434,7837,
20221004,672,671,정남,봉담,3631,161,92,72,115,271,4342,3434,164,82,67,99,243,4089,
20221004,673,101,북오산,서울,1596,33,123,21,16,100,1889,1707,30,125,22,12,109,2005,
20221004,673,671,북오산,봉담,1920,46,43,28,18,136,2191,1893,55,42,24,5,173,2192,
20221004,673,677,북오산,북평택,1849,40,64,25,22,132,2132,1899,31,43,29,18,129,2149,
20221004,675,671,서오산,봉담,933,21,22,7,16,72,1071,930,19,21,5,9,76,1060,
20221004,675,676,서오산,향남,3362,118,73,60,33,223,3869,3078,95,66,48,29,199,3515,
20221004,675,677,서오산,북평택,11666,225,409,151,207,794,13452,10946,212,352,175,167,723,12575,
20221004,675,876,서오산,양감,1884,55,35,34,116,110,2234,2100,66,33,29,113,148,2489,
20221004,676,671,향남,봉담,1176,104,49,34,28,89,1480,1401,118,58,27,39,113,1756,
20221004,676,675,향남,서오산,3078,95,66,48,29,199,3515,3362,118,73,60,33,223,3869,
20221004,676,677,향남,북평택,1803,176,175,298,133,102,2687,1645,153,159,253,122,80,2412,
20221004,677,101,북평택,서울,1493,59,252,70,106,84,2064,1855,38,243,75,86,91,2388,
20221004,677,671,북평택,봉담,6741,162,186,117,197,434,7837,7695,161,219,163,238,445,8921,
20221004,677,673,북평택,북오산,1899,31,43,29,18,129,2149,1849,40,64,25,22,132,2132,
20221004,677,675,북평택,서오산,10946,212,352,175,167,723,12575,11666,225,409,151,207,794,13452,
20221004,677,676,북평택,향남,1645,153,159,253,122,80,2412,1803,176,175,298,133,102,2687,
20221004,677,876,북평택,양감,2200,159,164,220,167,148,3058,2040,158,159,204,132,155,2848,
20221004,682,683,조암,송산마도,794,85,78,67,57,38,1119,961,99,90,97,62,49,1358,
20221004,682,684,조암,남안산,1023,157,164,101,109,44,1598,1134,157,167,116,79,43,1696,
20221004,682,685,조암,서시흥,1768,157,153,160,312,88,2638,2135,179,164,166,348,107,3099,
20221004,683,682,송산마도,조암,961,99,90,97,62,49,1358,794,85,78,67,57,38,1119,
20221004,683,684,송산마도,남안산,2406,212,146,114,96,131,3105,2181,184,122,88,70,128,2773,
20221004,683,685,송산마도,서시흥,4994,321,202,172,689,292,6670,4794,285,209,182,702,263,6435,
20221004,684,682,남안산,조암,1134,157,167,116,79,43,1696,1023,157,164,101,109,44,1598,
20221004,684,683,남안산,송산마도,2181,184,122,88,70,128,2773,2406,212,146,114,96,131,3105,
20221004,684,685,남안산,서시흥,5806,533,312,492,572,397,8112,5122,437,361,406,457,364,7147,
20221004,685,682,서시흥,조암,2135,179,164,166,348,107,3099,1768,157,153,160,312,88,2638,
20221004,685,683,서시흥,송산마도,4794,285,209,182,702,263,6435,4994,321,202,172,689,292,6670,
20221004,685,684,서시흥,남안산,5122,437,361,406,457,364,7147,5806,533,312,492,572,397,8112,
20221004,705,190,남이천,동서울,1291,94,51,94,51,43,1624,1384,88,71,98,105,41,1787,
20221004,706,641,남경주,울산,969,7,23,12,21,61,1093,957,6,12,10,16,62,1063,
20221004,706,707,남경주,남포항,839,32,65,30,177,64,1207,978,32,62,27,174,64,1337,
20221004,707,641,남포항,울산,1004,13,14,29,97,69,1226,974,9,18,10,127,57,1195,
20221004,707,706,남포항,남경주,978,32,62,27,174,64,1337,839,32,65,30,177,64,1207,
20221004,707,708,남포항,동경주,1204,24,24,18,291,67,1628,1159,24,31,18,325,89,1646,
20221004,708,707,동경주,남포항,1159,24,31,18,325,89,1646,1204,24,24,18,291,67,1628,
20221004,715,716,동안동,청송,1067,16,15,7,10,51,1166,1026,16,7,7,12,56,1124,
20221004,716,715,청송,동안동,1026,16,7,7,12,56,1124,1067,16,15,7,10,51,1166,
20221004,730,519,유천,남대구,2759,47,14,1,0,218,3039,2333,54,19,1,3,176,2586,
20221004,731,519,북현풍,남대구,1508,22,6,0,0,104,1640,1885,30,31,0,0,117,2063,
20221004,741,253,평택고덕,서서울,985,34,24,27,15,82,1167,1276,17,20,28,8,95,1444,
20221004,741,540,평택고덕,청북,816,29,47,55,16,80,1043,823,24,43,43,15,82,1030,
20221004,742,107,남사진위,안성,1285,48,47,24,7,118,1529,1113,41,46,17,6,106,1329,
20221004,742,108,남사진위,천안,1010,36,32,29,8,73,1188,1034,25,31,15,10,71,1186,
20221004,752,252,기장철마,대동,1818,54,58,35,64,141,2170,1756,56,44,39,111,128,2134,
20221004,753,252,금정,대동,1071,55,69,69,88,60,1412,1727,84,93,97,177,112,2290,
20221004,755,140,광재,부산,931,15,8,5,26,66,1051,1059,16,15,3,18,72,1183,
20221004,755,252,광재,대동,2300,106,76,113,377,126,3098,2261,102,74,113,277,147,2974,
20221004,772,774,북달성,남칠곡,2379,50,41,37,41,145,2693,2428,50,52,41,32,151,2754,
20221004,773,774,북다사,남칠곡,1271,19,13,12,10,79,1404,1236,16,20,15,5,70,1362,
20221004,774,772,남칠곡,북달성,2428,50,52,41,32,151,2754,2379,50,41,37,41,145,2693,
20221004,774,773,남칠곡,북다사,1236,16,20,15,5,70,1362,1271,19,13,12,10,79,1404,
20221004,775,203,동명동호,가산,1574,64,36,48,181,72,1975,1617,44,39,46,233,75,2054,
20221004,776,777,연경,파군재,3184,38,24,12,35,209,3502,2334,35,27,10,33,165,2604,
20221004,776,779,연경,율암,5562,73,52,58,178,408,6331,5936,82,70,77,180,403,6748,
20221004,777,776,파군재,연경,2334,35,27,10,33,165,2604,3184,38,24,12,35,209,3502,
20221004,777,779,파군재,율암,2287,15,17,5,7,209,2540,2287,15,17,3,4,221,2547,
20221004,779,776,율암,연경,5936,82,70,77,180,403,6748,5562,73,52,58,178,408,6331,
20221004,779,777,율암,파군재,2287,15,17,3,4,221,2547,2287,15,17,5,7,209,2540,
20221004,876,675,양감,서오산,2100,66,33,29,113,148,2489,1884,55,35,34,116,110,2234,
20221004,876,677,양감,북평택,2040,158,159,204,132,155,2848,2200,159,164,220,167,148,3058,
20221004,981,982,서영암,강진무위사,1844,41,66,53,33,78,2115,1808,39,95,60,39,68,2109,
20221004,981,987,서영암,남순천,1305,26,62,65,288,32,1778,1615,22,63,88,272,66,2126,
20221004,982,981,강진무위사,서영암,1808,39,95,60,39,68,2109,1844,41,66,53,33,78,2115,
20221004,984,985,보성,벌교,1387,40,32,30,39,33,1561,1208,42,48,27,36,36,1397,
20221004,984,987,보성,남순천,1660,41,78,70,251,64,2164,1786,51,83,68,242,64,2294,
20221004,985,984,벌교,보성,1208,42,48,27,36,36,1397,1387,40,32,30,39,33,1561,
20221004,986,987,고흥,남순천,3367,70,96,113,171,124,3941,3777,69,103,100,181,124,4354,
20221004,987,981,남순천,서영암,1615,22,63,88,272,66,2126,1305,26,62,65,288,32,1778,
20221004,987,984,남순천,보성,1786,51,83,68,242,64,2294,1660,41,78,70,251,64,2164,
20221004,987,986,남순천,고흥,3777,69,103,100,181,124,4354,3367,70,96,113,171,124,3941,
20221005,101,102,서울,동수원,3684,41,251,22,4,195,4197,5200,58,383,29,14,283,5967,
20221005,101,103,서울,수원신갈,14756,639,1698,416,138,752,18399,14623,701,1710,368,140,702,18244,
20221005,101,105,서울,기흥,7017,111,406,81,48,296,7959,5816,97,350,102,44,299,6708,
20221005,101,106,서울,오산,4461,374,431,163,120,298,5847,4295,481,458,197,116,241,5788,
20221005,101,107,서울,안성,3161,94,301,32,11,172,3771,2901,81,298,54,20,156,3510,
20221005,101,108,서울,천안,3837,67,353,40,11,175,4483,3511,46,335,62,25,138,4117,
20221005,101,111,서울,청주,869,19,189,24,21,31,1153,728,15,217,25,20,28,1033,
20221005,101,171,서울,마성,1977,26,219,60,6,99,2387,2389,20,259,63,5,139,2875,
20221005,101,172,서울,용인,3554,124,128,42,57,208,4113,4009,129,141,46,31,272,4628,
20221005,101,173,서울,양지,3408,219,137,114,52,126,4056,4506,398,156,174,106,196,5536,
20221005,101,175,서울,덕평,714,64,111,39,43,33,1004,761,138,91,45,61,45,1141,
20221005,101,229,서울,북천안,917,48,40,51,22,48,1126,813,62,33,66,32,37,1043,
20221005,101,528,서울,기흥동탄,7042,72,1162,138,21,362,8797,7198,63,1295,128,15,323,9022,
20221005,101,542,서울,서안성,1279,49,97,97,29,62,1613,1694,53,73,173,66,72,2131,
20221005,101,543,서울,남안성,1216,74,77,68,59,36,1530,1227,91,92,113,82,38,1643,
20221005,101,673,서울,북오산,1626,47,127,19,10,113,1942,1512,41,113,27,9,109,1811,
20221005,101,677,서울,북평택,1784,59,260,92,87,85,2367,1391,73,269,92,123,47,1995,
20221005,102,101,동수원,서울,5200,58,383,29,14,283,5967,3684,41,251,22,4,195,4197,
20221005,102,172,동수원,용인,1069,33,13,3,4,96,1218,988,33,15,1,1,106,1144,
20221005,102,173,동수원,양지,1242,43,34,11,31,65,1426,1429,54,33,13,14,80,1623,
20221005,102,212,동수원,북수원,4179,22,220,22,36,232,4711,4644,33,231,20,22,265,5215,
20221005,102,213,동수원,부곡,1071,11,14,4,36,69,1205,1032,18,19,4,27,80,1180,
20221005,102,214,동수원,동군포,1559,26,18,10,6,102,1721,1539,19,17,5,5,110,1695,
20221005,102,215,동수원,군포,1645,22,27,6,16,113,1829,2322,24,51,5,3,166,2571,
20221005,102,253,동수원,서서울,5846,68,61,21,14,360,6370,5256,70,61,21,11,345,5764,
20221005,102,254,동수원,군자,3767,60,76,16,42,211,4172,4195,64,79,28,44,263,4673,
20221005,102,255,동수원,서안산,1790,47,16,8,7,103,1971,1964,39,17,14,4,122,2160,
20221005,103,101,수원신갈,서울,14623,701,1710,368,140,702,18244,14756,639,1698,416,138,752,18399,
20221005,103,105,수원신갈,기흥,1646,33,40,31,19,118,1887,2151,31,30,27,25,129,2393,
20221005,103,106,수원신갈,오산,1143,65,64,36,16,73,1397,1312,71,79,54,13,92,1621,
20221005,103,108,수원신갈,천안,960,11,50,14,2,34,1071,1143,17,49,19,0,57,1285,
20221005,103,253,수원신갈,서서울,1765,120,75,57,25,104,2146,2114,143,81,84,38,115,2575,
20221005,103,254,수원신갈,군자,1295,80,49,85,83,67,1659,1679,137,77,120,112,106,2231,
20221005,103,528,수원신갈,기흥동탄,1462,16,205,3,9,109,1804,2071,21,177,1,4,108,2382,
20221005,105,101,기흥,서울,5816,97,350,102,44,299,6708,7017,111,406,81,48,296,7959,
20221005,105,103,기흥,수원신갈,2151,31,30,27,25,129,2393,1646,33,40,31,19,118,1887,
20221005,106,101,오산,서울,4295,481,458,197,116,241,5788,4461,374,431,163,120,298,5847,
20221005,106,103,오산,수원신갈,1312,71,79,54,13,92,1621,1143,65,64,36,16,73,1397,
20221005,106,107,오산,안성,1651,44,30,18,12,144,1899,1506,47,18,14,7,139,1731,
20221005,106,108,오산,천안,1051,21,28,15,14,60,1189,1021,18,31,20,13,62,1165,
20221005,106,528,오산,기흥동탄,879,41,39,17,10,72,1058,936,40,49,19,9,85,1138,
20221005,107,101,안성,서울,2901,81,298,54,20,156,3510,3161,94,301,32,11,172,3771,
20221005,107,106,안성,오산,1506,47,18,14,7,139,1731,1651,44,30,18,12,144,1899,
20221005,107,108,안성,천안,1560,28,45,9,7,128,1777,1563,41,43,13,8,124,1792,
20221005,107,528,안성,기흥동탄,1050,12,18,6,3,94,1183,1233,20,22,2,9,119,1405,
20221005,107,742,안성,남사진위,1279,40,52,25,6,125,1527,1349,40,57,33,10,122,1611,
20221005,108,101,천안,서울,3511,46,335,62,25,138,4117,3837,67,353,40,11,175,4483,
20221005,108,103,천안,수원신갈,1143,17,49,19,0,57,1285,960,11,50,14,2,34,1071,
20221005,108,106,천안,오산,1021,18,31,20,13,62,1165,1051,21,28,15,14,60,1189,
20221005,108,107,천안,안성,1563,41,43,13,8,124,1792,1560,28,45,9,7,128,1777,
20221005,108,111,천안,청주,1074,36,66,21,44,60,1301,1104,32,58,33,27,58,1312,
20221005,108,229,천안,북천안,3598,70,121,47,33,209,4078,3900,87,119,57,98,252,4513,
20221005,108,528,천안,기흥동탄,1093,19,103,6,16,61,1298,1115,19,120,3,14,69,1340,
20221005,108,742,천안,남사진위,1072,26,39,26,6,74,1243,1051,29,41,31,7,63,1222,
20221005,111,101,청주,서울,728,15,217,25,20,28,1033,869,19,189,24,21,31,1153,
20221005,111,108,청주,천안,1104,32,58,33,27,58,1312,1074,36,66,21,44,60,1301,
20221005,112,115,남청주,대전,1549,94,63,16,20,121,1863,1611,114,58,8,22,115,1928,
20221005,113,115,신탄진,대전,967,28,13,11,8,112,1139,1102,31,11,7,8,130,1289,
20221005,114,153,남대전,서대전,1953,47,68,62,23,140,2293,1747,37,90,78,20,130,2102,
20221005,115,112,대전,남청주,1611,114,58,8,22,115,1928,1549,94,63,16,20,121,1863,
20221005,115,113,대전,신탄진,1102,31,11,7,8,130,1289,967,28,13,11,8,112,1139,
20221005,115,116,대전,옥천,2348,131,55,29,23,165,2751,2077,85,43,39,24,158,2426,
20221005,115,151,대전,북대전,1083,15,13,10,6,139,1266,904,12,14,5,12,106,1053,
20221005,115,152,대전,유성,1004,10,9,1,1,69,1094,928,13,21,1,3,64,1030,
20221005,115,153,대전,서대전,956,25,11,1,4,66,1063,892,17,11,3,5,76,1004,
20221005,115,198,대전,서청주,915,19,8,11,1,70,1024,893,16,8,10,8,75,1010,
20221005,115,579,대전,남세종,1086,14,20,6,35,85,1246,1100,19,18,6,26,88,1257,
20221005,116,115,옥천,대전,2077,85,43,39,24,158,2426,2348,131,55,29,23,165,2751,
20221005,119,153,판암,서대전,1694,27,14,45,9,165,1954,1785,31,18,52,7,146,2039,
20221005,123,127,구미,서대구,1660,38,26,17,5,107,1853,1649,28,30,22,9,91,1829,
20221005,123,129,구미,북대구,1848,13,54,9,8,81,2013,1908,18,62,11,1,112,2112,
20221005,123,130,구미,동김천,1205,37,31,47,58,75,1453,1119,36,31,26,60,71,1343,
20221005,125,127,남구미,서대구,1871,44,107,40,14,116,2192,1987,66,114,41,15,117,2340,
20221005,125,129,남구미,북대구,1859,26,75,11,8,105,2084,2066,31,71,17,11,110,2306,
20221005,126,127,왜관,서대구,2549,117,75,40,142,138,3061,2763,119,80,50,92,146,3250,
20221005,126,129,왜관,북대구,3124,116,53,33,74,129,3529,3566,117,69,28,72,167,4019,
20221005,127,123,서대구,구미,1649,28,30,22,9,91,1829,1660,38,26,17,5,107,1853,
20221005,127,125,서대구,남구미,1987,66,114,41,15,117,2340,1871,44,107,40,14,116,2192,
20221005,127,126,서대구,왜관,2763,119,80,50,92,146,3250,2549,117,75,40,142,138,3061,
20221005,127,131,서대구,경산,2481,204,144,108,57,162,3156,1893,177,114,93,52,120,2449,
20221005,127,203,서대구,가산,2103,64,75,48,135,89,2514,1951,59,55,38,141,99,2343,
20221005,127,230,서대구,팔공산,1413,49,36,27,5,90,1620,1047,32,29,18,5,84,1215,
20221005,127,518,서대구,칠곡물류,858,134,81,112,52,45,1282,754,100,64,89,42,39,1088,
20221005,127,621,서대구,동대구,1777,71,63,37,34,125,2107,1342,46,40,29,36,102,1595,
20221005,129,123,북대구,구미,1908,18,62,11,1,112,2112,1848,13,54,9,8,81,2013,
20221005,129,125,북대구,남구미,2066,31,71,17,11,110,2306,1859,26,75,11,8,105,2084,
20221005,129,126,북대구,왜관,3566,117,69,28,72,167,4019,3124,116,53,33,74,129,3529,
20221005,129,131,북대구,경산,2550,169,111,87,43,126,3086,3013,201,124,97,47,174,3656,
20221005,129,524,북대구,청통와촌,972,63,33,14,21,39,1142,1174,77,33,21,24,39,1368,
20221005,129,527,북대구,포항,1505,24,20,27,65,83,1724,1799,37,23,27,74,106,2066,
20221005,130,123,동김천,구미,1119,36,31,26,60,71,1343,1205,37,31,47,58,75,1453,
20221005,131,127,경산,서대구,1893,177,114,93,52,120,2449,2481,204,144,108,57,162,3156,
20221005,131,129,경산,북대구,3013,201,124,97,47,174,3656,2550,169,111,87,43,126,3086,
20221005,131,132,경산,영천,883,48,53,81,60,38,1163,837,53,58,79,30,33,1090,
20221005,131,230,경산,팔공산,1305,93,48,22,11,97,1576,1513,99,67,96,25,90,1890,
20221005,131,621,경산,동대구,2239,71,50,217,48,131,2756,2422,84,47,165,31,134,2883,
20221005,132,131,영천,경산,837,53,58,79,30,33,1090,883,48,53,81,60,38,1163,
20221005,132,621,영천,동대구,1103,15,25,2,40,56,1241,1153,17,21,2,44,62,1299,
20221005,135,140,경주,부산,1036,15,27,9,42,44,1173,1099,11,30,13,24,52,1229,
20221005,135,252,경주,대동,805,34,77,46,164,47,1173,1061,41,73,38,80,41,1334,
20221005,138,140,양산,부산,5247,277,192,299,259,293,6567,5532,294,199,324,265,285,6899,
20221005,138,252,양산,대동,2635,363,221,231,342,112,3904,3015,378,210,221,353,135,4312,
20221005,139,140,서울산,부산,1178,40,19,10,33,62,1342,1125,48,21,10,26,70,1300,
20221005,139,641,서울산,울산,1075,35,61,32,41,105,1349,959,17,45,11,22,74,1128,
20221005,140,135,부산,경주,1099,11,30,13,24,52,1229,1036,15,27,9,42,44,1173,
20221005,140,138,부산,양산,5532,294,199,324,265,285,6899,5247,277,192,299,259,293,6567,
20221005,140,139,부산,서울산,1125,48,21,10,26,70,1300,1178,40,19,10,33,62,1342,
20221005,140,250,부산,남양산,7928,142,218,27,34,619,8968,7628,142,206,26,41,649,8692,
20221005,140,251,부산,물금,1035,123,32,33,43,83,1349,997,92,33,36,55,66,1279,
20221005,140,252,부산,대동,1754,51,49,48,97,103,2102,1579,42,28,48,118,102,1917,
20221005,140,755,부산,광재,1085,19,15,10,57,75,1261,951,14,17,6,23,81,1092,
20221005,142,145,군북,산인,3826,75,120,50,93,284,4448,3808,65,134,55,78,282,4422,
20221005,143,145,장지,산인,1277,25,30,23,51,101,1507,1293,28,30,22,62,105,1540,
20221005,144,145,함안,산인,1965,44,51,26,101,142,2329,1973,46,57,29,74,133,2312,
20221005,145,142,산인,군북,3808,65,134,55,78,282,4422,3826,75,120,50,93,284,4448,
20221005,145,143,산인,장지,1293,28,30,22,62,105,1540,1277,25,30,23,51,101,1507,
20221005,145,144,산인,함안,1973,46,57,29,74,133,2312,1965,44,51,26,101,142,2329,
20221005,145,291,산인,사천,1200,45,57,14,18,52,1386,1282,63,68,28,26,63,1530,
20221005,145,292,산인,진주,1201,31,147,10,17,96,1502,1460,28,132,14,20,111,1765,
20221005,145,293,산인,문산,1140,29,21,13,4,77,1284,1018,23,24,15,8,60,1148,
20221005,146,150,동창원,북부산,995,18,14,8,17,73,1125,926,17,17,3,6,70,1039,
20221005,146,244,동창원,서부산,1208,28,34,19,22,70,1381,1247,39,33,22,35,72,1448,
20221005,146,245,동창원,장유,945,14,17,5,8,92,1081,965,20,16,10,2,81,1094,
20221005,146,289,동창원,마산,2674,84,97,90,86,216,3247,2499,82,80,86,52,212,3011,
20221005,147,150,진례,북부산,1413,45,23,20,54,79,1634,1620,61,25,16,33,98,1853,
20221005,147,244,진례,서부산,1754,113,81,81,113,110,2252,1903,119,77,76,105,114,2394,
20221005,147,245,진례,장유,1153,63,80,101,22,108,1527,1477,62,87,97,23,133,1879,
20221005,147,289,진례,마산,1283,115,98,60,84,78,1718,1232,99,87,60,90,86,1654,
20221005,148,150,서김해,북부산,6598,132,91,97,101,528,7547,6403,119,82,106,57,486,7253,
20221005,148,251,서김해,물금,850,38,25,26,15,91,1045,873,52,20,32,11,97,1085,
20221005,148,289,서김해,마산,1436,30,57,8,12,122,1665,1406,31,52,21,9,117,1636,
20221005,149,150,동김해,북부산,10658,198,186,53,109,904,12108,9090,171,139,56,59,737,10252,
20221005,149,245,동김해,장유,888,43,91,102,10,74,1208,756,52,88,100,2,71,1069,
20221005,149,250,동김해,남양산,1116,23,49,9,7,92,1296,966,22,49,4,10,80,1131,
20221005,149,251,동김해,물금,1121,47,15,12,5,123,1323,1056,41,11,11,4,117,1240,
20221005,150,146,북부산,동창원,926,17,17,3,6,70,1039,995,18,14,8,17,73,1125,
20221005,150,147,북부산,진례,1620,61,25,16,33,98,1853,1413,45,23,20,54,79,1634,
20221005,150,148,북부산,서김해,6403,119,82,106,57,486,7253,6598,132,91,97,101,528,7547,
20221005,150,149,북부산,동김해,9090,171,139,56,59,737,10252,10658,198,186,53,109,904,12108,
20221005,150,245,북부산,장유,3647,45,106,21,37,254,4110,3142,38,87,13,30,233,3543,
20221005,150,289,북부산,마산,2368,39,73,13,25,139,2657,2599,36,66,16,46,155,2918,
20221005,151,115,북대전,대전,904,12,14,5,12,106,1053,1083,15,13,10,6,139,1266,
20221005,151,153,북대전,서대전,1131,20,15,17,12,93,1288,1300,16,26,27,15,104,1488,
20221005,152,115,유성,대전,928,13,21,1,3,64,1030,1004,10,9,1,1,69,1094,
20221005,152,154,유성,안영,949,18,23,5,7,70,1072,1136,22,18,4,16,62,1258,
20221005,153,114,서대전,남대전,1747,37,90,78,20,130,2102,1953,47,68,62,23,140,2293,
20221005,153,115,서대전,대전,892,17,11,3,5,76,1004,956,25,11,1,4,66,1063,
20221005,153,119,서대전,판암,1785,31,18,52,7,146,2039,1694,27,14,45,9,165,1954,
20221005,153,151,서대전,북대전,1300,16,26,27,15,104,1488,1131,20,15,17,12,93,1288,
20221005,153,154,서대전,안영,1105,40,40,64,50,76,1375,1097,43,46,53,23,67,1329,
20221005,153,579,서대전,남세종,1188,15,19,10,6,102,1340,1095,18,32,7,12,82,1246,
20221005,154,152,안영,유성,1136,22,18,4,16,62,1258,949,18,23,5,7,70,1072,
20221005,154,153,안영,서대전,1097,43,46,53,23,67,1329,1105,40,40,64,50,76,1375,
20221005,159,167,서전주,광주,1335,66,91,76,54,49,1671,1358,62,60,63,49,61,1653,
20221005,166,167,장성,광주,2180,78,58,27,58,75,2476,2605,123,70,34,44,92,2968,
20221005,167,159,광주,서전주,1358,62,60,63,49,61,1653,1335,66,91,76,54,49,1671,
20221005,167,166,광주,장성,2605,123,70,34,44,92,2968,2180,78,58,27,58,75,2476,
20221005,167,567,광주,남고창,1336,24,46,16,47,46,1515,1328,22,47,15,47,46,1505,
20221005,171,101,마성,서울,2389,20,259,63,5,139,2875,1977,26,219,60,6,99,2387,
20221005,172,101,용인,서울,4009,129,141,46,31,272,4628,3554,124,128,42,57,208,4113,
20221005,172,102,용인,동수원,988,33,15,1,1,106,1144,1069,33,13,3,4,96,1218,
20221005,172,173,용인,양지,1916,233,140,149,56,137,2631,1864,193,148,152,67,150,2574,
20221005,172,253,용인,서서울,1055,55,25,29,32,63,1259,1142,61,30,25,20,73,1351,
20221005,173,101,양지,서울,4506,398,156,174,106,196,5536,3408,219,137,114,52,126,4056,
20221005,173,102,양지,동수원,1429,54,33,13,14,80,1623,1242,43,34,11,31,65,1426,
20221005,173,172,양지,용인,1864,193,148,152,67,150,2574,1916,233,140,149,56,137,2631,
20221005,173,212,양지,북수원,1091,87,44,51,32,65,1370,1306,99,55,40,37,61,1598,
20221005,173,253,양지,서서울,1141,158,83,126,56,53,1617,917,125,60,118,31,44,1295,
20221005,173,254,양지,군자,718,116,84,185,230,37,1370,682,112,100,158,209,39,1300,
20221005,174,179,춘천,홍천,3197,51,87,46,27,306,3714,3021,61,77,45,22,317,3543,
20221005,174,216,춘천,횡성,975,46,38,35,30,55,1179,1068,42,26,28,21,59,1244,
20221005,174,218,춘천,남원주,990,20,80,14,14,55,1173,950,21,76,14,15,69,1145,
20221005,174,554,춘천,동홍천,1175,19,15,16,6,87,1318,1243,14,16,5,4,82,1364,
20221005,175,101,덕평,서울,761,138,91,45,61,45,1141,714,64,111,39,43,33,1004,
20221005,176,190,이천,동서울,1427,63,208,173,160,72,2103,1450,61,203,148,104,77,2043,
20221005,179,174,홍천,춘천,3021,61,77,45,22,317,3543,3197,51,87,46,27,306,3714,
20221005,184,189,대관령,강릉,1033,29,53,8,9,74,1206,1061,26,39,7,7,85,1225,
20221005,189,184,강릉,대관령,1061,26,39,7,7,85,1225,1033,29,53,8,9,74,1206,
20221005,190,176,동서울,이천,1450,61,203,148,104,77,2043,1427,63,208,173,160,72,2103,
20221005,190,191,동서울,경기광주,10917,691,470,347,330,718,13473,10403,669,432,326,379,708,12917,
20221005,190,192,동서울,곤지암,5843,538,248,197,85,390,7301,5291,459,171,178,73,357,6529,
20221005,190,193,동서울,일죽,2451,154,209,170,142,96,3222,2340,173,193,254,132,85,3177,
20221005,190,194,동서울,서이천,4179,628,337,295,168,251,5858,3245,457,249,232,133,199,4515,
20221005,190,560,동서울,감곡,881,27,42,46,87,23,1106,857,36,37,35,104,25,1094,
20221005,190,705,동서울,남이천,1494,94,59,169,92,33,1941,1657,112,53,142,57,52,2073,
20221005,191,190,경기광주,동서울,10403,669,432,326,379,708,12917,10917,691,470,347,330,718,13473,
20221005,192,190,곤지암,동서울,5291,459,171,178,73,357,6529,5843,538,248,197,85,390,7301,
20221005,192,194,곤지암,서이천,1349,283,138,173,105,105,2153,1089,163,114,120,111,83,1680,
20221005,193,190,일죽,동서울,2340,173,193,254,132,85,3177,2451,154,209,170,142,96,3222,
20221005,194,190,서이천,동서울,3245,457,249,232,133,199,4515,4179,628,337,295,168,251,5858,
20221005,194,192,서이천,곤지암,1089,163,114,120,111,83,1680,1349,283,138,173,105,105,2153,
20221005,196,198,진천,서청주,1366,40,81,44,29,83,1643,1369,35,87,34,28,82,1635,
20221005,198,115,서청주,대전,893,16,8,10,8,75,1010,915,19,8,11,1,70,1024,
20221005,198,196,서청주,진천,1369,35,87,34,28,82,1635,1366,40,81,44,29,83,1643,
20221005,201,203,칠곡,가산,965,44,44,39,116,61,1269,889,48,50,37,136,46,1206,
20221005,203,127,가산,서대구,1951,59,55,38,141,99,2343,2103,64,75,48,135,89,2514,
20221005,203,201,가산,칠곡,889,48,50,37,136,46,1206,965,44,44,39,116,61,1269,
20221005,203,775,가산,동명동호,1694,69,55,58,245,76,2197,1768,74,47,49,200,68,2206,
20221005,212,102,북수원,동수원,4644,33,231,20,22,265,5215,4179,22,220,22,36,232,4711,
20221005,212,173,북수원,양지,1306,99,55,40,37,61,1598,1091,87,44,51,32,65,1370,
20221005,212,253,북수원,서서울,3462,58,32,17,20,223,3812,1035,37,12,11,6,59,1160,
20221005,212,254,북수원,군자,1952,40,38,25,23,111,2189,1111,24,26,13,10,75,1259,
20221005,213,102,부곡,동수원,1032,18,19,4,27,80,1180,1071,11,14,4,36,69,1205,
20221005,213,253,부곡,서서울,1537,65,42,33,205,107,1989,1072,48,34,41,169,79,1443,
20221005,213,254,부곡,군자,1014,28,26,43,542,69,1722,915,36,26,58,432,69,1536,
20221005,214,102,동군포,동수원,1539,19,17,5,5,110,1695,1559,26,18,10,6,102,1721,
20221005,215,102,군포,동수원,2322,24,51,5,3,166,2571,1645,22,27,6,16,113,1829,
20221005,215,253,군포,서서울,3323,102,65,39,54,225,3808,3601,136,135,195,139,245,4451,
20221005,215,254,군포,군자,2144,71,74,45,117,157,2608,2921,144,104,163,182,200,3714,
20221005,215,255,군포,서안산,1408,48,30,17,14,116,1633,1672,76,72,74,111,126,2131,
20221005,216,174,횡성,춘천,1068,42,26,28,21,59,1244,975,46,38,35,30,55,1179,
20221005,218,174,남원주,춘천,950,21,76,14,15,69,1145,990,20,80,14,14,55,1173,
20221005,218,240,남원주,제천,2109,62,61,22,40,137,2431,2103,60,49,17,25,135,2389,
20221005,225,291,서진주,사천,936,25,28,7,21,62,1079,946,18,39,5,22,79,1109,
20221005,229,101,북천안,서울,813,62,33,66,32,37,1043,917,48,40,51,22,48,1126,
20221005,229,108,북천안,천안,3900,87,119,57,98,252,4513,3598,70,121,47,33,209,4078,
20221005,230,127,팔공산,서대구,1047,32,29,18,5,84,1215,1413,49,36,27,5,90,1620,
20221005,230,131,팔공산,경산,1513,99,67,96,25,90,1890,1305,93,48,22,11,97,1576,
20221005,230,524,팔공산,청통와촌,1213,44,38,15,14,50,1374,1070,45,21,14,22,47,1219,
20221005,230,527,팔공산,포항,1434,31,12,4,15,61,1557,1246,25,12,4,22,61,1370,
20221005,231,519,화원옥포,남대구,6520,189,114,163,112,506,7604,6435,153,111,148,96,473,7416,
20221005,232,519,달성,남대구,2782,135,153,48,43,209,3370,3055,130,162,46,33,205,3631,
20221005,233,519,현풍,남대구,5054,228,232,67,171,361,6113,4383,204,203,108,150,297,5345,
20221005,237,239,남지,칠원,779,23,38,26,106,67,1039,749,27,37,44,87,63,1007,
20221005,238,239,칠서,칠원,1631,102,132,162,330,93,2450,1652,117,115,142,305,111,2442,
20221005,239,237,칠원,남지,749,27,37,44,87,63,1007,779,23,38,26,106,67,1039,
20221005,239,238,칠원,칠서,1652,117,115,142,305,111,2442,1631,102,132,162,330,93,2450,
20221005,239,519,칠원,남대구,1006,47,87,38,95,37,1310,1051,55,95,50,67,34,1352,
20221005,240,218,제천,남원주,2103,60,49,17,25,135,2389,2109,62,61,22,40,137,2431,
20221005,241,519,동고령,남대구,3157,103,93,355,155,161,4024,3113,112,98,346,173,153,3995,
20221005,242,519,고령,남대구,1535,38,73,22,208,86,1962,1694,30,66,20,206,78,2094,
20221005,244,146,서부산,동창원,1247,39,33,22,35,72,1448,1208,28,34,19,22,70,1381,
20221005,244,147,서부산,진례,1903,119,77,76,105,114,2394,1754,113,81,81,113,110,2252,
20221005,244,245,서부산,장유,12815,259,399,236,402,975,15086,12395,249,394,231,393,922,14584,
20221005,244,289,서부산,마산,2892,59,244,58,87,169,3509,2773,57,233,44,95,150,3352,
20221005,245,146,장유,동창원,965,20,16,10,2,81,1094,945,14,17,5,8,92,1081,
20221005,245,147,장유,진례,1477,62,87,97,23,133,1879,1153,63,80,101,22,108,1527,
20221005,245,149,장유,동김해,756,52,88,100,2,71,1069,888,43,91,102,10,74,1208,
20221005,245,150,장유,북부산,3142,38,87,13,30,233,3543,3647,45,106,21,37,254,4110,
20221005,245,244,장유,서부산,12395,249,394,231,393,922,14584,12815,259,399,236,402,975,15086,
20221005,245,289,장유,마산,1423,34,36,19,18,129,1659,1330,36,32,31,16,110,1555,
20221005,248,261,순창,동광주,1264,25,22,11,16,58,1396,1230,26,32,17,13,54,1372,
20221005,249,261,담양,동광주,2306,38,127,31,29,105,2636,1774,32,122,29,18,86,2061,
20221005,250,140,남양산,부산,7628,142,206,26,41,649,8692,7928,142,218,27,34,619,8968,
20221005,250,149,남양산,동김해,966,22,49,4,10,80,1131,1116,23,49,9,7,92,1296,
20221005,250,252,남양산,대동,3412,148,91,115,98,235,4099,4067,177,117,98,121,285,4865,
20221005,251,140,물금,부산,997,92,33,36,55,66,1279,1035,123,32,33,43,83,1349,
20221005,251,148,물금,서김해,873,52,20,32,11,97,1085,850,38,25,26,15,91,1045,
20221005,251,149,물금,동김해,1056,41,11,11,4,117,1240,1121,47,15,12,5,123,1323,
20221005,251,252,물금,대동,3222,218,94,154,497,218,4403,3897,222,106,169,636,280,5310,
20221005,252,135,대동,경주,1061,41,73,38,80,41,1334,805,34,77,46,164,47,1173,
20221005,252,138,대동,양산,3015,378,210,221,353,135,4312,2635,363,221,231,342,112,3904,
20221005,252,140,대동,부산,1579,42,28,48,118,102,1917,1754,51,49,48,97,103,2102,
20221005,252,250,대동,남양산,4067,177,117,98,121,285,4865,3412,148,91,115,98,235,4099,
20221005,252,251,대동,물금,3897,222,106,169,636,280,5310,3222,218,94,154,497,218,4403,
20221005,252,641,대동,울산,1705,69,96,34,44,86,2034,1337,62,95,42,63,66,1665,
20221005,252,752,대동,기장철마,1875,83,50,43,108,150,2309,1864,91,54,44,57,148,2258,
20221005,252,753,대동,금정,1919,107,77,87,174,122,2486,1104,84,68,60,79,74,1469,
20221005,252,755,대동,광재,2427,121,100,69,315,174,3206,2262,97,79,65,398,139,3040,
20221005,252,756,대동,한림,860,52,32,37,114,42,1137,903,44,34,31,117,40,1169,
20221005,253,102,서서울,동수원,5256,70,61,21,11,345,5764,5846,68,61,21,14,360,6370,
20221005,253,103,서서울,수원신갈,2114,143,81,84,38,115,2575,1765,120,75,57,25,104,2146,
20221005,253,172,서서울,용인,1142,61,30,25,20,73,1351,1055,55,25,29,32,63,1259,
20221005,253,173,서서울,양지,917,125,60,118,31,44,1295,1141,158,83,126,56,53,1617,
20221005,253,212,서서울,북수원,1035,37,12,11,6,59,1160,3462,58,32,17,20,223,3812,
20221005,253,213,서서울,부곡,1072,48,34,41,169,79,1443,1537,65,42,33,205,107,1989,
20221005,253,215,서서울,군포,3601,136,135,195,139,245,4451,3323,102,65,39,54,225,3808,
20221005,253,255,서서울,서안산,15193,556,613,507,281,907,18057,14936,557,560,462,271,884,17670,
20221005,253,256,서서울,안산,9082,178,86,54,34,641,10075,5934,109,67,41,53,402,6606,
20221005,253,281,서서울,매송,3758,73,46,18,22,232,4149,3819,61,42,30,53,247,4252,
20221005,253,282,서서울,비봉,5672,284,260,177,525,337,7255,5687,310,268,203,593,352,7413,
20221005,253,283,서서울,발안,3412,168,173,147,194,199,4293,3585,222,160,170,179,194,4510,
20221005,253,285,서서울,서평택,1429,69,107,199,358,80,2242,1555,91,119,310,513,93,2681,
20221005,253,287,서서울,송악,1833,35,77,83,267,79,2374,1679,43,74,104,456,67,2423,
20221005,253,288,서서울,당진,1229,26,47,18,36,77,1433,1247,26,56,54,53,58,1494,
20221005,253,298,서서울,서산,2129,25,61,50,22,88,2375,1891,24,60,51,72,72,2170,
20221005,253,520,서서울,평택,2005,130,115,187,157,98,2692,1822,117,128,230,135,85,2517,
20221005,253,540,서서울,청북,817,48,69,111,53,53,1151,900,65,49,130,96,46,1286,
20221005,253,741,서서울,평택고덕,982,26,24,15,8,91,1146,922,28,29,21,9,57,1066,
20221005,254,102,군자,동수원,4195,64,79,28,44,263,4673,3767,60,76,16,42,211,4172,
20221005,254,103,군자,수원신갈,1679,137,77,120,112,106,2231,1295,80,49,85,83,67,1659,
20221005,254,173,군자,양지,682,112,100,158,209,39,1300,718,116,84,185,230,37,1370,
20221005,254,212,군자,북수원,1111,24,26,13,10,75,1259,1952,40,38,25,23,111,2189,
20221005,254,213,군자,부곡,915,36,26,58,432,69,1536,1014,28,26,43,542,69,1722,
20221005,254,215,군자,군포,2921,144,104,163,182,200,3714,2144,71,74,45,117,157,2608,
20221005,254,255,군자,서안산,9813,439,199,249,281,700,11681,9787,429,199,199,302,690,11606,
20221005,254,256,군자,안산,4473,135,114,45,54,376,5197,4789,129,101,41,66,387,5513,
20221005,254,281,군자,매송,1063,31,16,16,67,77,1270,862,27,16,16,58,61,1040,
20221005,254,282,군자,비봉,1371,122,82,72,209,102,1958,1051,110,63,59,181,82,1546,
20221005,254,283,군자,발안,1192,100,50,64,155,69,1630,975,74,57,59,131,58,1354,
20221005,255,102,서안산,동수원,1964,39,17,14,4,122,2160,1790,47,16,8,7,103,1971,
20221005,255,215,서안산,군포,1672,76,72,74,111,126,2131,1408,48,30,17,14,116,1633,
20221005,255,253,서안산,서서울,14936,557,560,462,271,884,17670,15193,556,613,507,281,907,18057,
20221005,255,254,서안산,군자,9787,429,199,199,302,690,11606,9813,439,199,249,281,700,11681,
20221005,256,253,안산,서서울,5934,109,67,41,53,402,6606,9082,178,86,54,34,641,10075,
20221005,256,254,안산,군자,4789,129,101,41,66,387,5513,4473,135,114,45,54,376,5197,
20221005,261,248,동광주,순창,1230,26,32,17,13,54,1372,1264,25,22,11,16,58,1396,
20221005,261,249,동광주,담양,1774,32,122,29,18,86,2061,2306,38,127,31,29,105,2636,
20221005,261,262,동광주,창평,1505,81,34,28,54,54,1756,1770,65,37,35,52,61,2020,
20221005,261,263,동광주,옥과,2677,34,126,21,88,119,3065,2814,23,123,16,118,130,3224,
20221005,261,265,동광주,곡성,1532,29,40,19,59,57,1736,1454,26,38,15,46,57,1636,
20221005,261,271,동광주,순천,2938,97,98,28,107,94,3362,2702,94,82,40,116,86,3120,
20221005,262,261,창평,동광주,1770,65,37,35,52,61,2020,1505,81,34,28,54,54,1756,
20221005,263,261,옥과,동광주,2814,23,123,16,118,130,3224,2677,34,126,21,88,119,3065,
20221005,265,261,곡성,동광주,1454,26,38,15,46,57,1636,1532,29,40,19,59,57,1736,
20221005,271,261,순천,동광주,2702,94,82,40,116,86,3120,2938,97,98,28,107,94,3362,
20221005,271,569,순천,북광주,757,74,47,33,138,25,1074,823,67,41,34,127,26,1118,
20221005,280,519,거창,남대구,965,20,49,4,8,58,1104,983,30,56,4,9,52,1134,
20221005,281,253,매송,서서울,3819,61,42,30,53,247,4252,3758,73,46,18,22,232,4149,
20221005,281,254,매송,군자,862,27,16,16,58,61,1040,1063,31,16,16,67,77,1270,
20221005,282,253,비봉,서서울,5687,310,268,203,593,352,7413,5672,284,260,177,525,337,7255,
20221005,282,254,비봉,군자,1051,110,63,59,181,82,1546,1371,122,82,72,209,102,1958,
20221005,283,253,발안,서서울,3585,222,160,170,179,194,4510,3412,168,173,147,194,199,4293,
20221005,283,254,발안,군자,975,74,57,59,131,58,1354,1192,100,50,64,155,69,1630,
20221005,285,253,서평택,서서울,1555,91,119,310,513,93,2681,1429,69,107,199,358,80,2242,
20221005,285,287,서평택,송악,702,41,86,79,699,47,1654,673,44,77,83,546,51,1474,
20221005,285,520,서평택,평택,657,45,60,71,102,71,1006,722,41,69,60,136,69,1097,
20221005,287,253,송악,서서울,1679,43,74,104,456,67,2423,1833,35,77,83,267,79,2374,
20221005,287,285,송악,서평택,673,44,77,83,546,51,1474,702,41,86,79,699,47,1654,
20221005,288,253,당진,서서울,1247,26,56,54,53,58,1494,1229,26,47,18,36,77,1433,
20221005,289,146,마산,동창원,2499,82,80,86,52,212,3011,2674,84,97,90,86,216,3247,
20221005,289,147,마산,진례,1232,99,87,60,90,86,1654,1283,115,98,60,84,78,1718,
20221005,289,148,마산,서김해,1406,31,52,21,9,117,1636,1436,30,57,8,12,122,1665,
20221005,289,150,마산,북부산,2599,36,66,16,46,155,2918,2368,39,73,13,25,139,2657,
20221005,289,244,마산,서부산,2773,57,233,44,95,150,3352,2892,59,244,58,87,169,3509,
20221005,289,245,마산,장유,1330,36,32,31,16,110,1555,1423,34,36,19,18,129,1659,
20221005,289,757,마산,진영,724,45,69,47,88,40,1013,799,51,67,54,83,43,1097,
20221005,291,145,사천,산인,1282,63,68,28,26,63,1530,1200,45,57,14,18,52,1386,
20221005,291,225,사천,서진주,946,18,39,5,22,79,1109,936,25,28,7,21,62,1079,
20221005,291,292,사천,진주,2878,74,89,66,41,259,3407,3613,92,102,75,62,292,4236,
20221005,292,145,진주,산인,1460,28,132,14,20,111,1765,1201,31,147,10,17,96,1502,
20221005,292,291,진주,사천,3613,92,102,75,62,292,4236,2878,74,89,66,41,259,3407,
20221005,293,145,문산,산인,1018,23,24,15,8,60,1148,1140,29,21,13,4,77,1284,
20221005,298,253,서산,서서울,1891,24,60,51,72,72,2170,2129,25,61,50,22,88,2375,
20221005,508,509,무안,목포,1292,58,38,30,49,64,1531,1619,56,41,31,71,78,1896,
20221005,508,553,무안,동광산,1466,33,39,32,29,50,1649,1521,33,41,29,48,60,1732,
20221005,509,508,목포,무안,1619,56,41,31,71,78,1896,1292,58,38,30,49,64,1531,
20221005,509,553,목포,동광산,6544,184,224,208,383,264,7807,6585,175,230,191,403,258,7842,
20221005,513,515,고성,북통영,1218,35,93,13,24,91,1474,1378,39,87,15,20,117,1656,
20221005,513,516,고성,통영,2715,83,123,98,167,209,3395,2676,83,134,85,153,211,3342,
20221005,514,516,동고성,통영,1151,23,47,34,111,140,1506,1166,23,52,40,119,139,1539,
20221005,515,513,북통영,고성,1378,39,87,15,20,117,1656,1218,35,93,13,24,91,1474,
20221005,516,513,통영,고성,2676,83,134,85,153,211,3342,2715,83,123,98,167,209,3395,
20221005,516,514,통영,동고성,1166,23,52,40,119,139,1539,1151,23,47,34,111,140,1506,
20221005,518,127,칠곡물류,서대구,754,100,64,89,42,39,1088,858,134,81,112,52,45,1282,
20221005,519,231,남대구,화원옥포,6435,153,111,148,96,473,7416,6520,189,114,163,112,506,7604,
20221005,519,232,남대구,달성,3055,130,162,46,33,205,3631,2782,135,153,48,43,209,3370,
20221005,519,233,남대구,현풍,4383,204,203,108,150,297,5345,5054,228,232,67,171,361,6113,
20221005,519,239,남대구,칠원,1051,55,95,50,67,34,1352,1006,47,87,38,95,37,1310,
20221005,519,241,남대구,동고령,3113,112,98,346,173,153,3995,3157,103,93,355,155,161,4024,
20221005,519,242,남대구,고령,1694,30,66,20,206,78,2094,1535,38,73,22,208,86,1962,
20221005,519,280,남대구,거창,983,30,56,4,9,52,1134,965,20,49,4,8,58,1104,
20221005,519,730,남대구,유천,2461,66,24,1,6,154,2712,2935,53,13,0,0,192,3193,
20221005,519,731,남대구,북현풍,1902,23,42,0,9,129,2105,1606,27,10,0,0,100,1743,
20221005,520,253,평택,서서울,1822,117,128,230,135,85,2517,2005,130,115,187,157,98,2692,
20221005,520,285,평택,서평택,722,41,69,60,136,69,1097,657,45,60,71,102,71,1006,
20221005,520,540,평택,청북,1023,92,151,154,89,52,1561,750,86,143,153,96,44,1272,
20221005,520,741,평택,평택고덕,948,15,213,11,19,81,1287,747,17,180,17,23,62,1046,
20221005,524,129,청통와촌,북대구,1174,77,33,21,24,39,1368,972,63,33,14,21,39,1142,
20221005,524,230,청통와촌,팔공산,1070,45,21,14,22,47,1219,1213,44,38,15,14,50,1374,
20221005,527,129,포항,북대구,1799,37,23,27,74,106,2066,1505,24,20,27,65,83,1724,
20221005,527,230,포항,팔공산,1246,25,12,4,22,61,1370,1434,31,12,4,15,61,1557,
20221005,528,101,기흥동탄,서울,7198,63,1295,128,15,323,9022,7042,72,1162,138,21,362,8797,
20221005,528,103,기흥동탄,수원신갈,2071,21,177,1,4,108,2382,1462,16,205,3,9,109,1804,
20221005,528,106,기흥동탄,오산,936,40,49,19,9,85,1138,879,41,39,17,10,72,1058,
20221005,528,107,기흥동탄,안성,1233,20,22,2,9,119,1405,1050,12,18,6,3,94,1183,
20221005,528,108,기흥동탄,천안,1115,19,120,3,14,69,1340,1093,19,103,6,16,61,1298,
20221005,540,253,청북,서서울,900,65,49,130,96,46,1286,817,48,69,111,53,53,1151,
20221005,540,520,청북,평택,750,86,143,153,96,44,1272,1023,92,151,154,89,52,1561,
20221005,540,741,청북,평택고덕,914,27,35,38,20,78,1112,915,39,55,46,25,81,1161,
20221005,542,101,서안성,서울,1694,53,73,173,66,72,2131,1279,49,97,97,29,62,1613,
20221005,542,543,서안성,남안성,1097,51,87,149,113,106,1603,1169,42,84,141,92,114,1642,
20221005,543,101,남안성,서울,1227,91,92,113,82,38,1643,1216,74,77,68,59,36,1530,
20221005,543,542,남안성,서안성,1169,42,84,141,92,114,1642,1097,51,87,149,113,106,1603,
20221005,543,555,남안성,북진천,834,111,151,192,181,40,1509,790,126,148,142,203,38,1447,
20221005,548,553,북무안,동광산,1267,22,30,23,13,32,1387,1513,18,24,34,14,34,1637,
20221005,549,553,동함평,동광산,3089,39,70,44,55,113,3410,3140,51,80,36,47,118,3472,
20221005,551,553,나주,동광산,1199,22,28,81,37,76,1443,1259,20,36,78,42,65,1500,
20221005,552,553,서광산,동광산,4603,179,205,221,209,183,5600,5879,215,231,237,200,230,6992,
20221005,553,508,동광산,무안,1521,33,41,29,48,60,1732,1466,33,39,32,29,50,1649,
20221005,553,509,동광산,목포,6585,175,230,191,403,258,7842,6544,184,224,208,383,264,7807,
20221005,553,548,동광산,북무안,1513,18,24,34,14,34,1637,1267,22,30,23,13,32,1387,
20221005,553,549,동광산,동함평,3140,51,80,36,47,118,3472,3089,39,70,44,55,113,3410,
20221005,553,551,동광산,나주,1259,20,36,78,42,65,1500,1199,22,28,81,37,76,1443,
20221005,553,552,동광산,서광산,5879,215,231,237,200,230,6992,4603,179,205,221,209,183,5600,
20221005,554,174,동홍천,춘천,1243,14,16,5,4,82,1364,1175,19,15,16,6,87,1318,
20221005,555,543,북진천,남안성,790,126,148,142,203,38,1447,834,111,151,192,181,40,1509,
20221005,560,190,감곡,동서울,857,36,37,35,104,25,1094,881,27,42,46,87,23,1106,
20221005,567,167,남고창,광주,1328,22,47,15,47,46,1505,1336,24,46,16,47,46,1515,
20221005,569,271,북광주,순천,823,67,41,34,127,26,1118,757,74,47,33,138,25,1074,
20221005,579,115,남세종,대전,1100,19,18,6,26,88,1257,1086,14,20,6,35,85,1246,
20221005,579,153,남세종,서대전,1095,18,32,7,12,82,1246,1188,15,19,10,6,102,1340,
20221005,587,589,오수,상관,1009,18,44,34,55,38,1198,1160,27,40,38,138,39,1442,
20221005,589,587,상관,오수,1160,27,40,38,138,39,1442,1009,18,44,34,55,38,1198,
20221005,597,598,서여주,북여주,974,43,131,31,70,48,1297,1019,41,96,35,92,57,1340,
20221005,598,597,북여주,서여주,1019,41,96,35,92,57,1340,974,43,131,31,70,48,1297,
20221005,621,127,동대구,서대구,1342,46,40,29,36,102,1595,1777,71,63,37,34,125,2107,
20221005,621,131,동대구,경산,2422,84,47,165,31,134,2883,2239,71,50,217,48,131,2756,
20221005,621,132,동대구,영천,1153,17,21,2,44,62,1299,1103,15,25,2,40,56,1241,
20221005,625,626,밀양,남밀양,1103,73,55,47,60,58,1396,1099,49,52,42,70,63,1375,
20221005,626,625,남밀양,밀양,1099,49,52,42,70,63,1375,1103,73,55,47,60,58,1396,
20221005,626,627,남밀양,삼랑진,964,25,43,14,83,109,1238,1019,30,28,17,104,99,1297,
20221005,627,626,삼랑진,남밀양,1019,30,28,17,104,99,1297,964,25,43,14,83,109,1238,
20221005,641,139,울산,서울산,959,17,45,11,22,74,1128,1075,35,61,32,41,105,1349,
20221005,641,252,울산,대동,1337,62,95,42,63,66,1665,1705,69,96,34,44,86,2034,
20221005,641,643,울산,청량,1165,17,21,14,35,94,1346,1302,6,13,10,13,131,1475,
20221005,641,706,울산,남경주,1098,12,33,8,24,50,1225,1131,7,32,20,25,57,1272,
20221005,641,707,울산,남포항,974,15,20,19,114,57,1199,1022,15,20,37,114,74,1282,
20221005,643,641,청량,울산,1302,6,13,10,13,131,1475,1165,17,21,14,35,94,1346,
20221005,643,648,청량,해운대,2709,21,34,26,80,208,3078,3060,34,65,51,438,185,3833,
20221005,645,648,장안,해운대,1574,15,12,7,10,101,1719,2780,36,20,148,55,178,3217,
20221005,646,648,기장일광,해운대,4688,20,31,20,79,262,5100,5375,47,35,19,218,337,6031,
20221005,648,643,해운대,청량,3060,34,65,51,438,185,3833,2709,21,34,26,80,208,3078,
20221005,648,645,해운대,장안,2780,36,20,148,55,178,3217,1574,15,12,7,10,101,1719,
20221005,648,646,해운대,기장일광,5375,47,35,19,218,337,6031,4688,20,31,20,79,262,5100,
20221005,651,652,남양주,화도,14669,582,514,517,241,1143,17666,16220,613,565,544,245,1275,19462,
20221005,651,653,남양주,서종,1901,14,18,5,32,84,2054,1902,16,13,3,26,72,2032,
20221005,651,654,남양주,설악,3541,29,60,14,17,143,3804,3272,14,62,18,12,122,3500,
20221005,651,655,남양주,강촌,2268,30,114,23,44,71,2550,2445,35,108,37,40,92,2757,
20221005,651,656,남양주,남춘천,2665,31,42,35,30,71,2874,2146,22,33,18,40,50,2309,
20221005,652,651,화도,남양주,16220,613,565,544,245,1275,19462,14669,582,514,517,241,1143,17666,
20221005,652,653,화도,서종,1406,36,17,17,21,108,1605,1523,39,24,11,22,114,1733,
20221005,652,654,화도,설악,1225,13,13,4,3,70,1328,1272,16,12,1,9,72,1382,
20221005,653,651,서종,남양주,1902,16,13,3,26,72,2032,1901,14,18,5,32,84,2054,
20221005,653,652,서종,화도,1523,39,24,11,22,114,1733,1406,36,17,17,21,108,1605,
20221005,654,651,설악,남양주,3272,14,62,18,12,122,3500,3541,29,60,14,17,143,3804,
20221005,654,652,설악,화도,1272,16,12,1,9,72,1382,1225,13,13,4,3,70,1328,
20221005,655,651,강촌,남양주,2445,35,108,37,40,92,2757,2268,30,114,23,44,71,2550,
20221005,656,651,남춘천,남양주,2146,22,33,18,40,50,2309,2665,31,42,35,30,71,2874,
20221005,671,672,봉담,정남,3418,196,94,138,156,253,4255,3955,188,116,192,171,287,4909,
20221005,671,673,봉담,북오산,1974,57,39,22,10,150,2252,2112,49,47,34,29,175,2446,
20221005,671,675,봉담,서오산,886,21,22,8,5,67,1009,977,33,24,7,17,87,1145,
20221005,671,676,봉담,향남,1441,102,54,34,34,96,1761,1314,106,50,28,30,102,1630,
20221005,671,677,봉담,북평택,7379,197,263,156,253,450,8698,7387,200,240,155,180,467,8629,
20221005,672,671,정남,봉담,3955,188,116,192,171,287,4909,3418,196,94,138,156,253,4255,
20221005,673,101,북오산,서울,1512,41,113,27,9,109,1811,1626,47,127,19,10,113,1942,
20221005,673,671,북오산,봉담,2112,49,47,34,29,175,2446,1974,57,39,22,10,150,2252,
20221005,673,677,북오산,북평택,1912,39,73,33,24,124,2205,1853,51,58,31,18,115,2126,
20221005,675,671,서오산,봉담,977,33,24,7,17,87,1145,886,21,22,8,5,67,1009,
20221005,675,676,서오산,향남,3556,116,69,64,40,235,4080,3229,99,66,40,25,197,3656,
20221005,675,677,서오산,북평택,11324,223,434,171,225,698,13075,10738,210,387,168,224,717,12444,
20221005,675,876,서오산,양감,1977,66,45,50,282,119,2539,2299,67,33,42,251,157,2849,
20221005,676,671,향남,봉담,1314,106,50,28,30,102,1630,1441,102,54,34,34,96,1761,
20221005,676,675,향남,서오산,3229,99,66,40,25,197,3656,3556,116,69,64,40,235,4080,
20221005,676,677,향남,북평택,1719,187,192,213,173,105,2589,1554,157,150,207,144,91,2303,
20221005,677,101,북평택,서울,1391,73,269,92,123,47,1995,1784,59,260,92,87,85,2367,
20221005,677,671,북평택,봉담,7387,200,240,155,180,467,8629,7379,197,263,156,253,450,8698,
20221005,677,673,북평택,북오산,1853,51,58,31,18,115,2126,1912,39,73,33,24,124,2205,
20221005,677,675,북평택,서오산,10738,210,387,168,224,717,12444,11324,223,434,171,225,698,13075,
20221005,677,676,북평택,향남,1554,157,150,207,144,91,2303,1719,187,192,213,173,105,2589,
20221005,677,876,북평택,양감,2239,173,189,285,177,132,3195,2142,180,200,266,166,132,3086,
20221005,682,683,조암,송산마도,850,97,95,73,54,33,1202,984,103,96,109,77,47,1416,
20221005,682,684,조암,남안산,1069,182,181,111,115,47,1705,1117,165,172,133,97,64,1748,
20221005,682,685,조암,서시흥,1743,216,161,186,358,95,2759,1961,161,164,175,363,103,2927,
20221005,683,682,송산마도,조암,984,103,96,109,77,47,1416,850,97,95,73,54,33,1202,
20221005,683,684,송산마도,남안산,2645,181,167,114,201,155,3463,2337,173,139,98,134,129,3010,
20221005,683,685,송산마도,서시흥,5058,310,207,206,1207,263,7251,4747,285,233,239,1140,253,6897,
20221005,684,682,남안산,조암,1117,165,172,133,97,64,1748,1069,182,181,111,115,47,1705,
20221005,684,683,남안산,송산마도,2337,173,139,98,134,129,3010,2645,181,167,114,201,155,3463,
20221005,684,685,남안산,서시흥,5216,576,326,475,657,352,7602,4756,407,366,384,527,329,6769,
20221005,685,682,서시흥,조암,1961,161,164,175,363,103,2927,1743,216,161,186,358,95,2759,
20221005,685,683,서시흥,송산마도,4747,285,233,239,1140,253,6897,5058,310,207,206,1207,263,7251,
20221005,685,684,서시흥,남안산,4756,407,366,384,527,329,6769,5216,576,326,475,657,352,7602,
20221005,705,190,남이천,동서울,1657,112,53,142,57,52,2073,1494,94,59,169,92,33,1941,
20221005,706,641,남경주,울산,1131,7,32,20,25,57,1272,1098,12,33,8,24,50,1225,
20221005,706,707,남경주,남포항,894,28,74,39,270,58,1363,956,22,69,31,221,48,1347,
20221005,707,641,남포항,울산,1022,15,20,37,114,74,1282,974,15,20,19,114,57,1199,
20221005,707,706,남포항,남경주,956,22,69,31,221,48,1347,894,28,74,39,270,58,1363,
20221005,707,708,남포항,동경주,1182,26,19,34,301,73,1635,1228,26,23,28,332,68,1705,
20221005,708,707,동경주,남포항,1228,26,23,28,332,68,1705,1182,26,19,34,301,73,1635,
20221005,715,716,동안동,청송,1082,18,18,9,19,48,1194,1083,28,13,10,18,43,1195,
20221005,716,715,청송,동안동,1083,28,13,10,18,43,1195,1082,18,18,9,19,48,1194,
20221005,730,519,유천,남대구,2935,53,13,0,0,192,3193,2461,66,24,1,6,154,2712,
20221005,731,519,북현풍,남대구,1606,27,10,0,0,100,1743,1902,23,42,0,9,129,2105,
20221005,741,253,평택고덕,서서울,922,28,29,21,9,57,1066,982,26,24,15,8,91,1146,
20221005,741,520,평택고덕,평택,747,17,180,17,23,62,1046,948,15,213,11,19,81,1287,
20221005,741,540,평택고덕,청북,915,39,55,46,25,81,1161,914,27,35,38,20,78,1112,
20221005,742,107,남사진위,안성,1349,40,57,33,10,122,1611,1279,40,52,25,6,125,1527,
20221005,742,108,남사진위,천안,1051,29,41,31,7,63,1222,1072,26,39,26,6,74,1243,
20221005,752,252,기장철마,대동,1864,91,54,44,57,148,2258,1875,83,50,43,108,150,2309,
20221005,753,252,금정,대동,1104,84,68,60,79,74,1469,1919,107,77,87,174,122,2486,
20221005,755,140,광재,부산,951,14,17,6,23,81,1092,1085,19,15,10,57,75,1261,
20221005,755,252,광재,대동,2262,97,79,65,398,139,3040,2427,121,100,69,315,174,3206,
20221005,756,252,한림,대동,903,44,34,31,117,40,1169,860,52,32,37,114,42,1137,
20221005,757,289,진영,마산,799,51,67,54,83,43,1097,724,45,69,47,88,40,1013,
20221005,772,774,북달성,남칠곡,2514,43,65,45,35,154,2856,2537,50,68,39,24,156,2874,
20221005,773,774,북다사,남칠곡,1288,27,19,11,16,75,1436,1277,25,17,13,17,90,1439,
20221005,774,772,남칠곡,북달성,2537,50,68,39,24,156,2874,2514,43,65,45,35,154,2856,
20221005,774,773,남칠곡,북다사,1277,25,17,13,17,90,1439,1288,27,19,11,16,75,1436,
20221005,775,203,동명동호,가산,1768,74,47,49,200,68,2206,1694,69,55,58,245,76,2197,
20221005,776,777,연경,파군재,3418,44,29,25,16,222,3754,2452,37,41,20,23,169,2742,
20221005,776,779,연경,율암,5985,94,78,79,152,416,6804,6071,112,78,93,140,446,6940,
20221005,777,776,파군재,연경,2452,37,41,20,23,169,2742,3418,44,29,25,16,222,3754,
20221005,777,779,파군재,율암,2477,24,21,4,13,213,2752,2493,20,32,2,17,201,2765,
20221005,779,776,율암,연경,6071,112,78,93,140,446,6940,5985,94,78,79,152,416,6804,
20221005,779,777,율암,파군재,2493,20,32,2,17,201,2765,2477,24,21,4,13,213,2752,
20221005,876,675,양감,서오산,2299,67,33,42,251,157,2849,1977,66,45,50,282,119,2539,
20221005,876,677,양감,북평택,2142,180,200,266,166,132,3086,2239,173,189,285,177,132,3195,
20221005,981,982,서영암,강진무위사,1812,46,103,50,47,71,2129,1738,47,115,76,61,60,2097,
20221005,981,987,서영암,남순천,1421,22,89,81,311,34,1958,1428,50,97,108,312,22,2017,
20221005,982,981,강진무위사,서영암,1738,47,115,76,61,60,2097,1812,46,103,50,47,71,2129,
20221005,984,985,보성,벌교,1463,47,60,40,66,44,1720,1379,48,54,31,40,41,1593,
20221005,984,987,보성,남순천,1685,40,92,96,306,46,2265,1779,55,80,67,286,58,2325,
20221005,985,984,벌교,보성,1379,48,54,31,40,41,1593,1463,47,60,40,66,44,1720,
20221005,986,987,고흥,남순천,3285,74,118,160,218,114,3969,3688,78,119,164,230,127,4406,
20221005,987,981,남순천,서영암,1428,50,97,108,312,22,2017,1421,22,89,81,311,34,1958,
20221005,987,984,남순천,보성,1779,55,80,67,286,58,2325,1685,40,92,96,306,46,2265,
20221005,987,986,남순천,고흥,3688,78,119,164,230,127,4406,3285,74,118,160,218,114,3969,
20221006,101,102,서울,동수원,3724,51,250,17,7,204,4253,5381,62,370,26,18,317,6174,
20221006,101,103,서울,수원신갈,14660,636,1748,443,150,720,18357,15248,690,1766,398,138,706,18946,
20221006,101,105,서울,기흥,6810,121,422,68,30,334,7785,6213,120,354,121,47,315,7170,
20221006,101,106,서울,오산,4385,392,447,172,101,296,5793,4489,469,492,211,78,266,6005,
20221006,101,107,서울,안성,3264,91,320,40,11,164,3890,2986,81,300,42,24,155,3588,
20221006,101,108,서울,천안,3813,69,334,44,11,141,4412,3873,56,341,51,17,152,4490,
20221006,101,111,서울,청주,850,13,179,24,28,23,1117,849,14,209,23,32,31,1158,
20221006,101,171,서울,마성,2051,32,242,56,13,101,2495,2463,25,248,56,18,115,2925,
20221006,101,172,서울,용인,3480,170,130,32,57,225,4094,3994,183,129,65,38,260,4669,
20221006,101,173,서울,양지,3588,218,119,107,79,150,4261,4612,407,141,172,113,188,5633,
20221006,101,229,서울,북천안,835,45,49,51,28,37,1045,933,56,41,61,30,45,1166,
20221006,101,528,서울,기흥동탄,6914,90,1190,140,12,348,8694,7466,78,1312,136,8,343,9343,
20221006,101,542,서울,서안성,1225,47,82,103,31,65,1553,1755,54,95,192,59,92,2247,
20221006,101,543,서울,남안성,1205,73,55,65,60,41,1499,1279,98,74,108,106,49,1714,
20221006,101,673,서울,북오산,1683,46,121,17,10,111,1988,1617,57,132,28,13,109,1956,
20221006,101,677,서울,북평택,1883,90,301,84,106,89,2553,1694,77,294,115,133,77,2390,
20221006,102,101,동수원,서울,5381,62,370,26,18,317,6174,3724,51,250,17,7,204,4253,
20221006,102,172,동수원,용인,1088,31,20,5,1,87,1232,1026,33,17,4,15,90,1185,
20221006,102,173,동수원,양지,1237,42,42,12,13,66,1412,1416,49,40,15,6,73,1599,
20221006,102,212,동수원,북수원,4294,33,234,24,39,222,4846,4924,37,244,28,16,268,5517,
20221006,102,213,동수원,부곡,1131,20,15,5,23,80,1274,1056,15,14,6,23,82,1196,
20221006,102,214,동수원,동군포,1811,35,19,12,5,115,1997,1615,25,16,7,3,116,1782,
20221006,102,215,동수원,군포,1743,22,33,10,7,116,1931,2329,21,45,8,7,170,2580,
20221006,102,253,동수원,서서울,5561,58,61,15,22,306,6023,5428,62,67,24,15,333,5929,
20221006,102,254,동수원,군자,3864,50,65,25,38,218,4260,4382,70,74,28,39,237,4830,
20221006,102,255,동수원,서안산,1841,39,12,9,6,96,2003,1976,51,11,15,8,114,2175,
20221006,103,101,수원신갈,서울,15248,690,1766,398,138,706,18946,14660,636,1748,443,150,720,18357,
20221006,103,105,수원신갈,기흥,1681,39,56,9,38,113,1936,2141,33,37,17,30,127,2385,
20221006,103,106,수원신갈,오산,1165,72,76,40,16,65,1434,1289,86,79,53,24,83,1614,
20221006,103,107,수원신갈,안성,921,24,39,10,1,72,1067,1029,18,42,6,4,79,1178,
20221006,103,108,수원신갈,천안,973,4,55,14,1,38,1085,1144,12,57,21,2,46,1282,
20221006,103,212,수원신갈,북수원,852,59,34,18,13,50,1026,1308,88,34,40,27,78,1575,
20221006,103,253,수원신갈,서서울,1942,138,76,72,25,111,2364,2240,141,115,88,35,126,2745,
20221006,103,254,수원신갈,군자,1466,116,79,61,83,77,1882,1707,130,85,115,108,98,2243,
20221006,103,528,수원신갈,기흥동탄,1441,17,195,9,3,94,1759,2041,22,178,10,4,110,2365,
20221006,105,101,기흥,서울,6213,120,354,121,47,315,7170,6810,121,422,68,30,334,7785,
20221006,105,103,기흥,수원신갈,2141,33,37,17,30,127,2385,1681,39,56,9,38,113,1936,
20221006,106,101,오산,서울,4489,469,492,211,78,266,6005,4385,392,447,172,101,296,5793,
20221006,106,103,오산,수원신갈,1289,86,79,53,24,83,1614,1165,72,76,40,16,65,1434,
20221006,106,107,오산,안성,1602,51,42,17,9,157,1878,1485,46,31,21,9,144,1736,
20221006,106,108,오산,천안,974,30,24,14,4,73,1119,1079,32,23,25,5,67,1231,
20221006,106,528,오산,기흥동탄,835,42,45,14,10,74,1020,994,43,50,13,12,88,1200,
20221006,107,101,안성,서울,2986,81,300,42,24,155,3588,3264,91,320,40,11,164,3890,
20221006,107,103,안성,수원신갈,1029,18,42,6,4,79,1178,921,24,39,10,1,72,1067,
20221006,107,106,안성,오산,1485,46,31,21,9,144,1736,1602,51,42,17,9,157,1878,
20221006,107,108,안성,천안,1594,25,48,8,9,128,1812,1638,28,46,15,5,147,1879,
20221006,107,528,안성,기흥동탄,986,11,26,1,4,96,1124,1179,25,22,3,5,103,1337,
20221006,107,742,안성,남사진위,1270,42,50,24,6,109,1501,1412,46,55,30,11,107,1661,
20221006,108,101,천안,서울,3873,56,341,51,17,152,4490,3813,69,334,44,11,141,4412,
20221006,108,103,천안,수원신갈,1144,12,57,21,2,46,1282,973,4,55,14,1,38,1085,
20221006,108,106,천안,오산,1079,32,23,25,5,67,1231,974,30,24,14,4,73,1119,
20221006,108,107,천안,안성,1638,28,46,15,5,147,1879,1594,25,48,8,9,128,1812,
20221006,108,111,천안,청주,1037,35,58,23,30,70,1253,1041,31,52,26,36,58,1244,
20221006,108,229,천안,북천안,3525,82,117,47,51,193,4015,3849,84,142,42,98,240,4455,
20221006,108,528,천안,기흥동탄,1082,13,105,2,16,70,1288,1082,17,117,0,13,71,1300,
20221006,108,742,천안,남사진위,1175,27,39,21,10,87,1359,1146,34,39,27,5,69,1320,
20221006,111,101,청주,서울,849,14,209,23,32,31,1158,850,13,179,24,28,23,1117,
20221006,111,108,청주,천안,1041,31,52,26,36,58,1244,1037,35,58,23,30,70,1253,
20221006,112,115,남청주,대전,1589,85,68,3,22,130,1897,1619,89,68,7,4,116,1903,
20221006,113,115,신탄진,대전,990,23,16,6,24,104,1163,1137,37,21,5,10,110,1320,
20221006,114,153,남대전,서대전,1916,48,67,61,17,132,2241,1744,40,101,73,17,135,2110,
20221006,115,112,대전,남청주,1619,89,68,7,4,116,1903,1589,85,68,3,22,130,1897,
20221006,115,113,대전,신탄진,1137,37,21,5,10,110,1320,990,23,16,6,24,104,1163,
20221006,115,116,대전,옥천,2264,114,52,29,24,169,2652,1997,68,51,33,22,156,2327,
20221006,115,151,대전,북대전,1139,12,17,4,8,115,1295,907,8,10,3,11,105,1044,
20221006,115,152,대전,유성,926,16,12,2,1,73,1030,957,20,17,2,1,70,1067,
20221006,115,153,대전,서대전,940,29,22,5,2,70,1068,934,20,11,2,3,65,1035,
20221006,115,198,대전,서청주,930,26,6,13,2,80,1057,921,30,7,9,6,74,1047,
20221006,115,579,대전,남세종,1101,6,20,7,19,91,1244,1122,7,14,6,38,87,1274,
20221006,116,115,옥천,대전,1997,68,51,33,22,156,2327,2264,114,52,29,24,169,2652,
20221006,119,153,판암,서대전,1739,26,15,93,5,145,2023,1853,26,18,91,7,157,2152,
20221006,123,127,구미,서대구,1661,29,24,17,6,107,1844,1763,26,32,19,8,104,1952,
20221006,123,129,구미,북대구,1923,20,57,8,5,92,2105,1905,16,63,8,3,92,2087,
20221006,123,130,구미,동김천,1169,27,35,45,68,77,1421,1120,24,35,31,63,79,1352,
20221006,125,127,남구미,서대구,1859,53,101,41,14,105,2173,2090,66,114,53,25,134,2482,
20221006,125,129,남구미,북대구,1868,26,87,15,6,113,2115,2072,29,75,19,8,120,2323,
20221006,126,127,왜관,서대구,2496,121,72,48,138,135,3010,2824,140,78,49,85,150,3326,
20221006,126,129,왜관,북대구,3101,106,54,17,98,119,3495,3501,114,76,18,103,152,3964,
20221006,127,123,서대구,구미,1763,26,32,19,8,104,1952,1661,29,24,17,6,107,1844,
20221006,127,125,서대구,남구미,2090,66,114,53,25,134,2482,1859,53,101,41,14,105,2173,
20221006,127,126,서대구,왜관,2824,140,78,49,85,150,3326,2496,121,72,48,138,135,3010,
20221006,127,131,서대구,경산,2561,222,131,105,80,162,3261,1843,159,99,66,55,122,2344,
20221006,127,203,서대구,가산,2059,67,98,46,146,102,2518,1901,68,82,35,132,94,2312,
20221006,127,230,서대구,팔공산,1490,51,55,16,4,99,1715,1061,31,46,15,4,67,1224,
20221006,127,518,서대구,칠곡물류,897,123,84,105,77,55,1341,732,113,64,87,71,42,1109,
20221006,127,621,서대구,동대구,1820,70,98,37,35,134,2194,1323,41,50,36,24,96,1570,
20221006,129,123,북대구,구미,1905,16,63,8,3,92,2087,1923,20,57,8,5,92,2105,
20221006,129,125,북대구,남구미,2072,29,75,19,8,120,2323,1868,26,87,15,6,113,2115,
20221006,129,126,북대구,왜관,3501,114,76,18,103,152,3964,3101,106,54,17,98,119,3495,
20221006,129,131,북대구,경산,2318,153,95,61,45,114,2786,2932,226,131,88,37,163,3577,
20221006,129,524,북대구,청통와촌,982,43,25,11,16,52,1129,1195,83,29,19,34,48,1408,
20221006,129,527,북대구,포항,1500,32,25,26,46,79,1708,1846,73,35,31,80,96,2161,
20221006,130,123,동김천,구미,1120,24,35,31,63,79,1352,1169,27,35,45,68,77,1421,
20221006,131,127,경산,서대구,1843,159,99,66,55,122,2344,2561,222,131,105,80,162,3261,
20221006,131,129,경산,북대구,2932,226,131,88,37,163,3577,2318,153,95,61,45,114,2786,
20221006,131,132,경산,영천,875,41,48,41,64,46,1115,818,48,58,50,30,50,1054,
20221006,131,230,경산,팔공산,1303,84,50,11,15,82,1545,1548,79,74,33,23,98,1855,
20221006,131,621,경산,동대구,2246,74,38,282,52,125,2817,2464,78,49,286,25,132,3034,
20221006,132,131,영천,경산,818,48,58,50,30,50,1054,875,41,48,41,64,46,1115,
20221006,132,621,영천,동대구,1130,14,22,5,39,54,1264,1177,16,23,2,41,69,1328,
20221006,135,140,경주,부산,1098,11,44,10,42,48,1253,1154,12,55,13,32,52,1318,
20221006,135,252,경주,대동,786,37,88,56,144,46,1157,1003,50,86,49,121,45,1354,
20221006,138,140,양산,부산,5207,262,175,370,277,269,6560,5396,292,204,396,281,305,6874,
20221006,138,252,양산,대동,2658,354,198,179,332,144,3865,3105,351,224,160,363,147,4350,
20221006,139,140,서울산,부산,1316,38,27,11,19,71,1482,1235,42,18,3,24,77,1399,
20221006,139,641,서울산,울산,1145,35,61,25,49,101,1416,1110,22,48,15,25,73,1293,
20221006,140,135,부산,경주,1154,12,55,13,32,52,1318,1098,11,44,10,42,48,1253,
20221006,140,138,부산,양산,5396,292,204,396,281,305,6874,5207,262,175,370,277,269,6560,
20221006,140,139,부산,서울산,1235,42,18,3,24,77,1399,1316,38,27,11,19,71,1482,
20221006,140,250,부산,남양산,8015,139,227,32,31,647,9091,7922,134,209,31,37,679,9012,
20221006,140,251,부산,물금,998,128,26,38,108,64,1362,1027,105,27,35,126,76,1396,
20221006,140,252,부산,대동,1673,59,53,53,63,98,1999,1573,43,37,47,88,77,1865,
20221006,140,755,부산,광재,1084,19,15,13,33,72,1236,949,20,16,9,31,64,1089,
20221006,142,145,군북,산인,4013,74,123,51,79,287,4627,3880,71,103,47,76,277,4454,
20221006,143,145,장지,산인,1302,29,32,22,46,99,1530,1221,25,34,27,55,107,1469,
20221006,144,145,함안,산인,1932,64,43,28,145,152,2364,1890,69,44,22,124,126,2275,
20221006,145,142,산인,군북,3880,71,103,47,76,277,4454,4013,74,123,51,79,287,4627,
20221006,145,143,산인,장지,1221,25,34,27,55,107,1469,1302,29,32,22,46,99,1530,
20221006,145,144,산인,함안,1890,69,44,22,124,126,2275,1932,64,43,28,145,152,2364,
20221006,145,291,산인,사천,1141,38,59,20,23,49,1330,1315,69,61,28,17,64,1554,
20221006,145,292,산인,진주,1215,22,133,18,16,78,1482,1486,26,134,19,14,93,1772,
20221006,145,293,산인,문산,995,17,14,8,4,65,1103,1049,27,25,14,8,75,1198,
20221006,146,150,동창원,북부산,954,16,15,6,26,71,1088,978,18,21,4,17,68,1106,
20221006,146,244,동창원,서부산,1209,27,38,15,36,83,1408,1198,28,41,23,54,78,1422,
20221006,146,245,동창원,장유,922,15,16,7,2,90,1052,939,19,19,8,7,83,1075,
20221006,146,289,동창원,마산,2584,80,75,87,71,229,3126,2424,77,79,90,55,193,2918,
20221006,147,150,진례,북부산,1416,37,29,21,48,85,1636,1670,55,28,19,26,98,1896,
20221006,147,244,진례,서부산,1721,105,67,66,104,117,2180,1868,120,62,58,97,106,2311,
20221006,147,245,진례,장유,1079,62,99,57,24,112,1433,1469,59,105,49,30,140,1852,
20221006,147,289,진례,마산,1242,94,87,51,74,81,1629,1190,95,76,59,78,98,1596,
20221006,148,150,서김해,북부산,6498,125,78,55,113,506,7375,6513,134,71,46,73,501,7338,
20221006,148,251,서김해,물금,892,40,22,35,15,83,1087,869,46,17,29,16,89,1066,
20221006,148,289,서김해,마산,1328,29,52,10,9,103,1531,1389,26,61,11,16,105,1608,
20221006,149,150,동김해,북부산,10599,200,158,42,71,887,11957,9229,171,124,31,42,813,10410,
20221006,149,250,동김해,남양산,1154,28,59,5,9,102,1357,945,18,47,7,4,91,1112,
20221006,149,251,동김해,물금,1151,49,20,8,2,121,1351,1061,37,15,9,3,114,1239,
20221006,150,146,북부산,동창원,978,18,21,4,17,68,1106,954,16,15,6,26,71,1088,
20221006,150,147,북부산,진례,1670,55,28,19,26,98,1896,1416,37,29,21,48,85,1636,
20221006,150,148,북부산,서김해,6513,134,71,46,73,501,7338,6498,125,78,55,113,506,7375,
20221006,150,149,북부산,동김해,9229,171,124,31,42,813,10410,10599,200,158,42,71,887,11957,
20221006,150,245,북부산,장유,3644,30,96,14,24,244,4052,3141,42,103,16,23,234,3559,
20221006,150,289,북부산,마산,2246,24,75,10,24,115,2494,2579,35,73,20,38,119,2864,
20221006,151,115,북대전,대전,907,8,10,3,11,105,1044,1139,12,17,4,8,115,1295,
20221006,151,153,북대전,서대전,1111,15,13,16,11,97,1263,1299,26,24,25,15,117,1506,
20221006,152,115,유성,대전,957,20,17,2,1,70,1067,926,16,12,2,1,73,1030,
20221006,152,154,유성,안영,975,26,44,13,30,57,1145,1093,26,45,10,39,75,1288,
20221006,153,114,서대전,남대전,1744,40,101,73,17,135,2110,1916,48,67,61,17,132,2241,
20221006,153,115,서대전,대전,934,20,11,2,3,65,1035,940,29,22,5,2,70,1068,
20221006,153,119,서대전,판암,1853,26,18,91,7,157,2152,1739,26,15,93,5,145,2023,
20221006,153,151,서대전,북대전,1299,26,24,25,15,117,1506,1111,15,13,16,11,97,1263,
20221006,153,154,서대전,안영,1127,35,49,44,48,74,1377,1046,33,43,36,42,71,1271,
20221006,153,579,서대전,남세종,1173,13,21,5,4,85,1301,1015,17,15,7,11,72,1137,
20221006,154,152,안영,유성,1093,26,45,10,39,75,1288,975,26,44,13,30,57,1145,
20221006,154,153,안영,서대전,1046,33,43,36,42,71,1271,1127,35,49,44,48,74,1377,
20221006,159,167,서전주,광주,1521,83,80,66,34,47,1831,1504,84,85,75,50,47,1845,
20221006,166,167,장성,광주,2187,84,59,28,47,107,2512,2719,117,81,44,38,110,3109,
20221006,167,159,광주,서전주,1504,84,85,75,50,47,1845,1521,83,80,66,34,47,1831,
20221006,167,166,광주,장성,2719,117,81,44,38,110,3109,2187,84,59,28,47,107,2512,
20221006,167,567,광주,남고창,1314,31,50,17,24,49,1485,1337,23,46,20,26,54,1506,
20221006,171,101,마성,서울,2463,25,248,56,18,115,2925,2051,32,242,56,13,101,2495,
20221006,172,101,용인,서울,3994,183,129,65,38,260,4669,3480,170,130,32,57,225,4094,
20221006,172,102,용인,동수원,1026,33,17,4,15,90,1185,1088,31,20,5,1,87,1232,
20221006,172,173,용인,양지,1981,255,140,152,54,149,2731,1827,170,177,132,64,151,2521,
20221006,172,212,용인,북수원,865,45,22,19,28,55,1034,1160,67,23,28,38,71,1387,
20221006,172,253,용인,서서울,1055,53,29,29,14,55,1235,1108,72,28,25,22,72,1327,
20221006,173,101,양지,서울,4612,407,141,172,113,188,5633,3588,218,119,107,79,150,4261,
20221006,173,102,양지,동수원,1416,49,40,15,6,73,1599,1237,42,42,12,13,66,1412,
20221006,173,172,양지,용인,1827,170,177,132,64,151,2521,1981,255,140,152,54,149,2731,
20221006,173,212,양지,북수원,1206,81,43,47,35,66,1478,1368,96,72,50,64,71,1721,
20221006,173,253,양지,서서울,1190,163,75,130,65,56,1679,1021,137,65,117,45,45,1430,
20221006,173,254,양지,군자,793,129,94,203,245,35,1499,749,114,78,177,215,33,1366,
20221006,174,179,춘천,홍천,3392,70,79,80,53,341,4015,3210,73,76,78,47,343,3827,
20221006,174,216,춘천,횡성,988,56,34,24,20,66,1188,1048,49,23,8,19,58,1205,
20221006,174,218,춘천,남원주,1168,26,62,18,16,70,1360,1107,26,64,12,29,86,1324,
20221006,174,554,춘천,동홍천,1163,15,20,11,7,84,1300,1244,17,21,6,7,89,1384,
20221006,176,190,이천,동서울,1512,75,207,168,124,73,2159,1522,69,207,138,86,83,2105,
20221006,179,174,홍천,춘천,3210,73,76,78,47,343,3827,3392,70,79,80,53,341,4015,
20221006,184,189,대관령,강릉,1098,32,45,4,7,83,1269,1208,34,47,6,9,76,1380,
20221006,189,184,강릉,대관령,1208,34,47,6,9,76,1380,1098,32,45,4,7,83,1269,
20221006,190,176,동서울,이천,1522,69,207,138,86,83,2105,1512,75,207,168,124,73,2159,
20221006,190,191,동서울,경기광주,10853,697,511,415,310,723,13509,10423,654,476,424,361,708,13046,
20221006,190,192,동서울,곤지암,5687,512,291,199,70,349,7108,4965,484,208,187,72,360,6276,
20221006,190,193,동서울,일죽,2520,181,202,196,134,94,3327,2249,172,176,272,94,97,3060,
20221006,190,194,동서울,서이천,4311,593,329,296,162,239,5930,3259,451,265,225,124,182,4506,
20221006,190,198,동서울,서청주,878,39,52,29,24,36,1058,915,21,43,32,16,37,1064,
20221006,190,560,동서울,감곡,997,21,39,43,90,31,1221,882,45,39,35,107,37,1145,
20221006,190,705,동서울,남이천,1486,89,87,134,120,45,1961,1862,130,80,123,97,45,2337,
20221006,191,190,경기광주,동서울,10423,654,476,424,361,708,13046,10853,697,511,415,310,723,13509,
20221006,192,190,곤지암,동서울,4965,484,208,187,72,360,6276,5687,512,291,199,70,349,7108,
20221006,192,194,곤지암,서이천,1343,263,125,228,100,96,2155,1133,172,100,214,106,89,1814,
20221006,193,190,일죽,동서울,2249,172,176,272,94,97,3060,2520,181,202,196,134,94,3327,
20221006,194,190,서이천,동서울,3259,451,265,225,124,182,4506,4311,593,329,296,162,239,5930,
20221006,194,192,서이천,곤지암,1133,172,100,214,106,89,1814,1343,263,125,228,100,96,2155,
20221006,196,198,진천,서청주,1329,41,83,41,41,70,1605,1329,35,76,36,29,77,1582,
20221006,198,115,서청주,대전,921,30,7,9,6,74,1047,930,26,6,13,2,80,1057,
20221006,198,190,서청주,동서울,915,21,43,32,16,37,1064,878,39,52,29,24,36,1058,
20221006,198,196,서청주,진천,1329,35,76,36,29,77,1582,1329,41,83,41,41,70,1605,
20221006,201,203,칠곡,가산,887,41,51,39,106,44,1168,914,36,57,33,140,41,1221,
20221006,203,127,가산,서대구,1901,68,82,35,132,94,2312,2059,67,98,46,146,102,2518,
20221006,203,201,가산,칠곡,914,36,57,33,140,41,1221,887,41,51,39,106,44,1168,
20221006,203,775,가산,동명동호,1755,52,50,47,238,86,2228,1713,62,55,44,192,69,2135,
20221006,212,102,북수원,동수원,4924,37,244,28,16,268,5517,4294,33,234,24,39,222,4846,
20221006,212,103,북수원,수원신갈,1308,88,34,40,27,78,1575,852,59,34,18,13,50,1026,
20221006,212,172,북수원,용인,1160,67,23,28,38,71,1387,865,45,22,19,28,55,1034,
20221006,212,173,북수원,양지,1368,96,72,50,64,71,1721,1206,81,43,47,35,66,1478,
20221006,212,253,북수원,서서울,2521,53,21,9,15,166,2785,1009,23,14,9,5,49,1109,
20221006,212,254,북수원,군자,1718,39,42,24,29,105,1957,1140,37,32,17,22,67,1315,
20221006,213,102,부곡,동수원,1056,15,14,6,23,82,1196,1131,20,15,5,23,80,1274,
20221006,213,253,부곡,서서울,1397,70,39,35,191,73,1805,1040,62,33,41,143,87,1406,
20221006,213,254,부곡,군자,953,33,20,45,503,55,1609,865,35,23,35,433,63,1454,
20221006,214,102,동군포,동수원,1615,25,16,7,3,116,1782,1811,35,19,12,5,115,1997,
20221006,215,102,군포,동수원,2329,21,45,8,7,170,2580,1743,22,33,10,7,116,1931,
20221006,215,253,군포,서서울,3085,90,67,51,66,209,3568,3748,152,134,183,106,262,4585,
20221006,215,254,군포,군자,2010,67,59,51,86,135,2408,2820,137,96,139,146,190,3528,
20221006,215,255,군포,서안산,1332,47,32,25,12,93,1541,1531,77,54,90,106,120,1978,
20221006,216,174,횡성,춘천,1048,49,23,8,19,58,1205,988,56,34,24,20,66,1188,
20221006,218,174,남원주,춘천,1107,26,64,12,29,86,1324,1168,26,62,18,16,70,1360,
20221006,218,240,남원주,제천,2003,54,47,20,51,135,2310,2055,55,46,22,27,128,2333,
20221006,225,291,서진주,사천,1007,22,23,12,19,68,1151,963,21,31,6,20,70,1111,
20221006,229,101,북천안,서울,933,56,41,61,30,45,1166,835,45,49,51,28,37,1045,
20221006,229,108,북천안,천안,3849,84,142,42,98,240,4455,3525,82,117,47,51,193,4015,
20221006,230,127,팔공산,서대구,1061,31,46,15,4,67,1224,1490,51,55,16,4,99,1715,
20221006,230,131,팔공산,경산,1548,79,74,33,23,98,1855,1303,84,50,11,15,82,1545,
20221006,230,524,팔공산,청통와촌,1175,55,38,15,26,57,1366,1000,43,30,19,37,47,1176,
20221006,230,527,팔공산,포항,1434,27,27,8,18,63,1577,1381,23,18,11,25,49,1507,
20221006,231,519,화원옥포,남대구,6551,178,100,179,152,472,7632,6356,155,105,180,85,480,7361,
20221006,232,519,달성,남대구,2747,114,143,47,43,201,3295,2929,114,161,51,29,199,3483,
20221006,233,519,현풍,남대구,5025,226,226,74,146,361,6058,4480,199,218,101,142,321,5461,
20221006,237,239,남지,칠원,769,20,46,23,112,72,1042,784,23,47,20,128,70,1072,
20221006,238,239,칠서,칠원,1566,99,98,98,226,101,2188,1552,99,98,73,213,98,2133,
20221006,239,237,칠원,남지,784,23,47,20,128,70,1072,769,20,46,23,112,72,1042,
20221006,239,238,칠원,칠서,1552,99,98,73,213,98,2133,1566,99,98,98,226,101,2188,
20221006,239,519,칠원,남대구,1036,51,94,33,74,33,1321,1118,57,102,46,48,33,1404,
20221006,240,218,제천,남원주,2055,55,46,22,27,128,2333,2003,54,47,20,51,135,2310,
20221006,241,519,동고령,남대구,3068,102,97,357,186,160,3970,2992,100,91,318,221,148,3870,
20221006,242,519,고령,남대구,1665,54,65,22,177,69,2052,1667,40,71,27,178,72,2055,
20221006,244,146,서부산,동창원,1198,28,41,23,54,78,1422,1209,27,38,15,36,83,1408,
20221006,244,147,서부산,진례,1868,120,62,58,97,106,2311,1721,105,67,66,104,117,2180,
20221006,244,245,서부산,장유,12694,258,409,145,343,978,14827,12490,244,423,142,385,956,14640,
20221006,244,289,서부산,마산,2647,62,226,42,53,132,3162,2697,53,228,44,63,144,3229,
20221006,245,146,장유,동창원,939,19,19,8,7,83,1075,922,15,16,7,2,90,1052,
20221006,245,147,장유,진례,1469,59,105,49,30,140,1852,1079,62,99,57,24,112,1433,
20221006,245,150,장유,북부산,3141,42,103,16,23,234,3559,3644,30,96,14,24,244,4052,
20221006,245,244,장유,서부산,12490,244,423,142,385,956,14640,12694,258,409,145,343,978,14827,
20221006,245,289,장유,마산,1336,27,38,14,13,130,1558,1272,20,31,14,14,120,1471,
20221006,248,261,순창,동광주,1285,22,28,15,17,57,1424,1199,23,36,25,16,55,1354,
20221006,249,261,담양,동광주,2339,43,122,29,38,124,2695,1892,26,110,17,35,72,2152,
20221006,250,140,남양산,부산,7922,134,209,31,37,679,9012,8015,139,227,32,31,647,9091,
20221006,250,149,남양산,동김해,945,18,47,7,4,91,1112,1154,28,59,5,9,102,1357,
20221006,250,252,남양산,대동,3418,157,121,103,93,227,4119,4060,160,125,101,126,310,4882,
20221006,251,140,물금,부산,1027,105,27,35,126,76,1396,998,128,26,38,108,64,1362,
20221006,251,148,물금,서김해,869,46,17,29,16,89,1066,892,40,22,35,15,83,1087,
20221006,251,149,물금,동김해,1061,37,15,9,3,114,1239,1151,49,20,8,2,121,1351,
20221006,251,252,물금,대동,3120,227,85,158,493,249,4332,3779,233,98,154,582,288,5134,
20221006,252,135,대동,경주,1003,50,86,49,121,45,1354,786,37,88,56,144,46,1157,
20221006,252,138,대동,양산,3105,351,224,160,363,147,4350,2658,354,198,179,332,144,3865,
20221006,252,140,대동,부산,1573,43,37,47,88,77,1865,1673,59,53,53,63,98,1999,
20221006,252,250,대동,남양산,4060,160,125,101,126,310,4882,3418,157,121,103,93,227,4119,
20221006,252,251,대동,물금,3779,233,98,154,582,288,5134,3120,227,85,158,493,249,4332,
20221006,252,641,대동,울산,1554,66,97,39,57,106,1919,1309,84,88,35,55,71,1642,
20221006,252,752,대동,기장철마,1846,71,67,39,85,155,2263,1841,61,72,31,67,140,2212,
20221006,252,753,대동,금정,1788,90,97,104,197,119,2395,1094,56,64,85,88,64,1451,
20221006,252,755,대동,광재,2309,93,93,97,302,160,3054,2314,85,77,98,445,124,3143,
20221006,252,756,대동,한림,856,45,23,27,93,51,1095,926,60,33,25,130,49,1223,
20221006,253,102,서서울,동수원,5428,62,67,24,15,333,5929,5561,58,61,15,22,306,6023,
20221006,253,103,서서울,수원신갈,2240,141,115,88,35,126,2745,1942,138,76,72,25,111,2364,
20221006,253,172,서서울,용인,1108,72,28,25,22,72,1327,1055,53,29,29,14,55,1235,
20221006,253,173,서서울,양지,1021,137,65,117,45,45,1430,1190,163,75,130,65,56,1679,
20221006,253,212,서서울,북수원,1009,23,14,9,5,49,1109,2521,53,21,9,15,166,2785,
20221006,253,213,서서울,부곡,1040,62,33,41,143,87,1406,1397,70,39,35,191,73,1805,
20221006,253,215,서서울,군포,3748,152,134,183,106,262,4585,3085,90,67,51,66,209,3568,
20221006,253,255,서서울,서안산,15538,555,631,550,287,952,18513,15208,540,538,508,280,922,17996,
20221006,253,256,서서울,안산,8884,155,85,61,71,616,9872,5854,105,61,31,75,415,6541,
20221006,253,281,서서울,매송,3518,68,49,24,28,221,3908,3831,69,38,25,76,244,4283,
20221006,253,282,서서울,비봉,5598,265,278,159,515,321,7136,5603,319,255,172,564,374,7287,
20221006,253,283,서서울,발안,3474,169,164,157,176,199,4339,3793,209,172,195,198,218,4785,
20221006,253,285,서서울,서평택,1374,64,96,232,353,87,2206,1498,104,126,307,486,87,2608,
20221006,253,287,서서울,송악,1856,37,74,84,240,74,2365,1960,49,57,107,475,78,2726,
20221006,253,288,서서울,당진,1335,34,65,25,26,57,1542,1389,26,56,48,58,55,1632,
20221006,253,298,서서울,서산,2161,30,59,48,23,76,2397,2121,25,50,58,67,82,2403,
20221006,253,520,서서울,평택,1901,119,113,172,127,69,2501,2234,130,112,202,136,91,2905,
20221006,253,540,서서울,청북,776,43,55,94,67,52,1087,894,69,49,112,97,46,1267,
20221006,253,741,서서울,평택고덕,994,27,23,26,9,74,1153,933,31,28,22,14,64,1092,
20221006,254,102,군자,동수원,4382,70,74,28,39,237,4830,3864,50,65,25,38,218,4260,
20221006,254,103,군자,수원신갈,1707,130,85,115,108,98,2243,1466,116,79,61,83,77,1882,
20221006,254,173,군자,양지,749,114,78,177,215,33,1366,793,129,94,203,245,35,1499,
20221006,254,212,군자,북수원,1140,37,32,17,22,67,1315,1718,39,42,24,29,105,1957,
20221006,254,213,군자,부곡,865,35,23,35,433,63,1454,953,33,20,45,503,55,1609,
20221006,254,215,군자,군포,2820,137,96,139,146,190,3528,2010,67,59,51,86,135,2408,
20221006,254,255,군자,서안산,9512,414,203,206,287,645,11267,9576,419,192,208,282,619,11296,
20221006,254,256,군자,안산,4624,133,112,40,61,357,5327,4805,126,102,54,48,392,5527,
20221006,254,281,군자,매송,1040,44,17,19,31,72,1223,882,27,13,18,25,65,1030,
20221006,254,282,군자,비봉,1225,115,80,83,191,95,1789,1054,112,86,75,193,89,1609,
20221006,254,283,군자,발안,1108,85,74,69,145,75,1556,1054,83,53,70,132,64,1456,
20221006,255,102,서안산,동수원,1976,51,11,15,8,114,2175,1841,39,12,9,6,96,2003,
20221006,255,215,서안산,군포,1531,77,54,90,106,120,1978,1332,47,32,25,12,93,1541,
20221006,255,253,서안산,서서울,15208,540,538,508,280,922,17996,15538,555,631,550,287,952,18513,
20221006,255,254,서안산,군자,9576,419,192,208,282,619,11296,9512,414,203,206,287,645,11267,
20221006,256,253,안산,서서울,5854,105,61,31,75,415,6541,8884,155,85,61,71,616,9872,
20221006,256,254,안산,군자,4805,126,102,54,48,392,5527,4624,133,112,40,61,357,5327,
20221006,261,248,동광주,순창,1199,23,36,25,16,55,1354,1285,22,28,15,17,57,1424,
20221006,261,249,동광주,담양,1892,26,110,17,35,72,2152,2339,43,122,29,38,124,2695,
20221006,261,262,동광주,창평,1559,86,33,101,53,59,1891,1679,76,40,109,46,80,2030,
20221006,261,263,동광주,옥과,2785,31,121,18,121,134,3210,3054,28,131,16,127,134,3490,
20221006,261,265,동광주,곡성,1490,24,51,15,24,52,1656,1295,16,42,9,16,52,1430,
20221006,261,271,동광주,순천,3072,89,103,35,103,100,3502,2689,94,93,29,135,94,3134,
20221006,262,261,창평,동광주,1679,76,40,109,46,80,2030,1559,86,33,101,53,59,1891,
20221006,263,261,옥과,동광주,3054,28,131,16,127,134,3490,2785,31,121,18,121,134,3210,
20221006,265,261,곡성,동광주,1295,16,42,9,16,52,1430,1490,24,51,15,24,52,1656,
20221006,271,261,순천,동광주,2689,94,93,29,135,94,3134,3072,89,103,35,103,100,3502,
20221006,271,569,순천,북광주,762,54,39,23,136,25,1039,817,51,39,38,102,37,1084,
20221006,280,519,거창,남대구,966,19,43,9,21,51,1109,978,27,60,3,8,43,1119,
20221006,281,253,매송,서서울,3831,69,38,25,76,244,4283,3518,68,49,24,28,221,3908,
20221006,281,254,매송,군자,882,27,13,18,25,65,1030,1040,44,17,19,31,72,1223,
20221006,282,253,비봉,서서울,5603,319,255,172,564,374,7287,5598,265,278,159,515,321,7136,
20221006,282,254,비봉,군자,1054,112,86,75,193,89,1609,1225,115,80,83,191,95,1789,
20221006,283,253,발안,서서울,3793,209,172,195,198,218,4785,3474,169,164,157,176,199,4339,
20221006,283,254,발안,군자,1054,83,53,70,132,64,1456,1108,85,74,69,145,75,1556,
20221006,285,253,서평택,서서울,1498,104,126,307,486,87,2608,1374,64,96,232,353,87,2206,
20221006,285,287,서평택,송악,691,29,95,78,701,38,1632,767,41,87,77,582,43,1597,
20221006,285,520,서평택,평택,658,48,63,73,115,76,1033,735,41,72,62,123,74,1107,
20221006,287,253,송악,서서울,1960,49,57,107,475,78,2726,1856,37,74,84,240,74,2365,
20221006,287,285,송악,서평택,767,41,87,77,582,43,1597,691,29,95,78,701,38,1632,
20221006,288,253,당진,서서울,1389,26,56,48,58,55,1632,1335,34,65,25,26,57,1542,
20221006,289,146,마산,동창원,2424,77,79,90,55,193,2918,2584,80,75,87,71,229,3126,
20221006,289,147,마산,진례,1190,95,76,59,78,98,1596,1242,94,87,51,74,81,1629,
20221006,289,148,마산,서김해,1389,26,61,11,16,105,1608,1328,29,52,10,9,103,1531,
20221006,289,150,마산,북부산,2579,35,73,20,38,119,2864,2246,24,75,10,24,115,2494,
20221006,289,244,마산,서부산,2697,53,228,44,63,144,3229,2647,62,226,42,53,132,3162,
20221006,289,245,마산,장유,1272,20,31,14,14,120,1471,1336,27,38,14,13,130,1558,
20221006,291,145,사천,산인,1315,69,61,28,17,64,1554,1141,38,59,20,23,49,1330,
20221006,291,225,사천,서진주,963,21,31,6,20,70,1111,1007,22,23,12,19,68,1151,
20221006,291,292,사천,진주,2848,59,96,37,48,259,3347,3492,95,97,52,60,272,4068,
20221006,292,145,진주,산인,1486,26,134,19,14,93,1772,1215,22,133,18,16,78,1482,
20221006,292,291,진주,사천,3492,95,97,52,60,272,4068,2848,59,96,37,48,259,3347,
20221006,293,145,문산,산인,1049,27,25,14,8,75,1198,995,17,14,8,4,65,1103,
20221006,298,253,서산,서서울,2121,25,50,58,67,82,2403,2161,30,59,48,23,76,2397,
20221006,508,509,무안,목포,1254,42,38,43,54,51,1482,1612,43,47,32,82,84,1900,
20221006,508,553,무안,동광산,1389,24,51,32,34,47,1577,1816,45,57,34,44,56,2052,
20221006,509,508,목포,무안,1612,43,47,32,82,84,1900,1254,42,38,43,54,51,1482,
20221006,509,553,목포,동광산,6510,178,188,141,380,229,7626,6642,159,213,175,436,237,7862,
20221006,513,515,고성,북통영,1392,32,80,13,22,96,1635,1396,34,78,13,31,99,1651,
20221006,513,516,고성,통영,2900,90,134,84,170,206,3584,2701,79,150,77,143,191,3341,
20221006,514,516,동고성,통영,1178,27,60,30,108,175,1578,1161,16,48,36,125,178,1564,
20221006,515,513,북통영,고성,1396,34,78,13,31,99,1651,1392,32,80,13,22,96,1635,
20221006,516,513,통영,고성,2701,79,150,77,143,191,3341,2900,90,134,84,170,206,3584,
20221006,516,514,통영,동고성,1161,16,48,36,125,178,1564,1178,27,60,30,108,175,1578,
20221006,518,127,칠곡물류,서대구,732,113,64,87,71,42,1109,897,123,84,105,77,55,1341,
20221006,519,231,남대구,화원옥포,6356,155,105,180,85,480,7361,6551,178,100,179,152,472,7632,
20221006,519,232,남대구,달성,2929,114,161,51,29,199,3483,2747,114,143,47,43,201,3295,
20221006,519,233,남대구,현풍,4480,199,218,101,142,321,5461,5025,226,226,74,146,361,6058,
20221006,519,239,남대구,칠원,1118,57,102,46,48,33,1404,1036,51,94,33,74,33,1321,
20221006,519,241,남대구,동고령,2992,100,91,318,221,148,3870,3068,102,97,357,186,160,3970,
20221006,519,242,남대구,고령,1667,40,71,27,178,72,2055,1665,54,65,22,177,69,2052,
20221006,519,280,남대구,거창,978,27,60,3,8,43,1119,966,19,43,9,21,51,1109,
20221006,519,730,남대구,유천,2499,55,18,2,27,150,2751,2847,58,14,0,0,189,3108,
20221006,519,731,남대구,북현풍,1967,32,27,0,2,140,2168,1628,29,10,0,0,104,1771,
20221006,520,253,평택,서서울,2234,130,112,202,136,91,2905,1901,119,113,172,127,69,2501,
20221006,520,285,평택,서평택,735,41,72,62,123,74,1107,658,48,63,73,115,76,1033,
20221006,520,540,평택,청북,1142,89,165,135,77,77,1685,835,75,145,134,107,51,1347,
20221006,520,741,평택,평택고덕,955,16,207,16,14,73,1281,739,10,172,8,18,65,1012,
20221006,524,129,청통와촌,북대구,1195,83,29,19,34,48,1408,982,43,25,11,16,52,1129,
20221006,524,230,청통와촌,팔공산,1000,43,30,19,37,47,1176,1175,55,38,15,26,57,1366,
20221006,527,129,포항,북대구,1846,73,35,31,80,96,2161,1500,32,25,26,46,79,1708,
20221006,527,230,포항,팔공산,1381,23,18,11,25,49,1507,1434,27,27,8,18,63,1577,
20221006,528,101,기흥동탄,서울,7466,78,1312,136,8,343,9343,6914,90,1190,140,12,348,8694,
20221006,528,103,기흥동탄,수원신갈,2041,22,178,10,4,110,2365,1441,17,195,9,3,94,1759,
20221006,528,106,기흥동탄,오산,994,43,50,13,12,88,1200,835,42,45,14,10,74,1020,
20221006,528,107,기흥동탄,안성,1179,25,22,3,5,103,1337,986,11,26,1,4,96,1124,
20221006,528,108,기흥동탄,천안,1082,17,117,0,13,71,1300,1082,13,105,2,16,70,1288,
20221006,540,253,청북,서서울,894,69,49,112,97,46,1267,776,43,55,94,67,52,1087,
20221006,540,520,청북,평택,835,75,145,134,107,51,1347,1142,89,165,135,77,77,1685,
20221006,540,741,청북,평택고덕,900,23,40,48,119,74,1204,934,36,54,54,131,90,1299,
20221006,542,101,서안성,서울,1755,54,95,192,59,92,2247,1225,47,82,103,31,65,1553,
20221006,542,543,서안성,남안성,1159,59,80,132,108,100,1638,1210,55,93,126,88,102,1674,
20221006,543,101,남안성,서울,1279,98,74,108,106,49,1714,1205,73,55,65,60,41,1499,
20221006,543,542,남안성,서안성,1210,55,93,126,88,102,1674,1159,59,80,132,108,100,1638,
20221006,543,555,남안성,북진천,792,103,136,180,155,40,1406,812,106,136,161,159,43,1417,
20221006,548,553,북무안,동광산,1225,21,33,26,149,28,1482,1476,26,40,29,193,42,1806,
20221006,549,553,동함평,동광산,3069,37,69,32,71,110,3388,3277,62,87,39,66,117,3648,
20221006,551,553,나주,동광산,1127,20,37,78,39,53,1354,1312,18,50,84,47,64,1575,
20221006,552,553,서광산,동광산,4081,182,163,233,178,154,4991,5849,202,216,226,174,229,6896,
20221006,553,508,동광산,무안,1816,45,57,34,44,56,2052,1389,24,51,32,34,47,1577,
20221006,553,509,동광산,목포,6642,159,213,175,436,237,7862,6510,178,188,141,380,229,7626,
20221006,553,548,동광산,북무안,1476,26,40,29,193,42,1806,1225,21,33,26,149,28,1482,
20221006,553,549,동광산,동함평,3277,62,87,39,66,117,3648,3069,37,69,32,71,110,3388,
20221006,553,551,동광산,나주,1312,18,50,84,47,64,1575,1127,20,37,78,39,53,1354,
20221006,553,552,동광산,서광산,5849,202,216,226,174,229,6896,4081,182,163,233,178,154,4991,
20221006,554,174,동홍천,춘천,1244,17,21,6,7,89,1384,1163,15,20,11,7,84,1300,
20221006,555,543,북진천,남안성,812,106,136,161,159,43,1417,792,103,136,180,155,40,1406,
20221006,560,190,감곡,동서울,882,45,39,35,107,37,1145,997,21,39,43,90,31,1221,
20221006,567,167,남고창,광주,1337,23,46,20,26,54,1506,1314,31,50,17,24,49,1485,
20221006,569,271,북광주,순천,817,51,39,38,102,37,1084,762,54,39,23,136,25,1039,
20221006,579,115,남세종,대전,1122,7,14,6,38,87,1274,1101,6,20,7,19,91,1244,
20221006,579,153,남세종,서대전,1015,17,15,7,11,72,1137,1173,13,21,5,4,85,1301,
20221006,587,589,오수,상관,1103,24,55,44,37,41,1304,1208,21,47,36,135,45,1492,
20221006,589,587,상관,오수,1208,21,47,36,135,45,1492,1103,24,55,44,37,41,1304,
20221006,597,598,서여주,북여주,963,45,136,38,46,45,1273,1040,44,84,39,59,53,1319,
20221006,598,597,북여주,서여주,1040,44,84,39,59,53,1319,963,45,136,38,46,45,1273,
20221006,621,127,동대구,서대구,1323,41,50,36,24,96,1570,1820,70,98,37,35,134,2194,
20221006,621,131,동대구,경산,2464,78,49,286,25,132,3034,2246,74,38,282,52,125,2817,
20221006,621,132,동대구,영천,1177,16,23,2,41,69,1328,1130,14,22,5,39,54,1264,
20221006,625,626,밀양,남밀양,1115,75,57,73,56,56,1432,1115,54,68,62,59,51,1409,
20221006,626,625,남밀양,밀양,1115,54,68,62,59,51,1409,1115,75,57,73,56,56,1432,
20221006,626,627,남밀양,삼랑진,971,32,35,12,103,105,1258,987,35,26,9,100,101,1258,
20221006,627,626,삼랑진,남밀양,987,35,26,9,100,101,1258,971,32,35,12,103,105,1258,
20221006,641,139,울산,서울산,1110,22,48,15,25,73,1293,1145,35,61,25,49,101,1416,
20221006,641,252,울산,대동,1309,84,88,35,55,71,1642,1554,66,97,39,57,106,1919,
20221006,641,643,울산,청량,1214,10,17,11,71,101,1424,1300,9,14,18,76,128,1545,
20221006,641,706,울산,남경주,1104,11,29,4,15,55,1218,1110,6,38,14,20,57,1245,
20221006,641,707,울산,남포항,982,17,21,19,105,48,1192,992,13,21,19,82,53,1180,
20221006,643,641,청량,울산,1300,9,14,18,76,128,1545,1214,10,17,11,71,101,1424,
20221006,643,648,청량,해운대,2811,26,40,37,81,191,3186,3076,34,75,62,504,181,3932,
20221006,645,648,장안,해운대,1626,18,14,4,8,96,1766,2887,36,28,90,98,185,3324,
20221006,646,648,기장일광,해운대,4768,25,33,45,61,276,5208,5456,40,42,26,177,326,6067,
20221006,648,643,해운대,청량,3076,34,75,62,504,181,3932,2811,26,40,37,81,191,3186,
20221006,648,645,해운대,장안,2887,36,28,90,98,185,3324,1626,18,14,4,8,96,1766,
20221006,648,646,해운대,기장일광,5456,40,42,26,177,326,6067,4768,25,33,45,61,276,5208,
20221006,651,652,남양주,화도,14752,575,538,508,265,1123,17761,16294,612,580,544,263,1270,19563,
20221006,651,653,남양주,서종,1968,16,8,3,53,84,2132,1958,18,10,5,49,80,2120,
20221006,651,654,남양주,설악,3861,46,67,14,18,134,4140,3586,31,60,18,21,123,3839,
20221006,651,655,남양주,강촌,2382,40,106,29,25,84,2666,2578,43,110,27,35,89,2882,
20221006,651,656,남양주,남춘천,2762,44,61,30,38,84,3019,2234,22,41,10,37,48,2392,
20221006,652,651,화도,남양주,16294,612,580,544,263,1270,19563,14752,575,538,508,265,1123,17761,
20221006,652,653,화도,서종,1429,26,27,24,12,118,1636,1553,30,31,21,16,122,1773,
20221006,652,654,화도,설악,1324,21,12,5,8,83,1453,1276,24,9,5,10,73,1397,
20221006,653,651,서종,남양주,1958,18,10,5,49,80,2120,1968,16,8,3,53,84,2132,
20221006,653,652,서종,화도,1553,30,31,21,16,122,1773,1429,26,27,24,12,118,1636,
20221006,654,651,설악,남양주,3586,31,60,18,21,123,3839,3861,46,67,14,18,134,4140,
20221006,654,652,설악,화도,1276,24,9,5,10,73,1397,1324,21,12,5,8,83,1453,
20221006,655,651,강촌,남양주,2578,43,110,27,35,89,2882,2382,40,106,29,25,84,2666,
20221006,656,651,남춘천,남양주,2234,22,41,10,37,48,2392,2762,44,61,30,38,84,3019,
20221006,671,672,봉담,정남,3357,168,96,87,153,231,4092,4056,174,88,66,164,304,4852,
20221006,671,673,봉담,북오산,2051,57,51,17,15,159,2350,2161,54,57,27,27,184,2510,
20221006,671,675,봉담,서오산,920,24,21,7,5,56,1033,970,27,20,5,13,69,1104,
20221006,671,676,봉담,향남,1403,139,60,29,31,102,1764,1288,120,48,22,28,98,1604,
20221006,671,677,봉담,북평택,7553,214,247,155,250,439,8858,7637,181,220,131,190,454,8813,
20221006,672,671,정남,봉담,4056,174,88,66,164,304,4852,3357,168,96,87,153,231,4092,
20221006,673,101,북오산,서울,1617,57,132,28,13,109,1956,1683,46,121,17,10,111,1988,
20221006,673,671,북오산,봉담,2161,54,57,27,27,184,2510,2051,57,51,17,15,159,2350,
20221006,673,677,북오산,북평택,2013,39,91,29,43,143,2358,1913,47,70,33,25,122,2210,
20221006,675,671,서오산,봉담,970,27,20,5,13,69,1104,920,24,21,7,5,56,1033,
20221006,675,676,서오산,향남,3644,116,76,58,59,240,4193,3234,97,67,50,36,222,3706,
20221006,675,677,서오산,북평택,11670,244,439,183,190,744,13470,11281,245,393,201,177,708,13005,
20221006,675,876,서오산,양감,1906,71,45,40,85,122,2269,2251,71,36,27,70,144,2599,
20221006,676,671,향남,봉담,1288,120,48,22,28,98,1604,1403,139,60,29,31,102,1764,
20221006,676,675,향남,서오산,3234,97,67,50,36,222,3706,3644,116,76,58,59,240,4193,
20221006,676,677,향남,북평택,1819,169,170,200,185,109,2652,1560,161,155,182,155,92,2305,
20221006,677,101,북평택,서울,1694,77,294,115,133,77,2390,1883,90,301,84,106,89,2553,
20221006,677,671,북평택,봉담,7637,181,220,131,190,454,8813,7553,214,247,155,250,439,8858,
20221006,677,673,북평택,북오산,1913,47,70,33,25,122,2210,2013,39,91,29,43,143,2358,
20221006,677,675,북평택,서오산,11281,245,393,201,177,708,13005,11670,244,439,183,190,744,13470,
20221006,677,676,북평택,향남,1560,161,155,182,155,92,2305,1819,169,170,200,185,109,2652,
20221006,677,876,북평택,양감,2298,146,170,282,178,153,3227,2073,140,189,256,153,148,2959,
20221006,682,683,조암,송산마도,890,109,102,67,53,42,1263,1055,121,112,82,69,49,1488,
20221006,682,684,조암,남안산,1107,166,181,111,130,46,1741,1142,162,166,116,137,41,1764,
20221006,682,685,조암,서시흥,1771,217,149,177,302,95,2711,1917,200,160,187,299,114,2877,
20221006,683,682,송산마도,조암,1055,121,112,82,69,49,1488,890,109,102,67,53,42,1263,
20221006,683,684,송산마도,남안산,2643,203,176,120,193,153,3488,2244,169,139,107,130,140,2929,
20221006,683,685,송산마도,서시흥,5085,315,210,199,974,283,7066,4792,274,206,195,977,266,6710,
20221006,684,682,남안산,조암,1142,162,166,116,137,41,1764,1107,166,181,111,130,46,1741,
20221006,684,683,남안산,송산마도,2244,169,139,107,130,140,2929,2643,203,176,120,193,153,3488,
20221006,684,685,남안산,서시흥,5228,577,331,452,691,380,7659,5054,408,342,388,522,367,7081,
20221006,685,682,서시흥,조암,1917,200,160,187,299,114,2877,1771,217,149,177,302,95,2711,
20221006,685,683,서시흥,송산마도,4792,274,206,195,977,266,6710,5085,315,210,199,974,283,7066,
20221006,685,684,서시흥,남안산,5054,408,342,388,522,367,7081,5228,577,331,452,691,380,7659,
20221006,705,190,남이천,동서울,1862,130,80,123,97,45,2337,1486,89,87,134,120,45,1961,
20221006,706,641,남경주,울산,1110,6,38,14,20,57,1245,1104,11,29,4,15,55,1218,
20221006,706,707,남경주,남포항,894,34,73,28,252,57,1338,965,37,83,44,185,60,1374,
20221006,707,641,남포항,울산,992,13,21,19,82,53,1180,982,17,21,19,105,48,1192,
20221006,707,706,남포항,남경주,965,37,83,44,185,60,1374,894,34,73,28,252,57,1338,
20221006,707,708,남포항,동경주,1279,25,37,21,205,73,1640,1293,25,36,28,236,72,1690,
20221006,708,707,동경주,남포항,1293,25,36,28,236,72,1690,1279,25,37,21,205,73,1640,
20221006,715,716,동안동,청송,1080,18,13,15,33,50,1209,1033,29,14,14,39,55,1184,
20221006,716,715,청송,동안동,1033,29,14,14,39,55,1184,1080,18,13,15,33,50,1209,
20221006,730,519,유천,남대구,2847,58,14,0,0,189,3108,2499,55,18,2,27,150,2751,
20221006,731,519,북현풍,남대구,1628,29,10,0,0,104,1771,1967,32,27,0,2,140,2168,
20221006,741,253,평택고덕,서서울,933,31,28,22,14,64,1092,994,27,23,26,9,74,1153,
20221006,741,520,평택고덕,평택,739,10,172,8,18,65,1012,955,16,207,16,14,73,1281,
20221006,741,540,평택고덕,청북,934,36,54,54,131,90,1299,900,23,40,48,119,74,1204,
20221006,742,107,남사진위,안성,1412,46,55,30,11,107,1661,1270,42,50,24,6,109,1501,
20221006,742,108,남사진위,천안,1146,34,39,27,5,69,1320,1175,27,39,21,10,87,1359,
20221006,752,252,기장철마,대동,1841,61,72,31,67,140,2212,1846,71,67,39,85,155,2263,
20221006,753,252,금정,대동,1094,56,64,85,88,64,1451,1788,90,97,104,197,119,2395,
20221006,755,140,광재,부산,949,20,16,9,31,64,1089,1084,19,15,13,33,72,1236,
20221006,755,252,광재,대동,2314,85,77,98,445,124,3143,2309,93,93,97,302,160,3054,
20221006,756,252,한림,대동,926,60,33,25,130,49,1223,856,45,23,27,93,51,1095,
20221006,772,774,북달성,남칠곡,2381,51,65,30,29,158,2714,2456,46,60,35,19,142,2758,
20221006,773,774,북다사,남칠곡,1338,21,19,12,21,90,1501,1255,27,23,10,20,85,1420,
20221006,774,772,남칠곡,북달성,2456,46,60,35,19,142,2758,2381,51,65,30,29,158,2714,
20221006,774,773,남칠곡,북다사,1255,27,23,10,20,85,1420,1338,21,19,12,21,90,1501,
20221006,775,203,동명동호,가산,1713,62,55,44,192,69,2135,1755,52,50,47,238,86,2228,
20221006,776,777,연경,파군재,3339,52,36,17,14,230,3688,2456,39,37,16,16,166,2730,
20221006,776,779,연경,율암,6007,106,70,80,151,447,6861,6091,117,90,83,148,441,6970,
20221006,777,776,파군재,연경,2456,39,37,16,16,166,2730,3339,52,36,17,14,230,3688,
20221006,777,779,파군재,율암,2435,27,25,3,15,230,2735,2387,25,25,3,11,211,2662,
20221006,779,776,율암,연경,6091,117,90,83,148,441,6970,6007,106,70,80,151,447,6861,
20221006,779,777,율암,파군재,2387,25,25,3,11,211,2662,2435,27,25,3,15,230,2735,
20221006,876,675,양감,서오산,2251,71,36,27,70,144,2599,1906,71,45,40,85,122,2269,
20221006,876,677,양감,북평택,2073,140,189,256,153,148,2959,2298,146,170,282,178,153,3227,
20221006,981,982,서영암,강진무위사,1900,56,82,45,43,76,2202,1787,41,76,69,43,79,2095,
20221006,981,987,서영암,남순천,1656,25,86,62,385,42,2256,1537,42,107,121,384,40,2231,
20221006,982,981,강진무위사,서영암,1787,41,76,69,43,79,2095,1900,56,82,45,43,76,2202,
20221006,984,985,보성,벌교,1533,48,50,52,70,36,1789,1533,57,59,30,50,35,1764,
20221006,984,987,보성,남순천,1820,57,84,82,311,75,2429,1842,50,72,55,295,62,2376,
20221006,985,984,벌교,보성,1533,57,59,30,50,35,1764,1533,48,50,52,70,36,1789,
20221006,986,987,고흥,남순천,3447,65,108,146,283,129,4178,3751,72,95,160,267,156,4501,
20221006,987,981,남순천,서영암,1537,42,107,121,384,40,2231,1656,25,86,62,385,42,2256,
20221006,987,984,남순천,보성,1842,50,72,55,295,62,2376,1820,57,84,82,311,75,2429,
20221006,987,986,남순천,고흥,3751,72,95,160,267,156,4501,3447,65,108,146,283,129,4178,
20221007,101,102,서울,동수원,3434,52,237,9,5,188,3925,5033,58,362,36,10,289,5788,
20221007,101,103,서울,수원신갈,13985,647,1683,443,171,708,17637,14654,703,1737,386,118,710,18308,
20221007,101,105,서울,기흥,6617,101,413,76,29,330,7566,6089,93,365,98,43,304,6992,
20221007,101,106,서울,오산,4402,394,445,170,82,289,5782,4836,479,451,193,86,291,6336,
20221007,101,107,서울,안성,3166,84,309,42,13,192,3806,3075,82,300,56,27,180,3720,
20221007,101,108,서울,천안,4160,50,373,36,17,165,4801,4173,59,365,59,18,171,4845,
20221007,101,111,서울,청주,1039,10,229,25,31,37,1371,868,6,261,25,22,32,1214,
20221007,101,171,서울,마성,2317,23,215,52,10,91,2708,2501,26,261,57,13,120,2978,
20221007,101,172,서울,용인,3363,159,124,36,28,208,3918,3860,180,122,58,43,243,4506,
20221007,101,173,서울,양지,3806,211,145,104,82,139,4487,4702,400,172,175,107,198,5754,
20221007,101,175,서울,덕평,764,76,91,46,27,38,1042,916,120,103,38,33,48,1258,
20221007,101,229,서울,북천안,888,47,59,51,24,39,1108,950,49,47,60,20,45,1171,
20221007,101,528,서울,기흥동탄,6970,70,1219,130,12,338,8739,7379,67,1366,123,14,349,9298,
20221007,101,542,서울,서안성,1187,39,91,89,23,49,1478,1694,55,88,161,48,90,2136,
20221007,101,543,서울,남안성,1149,68,79,76,60,35,1467,969,82,84,99,90,43,1367,
20221007,101,673,서울,북오산,1598,50,118,19,8,116,1909,1616,44,122,22,17,129,1950,
20221007,101,677,서울,북평택,2116,64,295,84,98,91,2748,1661,69,287,107,121,68,2313,
20221007,102,101,동수원,서울,5033,58,362,36,10,289,5788,3434,52,237,9,5,188,3925,
20221007,102,172,동수원,용인,1071,27,13,7,5,68,1191,1055,36,14,8,1,89,1203,
20221007,102,173,동수원,양지,1304,44,33,9,16,75,1481,1494,46,35,8,6,74,1663,
20221007,102,212,동수원,북수원,4471,43,232,42,47,252,5087,5135,46,247,48,26,279,5781,
20221007,102,213,동수원,부곡,1169,16,18,4,22,70,1299,1088,16,21,5,25,82,1237,
20221007,102,214,동수원,동군포,1706,30,21,9,7,105,1878,1859,25,24,11,8,121,2048,
20221007,102,215,동수원,군포,1535,22,26,7,6,109,1705,2259,16,36,6,2,169,2488,
20221007,102,253,동수원,서서울,5636,67,66,20,16,335,6140,4865,69,58,30,12,309,5343,
20221007,102,254,동수원,군자,3588,47,64,26,38,180,3943,4159,69,76,35,39,247,4625,
20221007,102,255,동수원,서안산,1735,50,19,15,4,94,1917,1853,35,15,8,8,100,2019,
20221007,103,101,수원신갈,서울,14654,703,1737,386,118,710,18308,13985,647,1683,443,171,708,17637,
20221007,103,105,수원신갈,기흥,1852,25,52,103,26,113,2171,2342,38,36,84,50,156,2706,
20221007,103,106,수원신갈,오산,1137,74,55,31,15,75,1387,1481,71,72,42,9,85,1760,
20221007,103,108,수원신갈,천안,1036,15,56,9,1,42,1159,1295,15,57,14,1,56,1438,
20221007,103,212,수원신갈,북수원,889,46,26,27,13,68,1069,1461,88,47,51,35,89,1771,
20221007,103,253,수원신갈,서서울,1970,156,77,65,28,135,2431,2002,133,81,77,40,114,2447,
20221007,103,254,수원신갈,군자,1332,81,69,71,83,64,1700,1737,108,78,129,133,106,2291,
20221007,103,528,수원신갈,기흥동탄,1568,16,194,2,2,88,1870,2079,21,159,4,10,136,2409,
20221007,105,101,기흥,서울,6089,93,365,98,43,304,6992,6617,101,413,76,29,330,7566,
20221007,105,103,기흥,수원신갈,2342,38,36,84,50,156,2706,1852,25,52,103,26,113,2171,
20221007,106,101,오산,서울,4836,479,451,193,86,291,6336,4402,394,445,170,82,289,5782,
20221007,106,103,오산,수원신갈,1481,71,72,42,9,85,1760,1137,74,55,31,15,75,1387,
20221007,106,107,오산,안성,1501,44,44,16,12,146,1763,1455,48,25,17,12,128,1685,
20221007,106,108,오산,천안,1025,24,25,16,8,61,1159,1078,22,37,18,9,68,1232,
20221007,106,528,오산,기흥동탄,991,38,49,20,10,80,1188,1021,35,50,12,8,73,1199,
20221007,107,101,안성,서울,3075,82,300,56,27,180,3720,3166,84,309,42,13,192,3806,
20221007,107,106,안성,오산,1455,48,25,17,12,128,1685,1501,44,44,16,12,146,1763,
20221007,107,108,안성,천안,1594,28,45,11,9,121,1808,1632,31,50,13,5,130,1861,
20221007,107,528,안성,기흥동탄,1015,9,19,4,8,95,1150,1100,20,18,4,6,92,1240,
20221007,107,742,안성,남사진위,1417,51,51,25,6,121,1671,1593,35,51,31,11,123,1844,
20221007,108,101,천안,서울,4173,59,365,59,18,171,4845,4160,50,373,36,17,165,4801,
20221007,108,103,천안,수원신갈,1295,15,57,14,1,56,1438,1036,15,56,9,1,42,1159,
20221007,108,106,천안,오산,1078,22,37,18,9,68,1232,1025,24,25,16,8,61,1159,
20221007,108,107,천안,안성,1632,31,50,13,5,130,1861,1594,28,45,11,9,121,1808,
20221007,108,110,천안,목천,1242,41,74,31,38,76,1502,862,18,79,24,22,59,1064,
20221007,108,111,천안,청주,1157,41,57,25,42,66,1388,1169,32,52,28,27,67,1375,
20221007,108,229,천안,북천안,3620,84,114,46,38,204,4106,3430,90,134,60,89,213,4016,
20221007,108,528,천안,기흥동탄,1119,15,107,3,13,68,1325,1173,19,123,1,11,77,1404,
20221007,108,541,천안,송탄,839,43,27,14,19,62,1004,872,49,27,13,15,81,1057,
20221007,108,742,천안,남사진위,1370,29,45,20,5,82,1551,1250,35,51,32,8,75,1451,
20221007,110,108,목천,천안,862,18,79,24,22,59,1064,1242,41,74,31,38,76,1502,
20221007,111,101,청주,서울,868,6,261,25,22,32,1214,1039,10,229,25,31,37,1371,
20221007,111,108,청주,천안,1169,32,52,28,27,67,1375,1157,41,57,25,42,66,1388,
20221007,112,115,남청주,대전,1673,91,68,9,29,115,1985,1698,90,54,7,4,128,1981,
20221007,113,115,신탄진,대전,1018,35,14,4,14,111,1196,1218,43,12,12,6,120,1411,
20221007,113,198,신탄진,서청주,814,30,22,46,35,53,1000,966,32,26,20,21,80,1145,
20221007,114,153,남대전,서대전,1977,56,63,55,10,133,2294,1826,51,97,72,15,121,2182,
20221007,115,112,대전,남청주,1698,90,54,7,4,128,1981,1673,91,68,9,29,115,1985,
20221007,115,113,대전,신탄진,1218,43,12,12,6,120,1411,1018,35,14,4,14,111,1196,
20221007,115,116,대전,옥천,2361,115,47,23,19,181,2746,2167,60,39,31,27,140,2464,
20221007,115,151,대전,북대전,1117,19,16,3,5,131,1291,906,12,18,2,7,109,1054,
20221007,115,153,대전,서대전,1069,27,18,1,2,76,1193,1016,25,14,0,1,90,1146,
20221007,115,198,대전,서청주,912,23,1,4,2,75,1017,906,17,7,6,2,75,1013,
20221007,115,579,대전,남세종,1009,10,15,3,29,91,1157,1085,10,22,4,36,94,1251,
20221007,116,115,옥천,대전,2167,60,39,31,27,140,2464,2361,115,47,23,19,181,2746,
20221007,119,153,판암,서대전,1962,25,22,13,5,159,2186,2066,27,25,12,7,182,2319,
20221007,123,127,구미,서대구,1694,32,30,13,9,112,1890,1675,25,39,27,10,105,1881,
20221007,123,129,구미,북대구,1871,21,60,4,4,94,2054,2019,16,61,7,4,110,2217,
20221007,123,130,구미,동김천,1268,22,35,30,32,91,1478,1154,24,33,17,23,86,1337,
20221007,125,127,남구미,서대구,1913,57,99,47,16,128,2260,2127,74,117,46,29,133,2526,
20221007,125,129,남구미,북대구,1931,27,77,14,10,129,2188,2140,21,91,21,7,127,2407,
20221007,126,127,왜관,서대구,2360,114,68,43,128,152,2865,2924,137,83,51,97,151,3443,
20221007,126,129,왜관,북대구,2856,90,63,29,89,115,3242,3519,103,77,29,118,150,3996,
20221007,127,123,서대구,구미,1675,25,39,27,10,105,1881,1694,32,30,13,9,112,1890,
20221007,127,125,서대구,남구미,2127,74,117,46,29,133,2526,1913,57,99,47,16,128,2260,
20221007,127,126,서대구,왜관,2924,137,83,51,97,151,3443,2360,114,68,43,128,152,2865,
20221007,127,131,서대구,경산,2569,224,160,119,74,158,3304,1908,169,111,71,65,119,2443,
20221007,127,201,서대구,칠곡,1455,26,28,9,8,90,1616,892,16,25,7,8,58,1006,
20221007,127,203,서대구,가산,2296,69,106,40,162,105,2778,2092,65,86,33,155,113,2544,
20221007,127,230,서대구,팔공산,1587,51,58,15,8,87,1806,1074,25,43,11,6,81,1240,
20221007,127,518,서대구,칠곡물류,900,118,84,99,47,49,1297,752,90,71,86,44,44,1087,
20221007,127,527,서대구,포항,1205,34,55,24,79,62,1459,936,40,37,12,53,54,1132,
20221007,127,621,서대구,동대구,1936,60,71,41,39,153,2300,1349,50,41,23,16,96,1575,
20221007,129,123,북대구,구미,2019,16,61,7,4,110,2217,1871,21,60,4,4,94,2054,
20221007,129,125,북대구,남구미,2140,21,91,21,7,127,2407,1931,27,77,14,10,129,2188,
20221007,129,126,북대구,왜관,3519,103,77,29,118,150,3996,2856,90,63,29,89,115,3242,
20221007,129,131,북대구,경산,2375,164,100,62,41,129,2871,2938,215,154,73,40,164,3584,
20221007,129,524,북대구,청통와촌,987,44,26,10,10,52,1129,1141,63,34,22,36,53,1349,
20221007,129,527,북대구,포항,1663,31,23,28,61,80,1886,2142,51,36,24,84,100,2437,
20221007,130,123,동김천,구미,1154,24,33,17,23,86,1337,1268,22,35,30,32,91,1478,
20221007,131,127,경산,서대구,1908,169,111,71,65,119,2443,2569,224,160,119,74,158,3304,
20221007,131,129,경산,북대구,2938,215,154,73,40,164,3584,2375,164,100,62,41,129,2871,
20221007,131,132,경산,영천,913,50,54,50,60,48,1175,902,60,63,52,35,55,1167,
20221007,131,230,경산,팔공산,1349,85,43,24,21,85,1607,1512,87,55,28,32,83,1797,
20221007,131,621,경산,동대구,2240,63,49,267,71,142,2832,2445,72,50,274,35,143,3019,
20221007,132,131,영천,경산,902,60,63,52,35,55,1167,913,50,54,50,60,48,1175,
20221007,132,621,영천,동대구,1315,11,34,7,31,71,1469,1202,12,26,0,50,60,1350,
20221007,135,140,경주,부산,1393,14,29,10,49,73,1568,1580,18,35,6,30,66,1735,
20221007,135,252,경주,대동,1072,36,94,47,173,47,1469,1462,49,92,66,132,73,1874,
20221007,137,140,통도사,부산,826,40,34,15,47,54,1016,830,29,41,14,49,50,1013,
20221007,138,140,양산,부산,5378,250,189,178,277,277,6549,5628,318,206,193,285,288,6918,
20221007,138,252,양산,대동,2728,338,204,291,347,124,4032,3060,344,233,282,326,142,4387,
20221007,139,140,서울산,부산,1436,43,28,9,30,80,1626,1523,49,19,8,26,84,1709,
20221007,139,252,서울산,대동,883,47,50,35,47,52,1114,1010,46,39,36,36,60,1227,
20221007,139,641,서울산,울산,1418,43,57,34,51,101,1704,1411,33,56,22,25,99,1646,
20221007,140,135,부산,경주,1580,18,35,6,30,66,1735,1393,14,29,10,49,73,1568,
20221007,140,137,부산,통도사,830,29,41,14,49,50,1013,826,40,34,15,47,54,1016,
20221007,140,138,부산,양산,5628,318,206,193,285,288,6918,5378,250,189,178,277,277,6549,
20221007,140,139,부산,서울산,1523,49,19,8,26,84,1709,1436,43,28,9,30,80,1626,
20221007,140,250,부산,남양산,8047,125,250,54,59,669,9204,8037,112,235,44,50,660,9138,
20221007,140,251,부산,물금,1088,134,25,40,59,85,1431,1064,107,28,37,61,64,1361,
20221007,140,252,부산,대동,1795,57,39,37,62,104,2094,1728,41,43,48,105,92,2057,
20221007,140,755,부산,광재,1100,30,22,15,25,58,1250,1016,27,13,22,25,72,1175,
20221007,142,145,군북,산인,4454,98,104,52,81,303,5092,4292,83,106,54,83,279,4897,
20221007,143,145,장지,산인,1336,22,35,30,39,92,1554,1283,24,32,32,54,98,1523,
20221007,144,145,함안,산인,2163,55,52,27,141,133,2571,2145,53,42,30,137,138,2545,
20221007,145,142,산인,군북,4292,83,106,54,83,279,4897,4454,98,104,52,81,303,5092,
20221007,145,143,산인,장지,1283,24,32,32,54,98,1523,1336,22,35,30,39,92,1554,
20221007,145,144,산인,함안,2145,53,42,30,137,138,2545,2163,55,52,27,141,133,2571,
20221007,145,291,산인,사천,1510,47,75,15,18,80,1745,1866,68,67,22,14,88,2125,
20221007,145,292,산인,진주,1522,30,158,11,15,68,1804,1788,26,155,20,17,97,2103,
20221007,145,293,산인,문산,1401,31,21,9,4,96,1562,1375,25,27,16,13,78,1534,
20221007,146,150,동창원,북부산,1141,18,21,4,26,87,1297,1049,17,18,3,17,73,1177,
20221007,146,244,동창원,서부산,1274,26,32,21,40,69,1462,1386,34,42,21,67,87,1637,
20221007,146,245,동창원,장유,954,18,12,5,4,102,1095,1028,16,10,5,4,95,1158,
20221007,146,289,동창원,마산,2834,82,66,40,83,259,3364,2734,99,75,39,45,224,3216,
20221007,147,150,진례,북부산,1396,46,27,19,71,75,1634,1640,60,24,17,32,93,1866,
20221007,147,244,진례,서부산,1765,108,72,64,107,109,2225,1902,117,83,71,138,107,2418,
20221007,147,245,진례,장유,1090,59,100,92,20,104,1465,1473,60,104,77,28,144,1886,
20221007,147,289,진례,마산,1373,105,66,57,79,76,1756,1398,108,94,75,68,94,1837,
20221007,148,150,서김해,북부산,6682,127,77,54,105,472,7517,6765,116,73,47,71,499,7571,
20221007,148,251,서김해,물금,992,42,24,28,10,87,1183,1028,48,20,32,20,88,1236,
20221007,148,289,서김해,마산,1536,42,59,10,11,101,1759,1724,40,64,15,10,111,1964,
20221007,149,150,동김해,북부산,10520,187,183,51,93,903,11937,9490,164,141,35,76,745,10651,
20221007,149,245,동김해,장유,856,47,100,15,10,81,1109,785,44,97,8,0,77,1011,
20221007,149,250,동김해,남양산,1193,26,57,6,7,83,1372,1035,18,52,6,6,77,1194,
20221007,149,251,동김해,물금,1107,51,15,8,6,105,1292,1095,40,8,14,7,114,1278,
20221007,149,289,동김해,마산,939,33,39,20,10,70,1111,1129,43,51,11,9,72,1315,
20221007,150,146,북부산,동창원,1049,17,18,3,17,73,1177,1141,18,21,4,26,87,1297,
20221007,150,147,북부산,진례,1640,60,24,17,32,93,1866,1396,46,27,19,71,75,1634,
20221007,150,148,북부산,서김해,6765,116,73,47,71,499,7571,6682,127,77,54,105,472,7517,
20221007,150,149,북부산,동김해,9490,164,141,35,76,745,10651,10520,187,183,51,93,903,11937,
20221007,150,245,북부산,장유,3854,46,102,9,39,263,4313,3464,43,88,6,42,246,3889,
20221007,150,289,북부산,마산,2925,24,88,15,30,125,3207,3521,32,82,19,55,175,3884,
20221007,151,115,북대전,대전,906,12,18,2,7,109,1054,1117,19,16,3,5,131,1291,
20221007,151,153,북대전,서대전,1067,18,17,13,28,99,1242,1283,18,30,22,20,102,1475,
20221007,152,154,유성,안영,1073,26,39,10,68,77,1293,1235,29,29,8,59,89,1449,
20221007,153,114,서대전,남대전,1826,51,97,72,15,121,2182,1977,56,63,55,10,133,2294,
20221007,153,115,서대전,대전,1016,25,14,0,1,90,1146,1069,27,18,1,2,76,1193,
20221007,153,119,서대전,판암,2066,27,25,12,7,182,2319,1962,25,22,13,5,159,2186,
20221007,153,151,서대전,북대전,1283,18,30,22,20,102,1475,1067,18,17,13,28,99,1242,
20221007,153,154,서대전,안영,1206,42,37,51,50,74,1460,1303,38,50,54,24,81,1550,
20221007,153,579,서대전,남세종,1336,16,20,5,12,105,1494,1031,22,24,5,7,93,1182,
20221007,154,152,안영,유성,1235,29,29,8,59,89,1449,1073,26,39,10,68,77,1293,
20221007,154,153,안영,서대전,1303,38,50,54,24,81,1550,1206,42,37,51,50,74,1460,
20221007,159,167,서전주,광주,1745,66,79,55,51,46,2042,1542,64,67,54,46,49,1822,
20221007,163,167,정읍,광주,936,33,51,29,28,33,1110,886,32,61,37,27,33,1076,
20221007,166,167,장성,광주,2475,95,79,33,63,105,2850,2894,124,82,34,38,132,3304,
20221007,167,159,광주,서전주,1542,64,67,54,46,49,1822,1745,66,79,55,51,46,2042,
20221007,167,163,광주,정읍,886,32,61,37,27,33,1076,936,33,51,29,28,33,1110,
20221007,167,166,광주,장성,2894,124,82,34,38,132,3304,2475,95,79,33,63,105,2850,
20221007,167,567,광주,남고창,1433,29,47,6,42,63,1620,1495,28,48,12,41,52,1676,
20221007,171,101,마성,서울,2501,26,261,57,13,120,2978,2317,23,215,52,10,91,2708,
20221007,172,101,용인,서울,3860,180,122,58,43,243,4506,3363,159,124,36,28,208,3918,
20221007,172,102,용인,동수원,1055,36,14,8,1,89,1203,1071,27,13,7,5,68,1191,
20221007,172,173,용인,양지,2000,276,139,165,45,143,2768,1885,231,154,161,61,136,2628,
20221007,172,212,용인,북수원,978,48,13,16,18,66,1139,1261,64,25,17,15,77,1459,
20221007,172,253,용인,서서울,1034,50,30,37,19,67,1237,1024,48,24,36,15,50,1197,
20221007,173,101,양지,서울,4702,400,172,175,107,198,5754,3806,211,145,104,82,139,4487,
20221007,173,102,양지,동수원,1494,46,35,8,6,74,1663,1304,44,33,9,16,75,1481,
20221007,173,172,양지,용인,1885,231,154,161,61,136,2628,2000,276,139,165,45,143,2768,
20221007,173,212,양지,북수원,1496,96,50,57,35,83,1817,1416,102,59,42,58,73,1750,
20221007,173,253,양지,서서울,1363,151,81,125,56,71,1847,998,129,62,97,40,58,1384,
20221007,173,254,양지,군자,899,130,94,189,199,34,1545,741,104,111,146,198,42,1342,
20221007,174,179,춘천,홍천,3551,84,87,72,58,318,4170,3567,78,70,70,51,317,4153,
20221007,174,216,춘천,횡성,1181,45,29,27,28,66,1376,1236,45,36,17,19,69,1422,
20221007,174,218,춘천,남원주,1472,20,76,18,13,101,1700,1427,24,83,17,14,87,1652,
20221007,174,554,춘천,동홍천,1250,17,14,15,9,94,1399,1357,18,13,4,15,120,1527,
20221007,175,101,덕평,서울,916,120,103,38,33,48,1258,764,76,91,46,27,38,1042,
20221007,176,190,이천,동서울,1984,64,210,144,97,104,2603,1594,60,221,160,81,95,2211,
20221007,179,174,홍천,춘천,3567,78,70,70,51,317,4153,3551,84,87,72,58,318,4170,
20221007,184,189,대관령,강릉,1191,25,53,2,6,79,1356,1267,23,49,4,7,89,1439,
20221007,189,184,강릉,대관령,1267,23,49,4,7,89,1439,1191,25,53,2,6,79,1356,
20221007,190,176,동서울,이천,1594,60,221,160,81,95,2211,1984,64,210,144,97,104,2603,
20221007,190,191,동서울,경기광주,10963,710,483,358,276,749,13539,11028,738,460,340,343,766,13675,
20221007,190,192,동서울,곤지암,5798,490,233,192,95,363,7171,4904,461,166,201,75,334,6141,
20221007,190,193,동서울,일죽,2648,177,193,174,135,123,3450,2343,187,181,223,101,93,3128,
20221007,190,194,동서울,서이천,4428,619,335,279,201,280,6142,3344,446,254,232,129,205,4610,
20221007,190,198,동서울,서청주,1020,37,42,22,34,49,1204,1195,23,45,34,18,45,1360,
20221007,190,560,동서울,감곡,1160,15,26,35,94,22,1352,987,32,23,37,84,31,1194,
20221007,190,705,동서울,남이천,1681,95,78,135,124,50,2163,2761,128,61,147,86,97,3280,
20221007,191,190,경기광주,동서울,11028,738,460,340,343,766,13675,10963,710,483,358,276,749,13539,
20221007,192,190,곤지암,동서울,4904,461,166,201,75,334,6141,5798,490,233,192,95,363,7171,
20221007,192,194,곤지암,서이천,1406,272,125,211,120,118,2252,1246,207,100,177,111,95,1936,
20221007,193,190,일죽,동서울,2343,187,181,223,101,93,3128,2648,177,193,174,135,123,3450,
20221007,194,190,서이천,동서울,3344,446,254,232,129,205,4610,4428,619,335,279,201,280,6142,
20221007,194,192,서이천,곤지암,1246,207,100,177,111,95,1936,1406,272,125,211,120,118,2252,
20221007,196,198,진천,서청주,1259,42,86,42,32,80,1541,1386,44,76,30,33,73,1642,
20221007,198,113,서청주,신탄진,966,32,26,20,21,80,1145,814,30,22,46,35,53,1000,
20221007,198,115,서청주,대전,906,17,7,6,2,75,1013,912,23,1,4,2,75,1017,
20221007,198,190,서청주,동서울,1195,23,45,34,18,45,1360,1020,37,42,22,34,49,1204,
20221007,198,196,서청주,진천,1386,44,76,30,33,73,1642,1259,42,86,42,32,80,1541,
20221007,201,127,칠곡,서대구,892,16,25,7,8,58,1006,1455,26,28,9,8,90,1616,
20221007,201,203,칠곡,가산,924,32,38,38,145,60,1237,852,42,46,30,169,49,1188,
20221007,203,127,가산,서대구,2092,65,86,33,155,113,2544,2296,69,106,40,162,105,2778,
20221007,203,201,가산,칠곡,852,42,46,30,169,49,1188,924,32,38,38,145,60,1237,
20221007,203,775,가산,동명동호,1919,67,63,46,197,74,2366,1860,75,59,52,174,69,2289,
20221007,212,102,북수원,동수원,5135,46,247,48,26,279,5781,4471,43,232,42,47,252,5087,
20221007,212,103,북수원,수원신갈,1461,88,47,51,35,89,1771,889,46,26,27,13,68,1069,
20221007,212,172,북수원,용인,1261,64,25,17,15,77,1459,978,48,13,16,18,66,1139,
20221007,212,173,북수원,양지,1416,102,59,42,58,73,1750,1496,96,50,57,35,83,1817,
20221007,212,254,북수원,군자,1588,38,36,14,31,92,1799,968,27,24,18,21,53,1111,
20221007,213,102,부곡,동수원,1088,16,21,5,25,82,1237,1169,16,18,4,22,70,1299,
20221007,213,253,부곡,서서울,1493,73,37,28,201,101,1933,893,57,23,33,148,53,1207,
20221007,213,254,부곡,군자,898,33,28,46,455,57,1517,751,38,25,42,397,46,1299,
20221007,214,102,동군포,동수원,1859,25,24,11,8,121,2048,1706,30,21,9,7,105,1878,
20221007,215,102,군포,동수원,2259,16,36,6,2,169,2488,1535,22,26,7,6,109,1705,
20221007,215,253,군포,서서울,4083,115,71,37,64,283,4653,3661,172,131,166,104,249,4483,
20221007,215,254,군포,군자,2394,63,72,48,98,157,2832,2905,127,114,117,162,199,3624,
20221007,215,255,군포,서안산,1404,49,27,20,17,115,1632,1493,80,63,82,96,119,1933,
20221007,216,174,횡성,춘천,1236,45,36,17,19,69,1422,1181,45,29,27,28,66,1376,
20221007,218,174,남원주,춘천,1427,24,83,17,14,87,1652,1472,20,76,18,13,101,1700,
20221007,218,240,남원주,제천,2096,51,61,28,54,131,2421,2373,55,57,31,43,156,2715,
20221007,225,291,서진주,사천,1067,23,16,13,30,88,1237,1166,24,31,20,33,85,1359,
20221007,229,101,북천안,서울,950,49,47,60,20,45,1171,888,47,59,51,24,39,1108,
20221007,229,108,북천안,천안,3430,90,134,60,89,213,4016,3620,84,114,46,38,204,4106,
20221007,230,127,팔공산,서대구,1074,25,43,11,6,81,1240,1587,51,58,15,8,87,1806,
20221007,230,131,팔공산,경산,1512,87,55,28,32,83,1797,1349,85,43,24,21,85,1607,
20221007,230,524,팔공산,청통와촌,1281,59,35,6,29,64,1474,1090,49,31,8,14,56,1248,
20221007,230,527,팔공산,포항,1629,32,31,5,40,80,1817,1616,30,25,10,51,82,1814,
20221007,231,519,화원옥포,남대구,6623,172,123,58,160,518,7654,6467,174,132,52,96,492,7413,
20221007,232,519,달성,남대구,2878,119,150,45,33,193,3418,2972,131,157,51,32,187,3530,
20221007,233,519,현풍,남대구,5290,217,206,83,137,372,6305,4589,204,174,96,128,325,5516,
20221007,237,239,남지,칠원,1029,30,48,18,83,73,1281,967,28,41,16,103,70,1225,
20221007,238,239,칠서,칠원,1848,111,131,130,276,122,2618,1712,108,111,92,232,112,2367,
20221007,239,237,칠원,남지,967,28,41,16,103,70,1225,1029,30,48,18,83,73,1281,
20221007,239,238,칠원,칠서,1712,108,111,92,232,112,2367,1848,111,131,130,276,122,2618,
20221007,239,519,칠원,남대구,1492,47,99,31,89,62,1820,1473,64,92,43,59,55,1786,
20221007,240,218,제천,남원주,2373,55,57,31,43,156,2715,2096,51,61,28,54,131,2421,
20221007,241,519,동고령,남대구,3189,84,85,271,216,168,4013,3134,80,84,270,202,155,3925,
20221007,242,519,고령,남대구,1937,40,72,33,156,105,2343,1895,38,73,26,164,95,2291,
20221007,244,146,서부산,동창원,1386,34,42,21,67,87,1637,1274,26,32,21,40,69,1462,
20221007,244,147,서부산,진례,1902,117,83,71,138,107,2418,1765,108,72,64,107,109,2225,
20221007,244,245,서부산,장유,13694,282,418,135,390,1000,15919,13738,229,435,168,431,1036,16037,
20221007,244,289,서부산,마산,3467,57,276,57,67,177,4101,3726,75,271,55,90,166,4383,
20221007,245,146,장유,동창원,1028,16,10,5,4,95,1158,954,18,12,5,4,102,1095,
20221007,245,147,장유,진례,1473,60,104,77,28,144,1886,1090,59,100,92,20,104,1465,
20221007,245,149,장유,동김해,785,44,97,8,0,77,1011,856,47,100,15,10,81,1109,
20221007,245,150,장유,북부산,3464,43,88,6,42,246,3889,3854,46,102,9,39,263,4313,
20221007,245,244,장유,서부산,13738,229,435,168,431,1036,16037,13694,282,418,135,390,1000,15919,
20221007,245,289,장유,마산,1569,38,42,19,13,145,1826,1789,29,55,17,11,140,2041,
20221007,248,261,순창,동광주,1361,20,25,9,15,63,1493,1355,21,26,15,17,61,1495,
20221007,249,261,담양,동광주,2538,46,132,31,38,108,2893,1990,43,125,31,25,106,2320,
20221007,250,140,남양산,부산,8037,112,235,44,50,660,9138,8047,125,250,54,59,669,9204,
20221007,250,149,남양산,동김해,1035,18,52,6,6,77,1194,1193,26,57,6,7,83,1372,
20221007,250,252,남양산,대동,3567,147,128,97,106,227,4272,4282,169,137,96,148,315,5147,
20221007,251,140,물금,부산,1064,107,28,37,61,64,1361,1088,134,25,40,59,85,1431,
20221007,251,148,물금,서김해,1028,48,20,32,20,88,1236,992,42,24,28,10,87,1183,
20221007,251,149,물금,동김해,1095,40,8,14,7,114,1278,1107,51,15,8,6,105,1292,
20221007,251,252,물금,대동,3296,211,122,138,518,239,4524,3984,208,106,148,677,276,5399,
20221007,252,135,대동,경주,1462,49,92,66,132,73,1874,1072,36,94,47,173,47,1469,
20221007,252,138,대동,양산,3060,344,233,282,326,142,4387,2728,338,204,291,347,124,4032,
20221007,252,139,대동,서울산,1010,46,39,36,36,60,1227,883,47,50,35,47,52,1114,
20221007,252,140,대동,부산,1728,41,43,48,105,92,2057,1795,57,39,37,62,104,2094,
20221007,252,250,대동,남양산,4282,169,137,96,148,315,5147,3567,147,128,97,106,227,4272,
20221007,252,251,대동,물금,3984,208,106,148,677,276,5399,3296,211,122,138,518,239,4524,
20221007,252,641,대동,울산,1872,76,95,49,57,122,2271,1487,71,87,43,74,93,1855,
20221007,252,752,대동,기장철마,1921,73,65,44,124,144,2371,1986,77,58,48,71,159,2399,
20221007,252,753,대동,금정,1953,107,105,100,191,109,2565,1153,64,67,61,90,69,1504,
20221007,252,755,대동,광재,2388,106,78,117,374,134,3197,2411,105,89,117,503,135,3360,
20221007,252,756,대동,한림,846,50,39,26,114,55,1130,905,52,52,35,166,44,1254,
20221007,253,102,서서울,동수원,4865,69,58,30,12,309,5343,5636,67,66,20,16,335,6140,
20221007,253,103,서서울,수원신갈,2002,133,81,77,40,114,2447,1970,156,77,65,28,135,2431,
20221007,253,172,서서울,용인,1024,48,24,36,15,50,1197,1034,50,30,37,19,67,1237,
20221007,253,173,서서울,양지,998,129,62,97,40,58,1384,1363,151,81,125,56,71,1847,
20221007,253,213,서서울,부곡,893,57,23,33,148,53,1207,1493,73,37,28,201,101,1933,
20221007,253,215,서서울,군포,3661,172,131,166,104,249,4483,4083,115,71,37,64,283,4653,
20221007,253,255,서서울,서안산,15713,546,629,545,295,958,18686,15566,531,577,494,280,979,18427,
20221007,253,256,서서울,안산,9113,179,85,48,41,687,10153,6348,128,62,32,58,476,7104,
20221007,253,281,서서울,매송,3516,56,41,13,36,213,3875,5068,73,48,26,75,313,5603,
20221007,253,282,서서울,비봉,5564,282,244,154,460,322,7026,6442,319,263,169,512,387,8092,
20221007,253,283,서서울,발안,3384,158,152,143,177,182,4196,4250,230,191,193,185,259,5308,
20221007,253,285,서서울,서평택,1613,67,109,236,369,94,2488,1762,90,120,309,465,100,2846,
20221007,253,287,서서울,송악,2328,28,59,64,234,105,2818,2512,42,57,105,472,108,3296,
20221007,253,288,서서울,당진,1505,29,38,32,29,77,1710,1549,29,59,52,47,71,1807,
20221007,253,298,서서울,서산,3742,33,68,50,27,153,4073,2167,24,55,52,64,105,2467,
20221007,253,520,서서울,평택,2475,106,111,171,120,100,3083,2570,111,114,176,104,117,3192,
20221007,253,540,서서울,청북,790,49,60,100,63,44,1106,923,71,52,110,99,54,1309,
20221007,253,741,서서울,평택고덕,935,26,20,25,11,69,1086,1254,31,28,31,13,73,1430,
20221007,254,102,군자,동수원,4159,69,76,35,39,247,4625,3588,47,64,26,38,180,3943,
20221007,254,103,군자,수원신갈,1737,108,78,129,133,106,2291,1332,81,69,71,83,64,1700,
20221007,254,173,군자,양지,741,104,111,146,198,42,1342,899,130,94,189,199,34,1545,
20221007,254,212,군자,북수원,968,27,24,18,21,53,1111,1588,38,36,14,31,92,1799,
20221007,254,213,군자,부곡,751,38,25,42,397,46,1299,898,33,28,46,455,57,1517,
20221007,254,215,군자,군포,2905,127,114,117,162,199,3624,2394,63,72,48,98,157,2832,
20221007,254,255,군자,서안산,9963,412,216,217,279,732,11819,9506,398,197,224,261,634,11220,
20221007,254,256,군자,안산,4737,136,128,43,53,388,5485,4955,125,125,35,54,382,5676,
20221007,254,281,군자,매송,986,33,16,21,32,67,1155,1042,26,13,25,26,67,1199,
20221007,254,282,군자,비봉,1284,113,82,103,183,102,1867,1143,99,81,58,165,88,1634,
20221007,254,283,군자,발안,1098,97,62,58,149,75,1539,1103,83,62,50,124,80,1502,
20221007,255,102,서안산,동수원,1853,35,15,8,8,100,2019,1735,50,19,15,4,94,1917,
20221007,255,215,서안산,군포,1493,80,63,82,96,119,1933,1404,49,27,20,17,115,1632,
20221007,255,253,서안산,서서울,15566,531,577,494,280,979,18427,15713,546,629,545,295,958,18686,
20221007,255,254,서안산,군자,9506,398,197,224,261,634,11220,9963,412,216,217,279,732,11819,
20221007,256,253,안산,서서울,6348,128,62,32,58,476,7104,9113,179,85,48,41,687,10153,
20221007,256,254,안산,군자,4955,125,125,35,54,382,5676,4737,136,128,43,53,388,5485,
20221007,261,248,동광주,순창,1355,21,26,15,17,61,1495,1361,20,25,9,15,63,1493,
20221007,261,249,동광주,담양,1990,43,125,31,25,106,2320,2538,46,132,31,38,108,2893,
20221007,261,262,동광주,창평,1541,91,41,33,17,67,1790,1722,79,46,27,15,62,1951,
20221007,261,263,동광주,옥과,2876,32,128,24,80,126,3266,2704,23,125,15,79,121,3067,
20221007,261,265,동광주,곡성,1587,31,44,23,37,65,1787,1565,19,53,22,22,64,1745,
20221007,261,270,동광주,서순천,966,40,71,10,10,32,1129,986,22,51,10,9,23,1101,
20221007,261,271,동광주,순천,3476,88,111,31,116,114,3936,3693,99,109,28,136,106,4171,
20221007,262,261,창평,동광주,1722,79,46,27,15,62,1951,1541,91,41,33,17,67,1790,
20221007,263,261,옥과,동광주,2704,23,125,15,79,121,3067,2876,32,128,24,80,126,3266,
20221007,265,261,곡성,동광주,1565,19,53,22,22,64,1745,1587,31,44,23,37,65,1787,
20221007,267,271,주암송광사,순천,936,22,23,26,34,44,1085,925,18,17,14,43,47,1064,
20221007,270,261,서순천,동광주,986,22,51,10,9,23,1101,966,40,71,10,10,32,1129,
20221007,271,261,순천,동광주,3693,99,109,28,136,106,4171,3476,88,111,31,116,114,3936,
20221007,271,267,순천,주암송광사,925,18,17,14,43,47,1064,936,22,23,26,34,44,1085,
20221007,271,569,순천,북광주,1122,67,64,28,156,38,1475,949,58,59,28,114,24,1232,
20221007,280,519,거창,남대구,1084,18,42,6,8,51,1209,1044,27,46,6,10,52,1185,
20221007,281,253,매송,서서울,5068,73,48,26,75,313,5603,3516,56,41,13,36,213,3875,
20221007,281,254,매송,군자,1042,26,13,25,26,67,1199,986,33,16,21,32,67,1155,
20221007,282,253,비봉,서서울,6442,319,263,169,512,387,8092,5564,282,244,154,460,322,7026,
20221007,282,254,비봉,군자,1143,99,81,58,165,88,1634,1284,113,82,103,183,102,1867,
20221007,283,253,발안,서서울,4250,230,191,193,185,259,5308,3384,158,152,143,177,182,4196,
20221007,283,254,발안,군자,1103,83,62,50,124,80,1502,1098,97,62,58,149,75,1539,
20221007,285,253,서평택,서서울,1762,90,120,309,465,100,2846,1613,67,109,236,369,94,2488,
20221007,285,287,서평택,송악,708,28,100,105,614,37,1592,931,48,101,120,541,56,1797,
20221007,285,520,서평택,평택,674,38,59,78,99,57,1005,793,42,70,53,93,80,1131,
20221007,287,253,송악,서서울,2512,42,57,105,472,108,3296,2328,28,59,64,234,105,2818,
20221007,287,285,송악,서평택,931,48,101,120,541,56,1797,708,28,100,105,614,37,1592,
20221007,288,253,당진,서서울,1549,29,59,52,47,71,1807,1505,29,38,32,29,77,1710,
20221007,289,146,마산,동창원,2734,99,75,39,45,224,3216,2834,82,66,40,83,259,3364,
20221007,289,147,마산,진례,1398,108,94,75,68,94,1837,1373,105,66,57,79,76,1756,
20221007,289,148,마산,서김해,1724,40,64,15,10,111,1964,1536,42,59,10,11,101,1759,
20221007,289,149,마산,동김해,1129,43,51,11,9,72,1315,939,33,39,20,10,70,1111,
20221007,289,150,마산,북부산,3521,32,82,19,55,175,3884,2925,24,88,15,30,125,3207,
20221007,289,244,마산,서부산,3726,75,271,55,90,166,4383,3467,57,276,57,67,177,4101,
20221007,289,245,마산,장유,1789,29,55,17,11,140,2041,1569,38,42,19,13,145,1826,
20221007,289,757,마산,진영,808,53,52,50,96,51,1110,943,60,55,45,77,56,1236,
20221007,291,145,사천,산인,1866,68,67,22,14,88,2125,1510,47,75,15,18,80,1745,
20221007,291,225,사천,서진주,1166,24,31,20,33,85,1359,1067,23,16,13,30,88,1237,
20221007,291,292,사천,진주,3010,72,81,51,53,266,3533,3632,102,110,58,49,296,4247,
20221007,292,145,진주,산인,1788,26,155,20,17,97,2103,1522,30,158,11,15,68,1804,
20221007,292,291,진주,사천,3632,102,110,58,49,296,4247,3010,72,81,51,53,266,3533,
20221007,293,145,문산,산인,1375,25,27,16,13,78,1534,1401,31,21,9,4,96,1562,
20221007,298,253,서산,서서울,2167,24,55,52,64,105,2467,3742,33,68,50,27,153,4073,
20221007,508,509,무안,목포,1381,45,38,32,70,51,1617,1731,46,46,35,73,69,2000,
20221007,508,553,무안,동광산,1568,23,43,22,26,51,1733,2098,48,62,44,40,71,2363,
20221007,509,508,목포,무안,1731,46,46,35,73,69,2000,1381,45,38,32,70,51,1617,
20221007,509,553,목포,동광산,7935,197,223,167,461,273,9256,7158,169,233,184,487,264,8495,
20221007,513,515,고성,북통영,1602,45,71,15,21,109,1863,2015,41,79,14,22,145,2316,
20221007,513,516,고성,통영,3557,89,171,108,174,262,4361,3561,114,152,86,158,236,4307,
20221007,514,516,동고성,통영,1257,25,50,29,119,160,1640,1193,22,69,30,112,151,1577,
20221007,515,513,북통영,고성,2015,41,79,14,22,145,2316,1602,45,71,15,21,109,1863,
20221007,516,513,통영,고성,3561,114,152,86,158,236,4307,3557,89,171,108,174,262,4361,
20221007,516,514,통영,동고성,1193,22,69,30,112,151,1577,1257,25,50,29,119,160,1640,
20221007,517,597,양평,서여주,867,27,71,54,48,50,1117,912,21,34,49,34,37,1087,
20221007,517,598,양평,북여주,1209,32,19,33,87,48,1428,1097,29,21,17,46,49,1259,
20221007,518,127,칠곡물류,서대구,752,90,71,86,44,44,1087,900,118,84,99,47,49,1297,
20221007,519,231,남대구,화원옥포,6467,174,132,52,96,492,7413,6623,172,123,58,160,518,7654,
20221007,519,232,남대구,달성,2972,131,157,51,32,187,3530,2878,119,150,45,33,193,3418,
20221007,519,233,남대구,현풍,4589,204,174,96,128,325,5516,5290,217,206,83,137,372,6305,
20221007,519,239,남대구,칠원,1473,64,92,43,59,55,1786,1492,47,99,31,89,62,1820,
20221007,519,241,남대구,동고령,3134,80,84,270,202,155,3925,3189,84,85,271,216,168,4013,
20221007,519,242,남대구,고령,1895,38,73,26,164,95,2291,1937,40,72,33,156,105,2343,
20221007,519,280,남대구,거창,1044,27,46,6,10,52,1185,1084,18,42,6,8,51,1209,
20221007,519,730,남대구,유천,2588,63,17,0,6,179,2853,2884,62,16,0,0,217,3179,
20221007,519,731,남대구,북현풍,2104,24,36,1,0,133,2298,1690,25,8,0,0,102,1825,
20221007,520,253,평택,서서울,2570,111,114,176,104,117,3192,2475,106,111,171,120,100,3083,
20221007,520,285,평택,서평택,793,42,70,53,93,80,1131,674,38,59,78,99,57,1005,
20221007,520,540,평택,청북,1390,97,160,113,73,85,1918,891,88,143,129,101,58,1410,
20221007,520,741,평택,평택고덕,1173,17,233,15,14,99,1551,911,16,183,8,18,80,1216,
20221007,524,129,청통와촌,북대구,1141,63,34,22,36,53,1349,987,44,26,10,10,52,1129,
20221007,524,230,청통와촌,팔공산,1090,49,31,8,14,56,1248,1281,59,35,6,29,64,1474,
20221007,526,527,서포항,포항,875,19,16,5,26,80,1021,1064,18,19,3,12,80,1196,
20221007,527,127,포항,서대구,936,40,37,12,53,54,1132,1205,34,55,24,79,62,1459,
20221007,527,129,포항,북대구,2142,51,36,24,84,100,2437,1663,31,23,28,61,80,1886,
20221007,527,230,포항,팔공산,1616,30,25,10,51,82,1814,1629,32,31,5,40,80,1817,
20221007,527,526,포항,서포항,1064,18,19,3,12,80,1196,875,19,16,5,26,80,1021,
20221007,528,101,기흥동탄,서울,7379,67,1366,123,14,349,9298,6970,70,1219,130,12,338,8739,
20221007,528,103,기흥동탄,수원신갈,2079,21,159,4,10,136,2409,1568,16,194,2,2,88,1870,
20221007,528,106,기흥동탄,오산,1021,35,50,12,8,73,1199,991,38,49,20,10,80,1188,
20221007,528,107,기흥동탄,안성,1100,20,18,4,6,92,1240,1015,9,19,4,8,95,1150,
20221007,528,108,기흥동탄,천안,1173,19,123,1,11,77,1404,1119,15,107,3,13,68,1325,
20221007,540,253,청북,서서울,923,71,52,110,99,54,1309,790,49,60,100,63,44,1106,
20221007,540,520,청북,평택,891,88,143,129,101,58,1410,1390,97,160,113,73,85,1918,
20221007,540,741,청북,평택고덕,988,24,34,60,102,84,1292,1065,33,51,66,125,108,1448,
20221007,541,108,송탄,천안,872,49,27,13,15,81,1057,839,43,27,14,19,62,1004,
20221007,542,101,서안성,서울,1694,55,88,161,48,90,2136,1187,39,91,89,23,49,1478,
20221007,542,543,서안성,남안성,1162,49,100,129,122,91,1653,1279,47,81,129,97,101,1734,
20221007,543,101,남안성,서울,969,82,84,99,90,43,1367,1149,68,79,76,60,35,1467,
20221007,543,542,남안성,서안성,1279,47,81,129,97,101,1734,1162,49,100,129,122,91,1653,
20221007,543,555,남안성,북진천,985,128,173,186,146,54,1672,964,120,171,196,182,54,1687,
20221007,548,553,북무안,동광산,1418,35,28,24,113,36,1654,1873,24,32,26,145,55,2155,
20221007,549,553,동함평,동광산,3290,40,70,34,59,126,3619,3527,56,80,38,54,122,3877,
20221007,551,553,나주,동광산,1373,26,45,66,32,59,1601,1394,21,48,62,46,61,1632,
20221007,552,553,서광산,동광산,4786,208,185,209,179,189,5756,6309,232,237,238,188,266,7470,
20221007,553,508,동광산,무안,2098,48,62,44,40,71,2363,1568,23,43,22,26,51,1733,
20221007,553,509,동광산,목포,7158,169,233,184,487,264,8495,7935,197,223,167,461,273,9256,
20221007,553,548,동광산,북무안,1873,24,32,26,145,55,2155,1418,35,28,24,113,36,1654,
20221007,553,549,동광산,동함평,3527,56,80,38,54,122,3877,3290,40,70,34,59,126,3619,
20221007,553,551,동광산,나주,1394,21,48,62,46,61,1632,1373,26,45,66,32,59,1601,
20221007,553,552,동광산,서광산,6309,232,237,238,188,266,7470,4786,208,185,209,179,189,5756,
20221007,554,174,동홍천,춘천,1357,18,13,4,15,120,1527,1250,17,14,15,9,94,1399,
20221007,555,543,북진천,남안성,964,120,171,196,182,54,1687,985,128,173,186,146,54,1672,
20221007,560,190,감곡,동서울,987,32,23,37,84,31,1194,1160,15,26,35,94,22,1352,
20221007,567,167,남고창,광주,1495,28,48,12,41,52,1676,1433,29,47,6,42,63,1620,
20221007,569,271,북광주,순천,949,58,59,28,114,24,1232,1122,67,64,28,156,38,1475,
20221007,579,115,남세종,대전,1085,10,22,4,36,94,1251,1009,10,15,3,29,91,1157,
20221007,579,153,남세종,서대전,1031,22,24,5,7,93,1182,1336,16,20,5,12,105,1494,
20221007,587,589,오수,상관,1228,20,52,35,49,38,1422,1238,31,59,27,135,44,1534,
20221007,589,587,상관,오수,1238,31,59,27,135,44,1534,1228,20,52,35,49,38,1422,
20221007,597,517,서여주,양평,912,21,34,49,34,37,1087,867,27,71,54,48,50,1117,
20221007,597,598,서여주,북여주,918,50,139,42,48,41,1238,1101,44,98,48,53,55,1399,
20221007,598,517,북여주,양평,1097,29,21,17,46,49,1259,1209,32,19,33,87,48,1428,
20221007,598,597,북여주,서여주,1101,44,98,48,53,55,1399,918,50,139,42,48,41,1238,
20221007,621,127,동대구,서대구,1349,50,41,23,16,96,1575,1936,60,71,41,39,153,2300,
20221007,621,131,동대구,경산,2445,72,50,274,35,143,3019,2240,63,49,267,71,142,2832,
20221007,621,132,동대구,영천,1202,12,26,0,50,60,1350,1315,11,34,7,31,71,1469,
20221007,625,626,밀양,남밀양,1258,71,50,49,116,63,1607,1436,68,58,44,140,76,1822,
20221007,626,625,남밀양,밀양,1436,68,58,44,140,76,1822,1258,71,50,49,116,63,1607,
20221007,626,627,남밀양,삼랑진,1064,27,34,19,49,113,1306,1065,28,29,21,54,107,1304,
20221007,627,626,삼랑진,남밀양,1065,28,29,21,54,107,1304,1064,27,34,19,49,113,1306,
20221007,641,139,울산,서울산,1411,33,56,22,25,99,1646,1418,43,57,34,51,101,1704,
20221007,641,252,울산,대동,1487,71,87,43,74,93,1855,1872,76,95,49,57,122,2271,
20221007,641,643,울산,청량,1166,14,18,10,61,108,1377,1386,13,15,10,76,138,1638,
20221007,641,648,울산,해운대,995,5,16,0,1,70,1087,1063,13,18,2,6,64,1166,
20221007,641,706,울산,남경주,1271,11,29,7,20,57,1395,1270,8,34,15,20,65,1412,
20221007,641,707,울산,남포항,1252,13,18,17,103,69,1472,1359,23,23,27,101,78,1611,
20221007,643,641,청량,울산,1386,13,15,10,76,138,1638,1166,14,18,10,61,108,1377,
20221007,643,648,청량,해운대,3208,25,32,20,29,209,3523,3216,40,93,63,535,191,4138,
20221007,645,648,장안,해운대,1603,13,12,4,5,106,1743,2986,33,31,137,87,187,3461,
20221007,646,648,기장일광,해운대,4794,13,30,82,21,268,5208,5618,36,39,21,201,347,6262,
20221007,648,641,해운대,울산,1063,13,18,2,6,64,1166,995,5,16,0,1,70,1087,
20221007,648,643,해운대,청량,3216,40,93,63,535,191,4138,3208,25,32,20,29,209,3523,
20221007,648,645,해운대,장안,2986,33,31,137,87,187,3461,1603,13,12,4,5,106,1743,
20221007,648,646,해운대,기장일광,5618,36,39,21,201,347,6262,4794,13,30,82,21,268,5208,
20221007,648,707,해운대,남포항,815,14,38,20,175,42,1104,940,5,24,10,14,35,1028,
20221007,651,652,남양주,화도,15836,546,489,499,320,1134,18824,17138,573,564,533,303,1313,20424,
20221007,651,653,남양주,서종,2332,20,14,4,18,80,2468,1893,17,19,1,12,72,2014,
20221007,651,654,남양주,설악,5128,28,80,21,15,178,5450,3546,26,77,16,12,119,3796,
20221007,651,655,남양주,강촌,3469,27,133,30,28,129,3816,3125,39,129,32,33,124,3482,
20221007,651,656,남양주,남춘천,3549,36,69,36,40,115,3845,2376,21,26,15,33,73,2544,
20221007,652,651,화도,남양주,17138,573,564,533,303,1313,20424,15836,546,489,499,320,1134,18824,
20221007,652,653,화도,서종,1519,32,30,24,23,123,1751,1589,40,28,17,25,124,1823,
20221007,652,654,화도,설악,1669,22,23,49,6,88,1857,1294,18,13,49,12,104,1490,
20221007,653,651,서종,남양주,1893,17,19,1,12,72,2014,2332,20,14,4,18,80,2468,
20221007,653,652,서종,화도,1589,40,28,17,25,124,1823,1519,32,30,24,23,123,1751,
20221007,654,651,설악,남양주,3546,26,77,16,12,119,3796,5128,28,80,21,15,178,5450,
20221007,654,652,설악,화도,1294,18,13,49,12,104,1490,1669,22,23,49,6,88,1857,
20221007,655,651,강촌,남양주,3125,39,129,32,33,124,3482,3469,27,133,30,28,129,3816,
20221007,656,651,남춘천,남양주,2376,21,26,15,33,73,2544,3549,36,69,36,40,115,3845,
20221007,671,672,봉담,정남,3173,171,94,216,142,229,4025,4337,187,116,225,207,322,5394,
20221007,671,673,봉담,북오산,1989,82,50,18,16,160,2315,2200,66,54,31,25,173,2549,
20221007,671,675,봉담,서오산,949,25,13,10,7,59,1063,1041,23,10,10,11,86,1181,
20221007,671,676,봉담,향남,1469,115,55,54,35,112,1840,1369,93,45,42,50,108,1707,
20221007,671,677,봉담,북평택,10227,198,285,150,313,554,11727,9181,173,229,161,226,506,10476,
20221007,672,671,정남,봉담,4337,187,116,225,207,322,5394,3173,171,94,216,142,229,4025,
20221007,673,101,북오산,서울,1616,44,122,22,17,129,1950,1598,50,118,19,8,116,1909,
20221007,673,671,북오산,봉담,2200,66,54,31,25,173,2549,1989,82,50,18,16,160,2315,
20221007,673,677,북오산,북평택,2457,51,83,31,37,151,2810,1922,46,66,24,22,118,2198,
20221007,675,671,서오산,봉담,1041,23,10,10,11,86,1181,949,25,13,10,7,59,1063,
20221007,675,676,서오산,향남,3584,119,85,45,52,241,4126,3436,94,67,37,31,210,3875,
20221007,675,677,서오산,북평택,14107,275,441,179,222,849,16073,12450,254,365,173,168,767,14177,
20221007,675,876,서오산,양감,1927,73,42,37,227,126,2432,2409,69,42,32,186,163,2901,
20221007,676,671,향남,봉담,1369,93,45,42,50,108,1707,1469,115,55,54,35,112,1840,
20221007,676,675,향남,서오산,3436,94,67,37,31,210,3875,3584,119,85,45,52,241,4126,
20221007,676,677,향남,북평택,2057,188,188,190,161,119,2903,1560,159,144,179,124,95,2261,
20221007,677,101,북평택,서울,1661,69,287,107,121,68,2313,2116,64,295,84,98,91,2748,
20221007,677,671,북평택,봉담,9181,173,229,161,226,506,10476,10227,198,285,150,313,554,11727,
20221007,677,673,북평택,북오산,1922,46,66,24,22,118,2198,2457,51,83,31,37,151,2810,
20221007,677,675,북평택,서오산,12450,254,365,173,168,767,14177,14107,275,441,179,222,849,16073,
20221007,677,676,북평택,향남,1560,159,144,179,124,95,2261,2057,188,188,190,161,119,2903,
20221007,677,876,북평택,양감,2660,167,198,191,182,181,3579,2398,147,193,194,158,164,3254,
20221007,682,683,조암,송산마도,787,106,96,58,44,26,1117,989,113,107,53,62,60,1384,
20221007,682,684,조암,남안산,946,161,195,117,160,40,1619,1085,155,193,101,148,47,1729,
20221007,682,685,조암,서시흥,1757,186,164,177,279,99,2662,1859,173,165,186,308,111,2802,
20221007,683,682,송산마도,조암,989,113,107,53,62,60,1384,787,106,96,58,44,26,1117,
20221007,683,684,송산마도,남안산,2700,229,162,128,152,149,3520,2340,169,122,99,102,126,2958,
20221007,683,685,송산마도,서시흥,5757,324,212,207,797,329,7626,4956,278,226,206,789,291,6746,
20221007,684,682,남안산,조암,1085,155,193,101,148,47,1729,946,161,195,117,160,40,1619,
20221007,684,683,남안산,송산마도,2340,169,122,99,102,126,2958,2700,229,162,128,152,149,3520,
20221007,684,685,남안산,서시흥,5158,534,332,448,635,354,7461,5250,422,371,405,527,406,7381,
20221007,685,682,서시흥,조암,1859,173,165,186,308,111,2802,1757,186,164,177,279,99,2662,
20221007,685,683,서시흥,송산마도,4956,278,226,206,789,291,6746,5757,324,212,207,797,329,7626,
20221007,685,684,서시흥,남안산,5250,422,371,405,527,406,7381,5158,534,332,448,635,354,7461,
20221007,705,190,남이천,동서울,2761,128,61,147,86,97,3280,1681,95,78,135,124,50,2163,
20221007,706,641,남경주,울산,1270,8,34,15,20,65,1412,1271,11,29,7,20,57,1395,
20221007,706,707,남경주,남포항,1168,23,83,36,235,60,1605,1185,28,72,39,179,72,1575,
20221007,707,641,남포항,울산,1359,23,23,27,101,78,1611,1252,13,18,17,103,69,1472,
20221007,707,648,남포항,해운대,940,5,24,10,14,35,1028,815,14,38,20,175,42,1104,
20221007,707,706,남포항,남경주,1185,28,72,39,179,72,1575,1168,23,83,36,235,60,1605,
20221007,707,708,남포항,동경주,1404,27,37,22,280,87,1857,1503,31,34,33,322,90,2013,
20221007,708,707,동경주,남포항,1503,31,34,33,322,90,2013,1404,27,37,22,280,87,1857,
20221007,715,716,동안동,청송,1174,24,9,9,26,56,1298,1174,29,13,6,40,51,1313,
20221007,716,715,청송,동안동,1174,29,13,6,40,51,1313,1174,24,9,9,26,56,1298,
20221007,730,519,유천,남대구,2884,62,16,0,0,217,3179,2588,63,17,0,6,179,2853,
20221007,731,519,북현풍,남대구,1690,25,8,0,0,102,1825,2104,24,36,1,0,133,2298,
20221007,741,253,평택고덕,서서울,1254,31,28,31,13,73,1430,935,26,20,25,11,69,1086,
20221007,741,520,평택고덕,평택,911,16,183,8,18,80,1216,1173,17,233,15,14,99,1551,
20221007,741,540,평택고덕,청북,1065,33,51,66,125,108,1448,988,24,34,60,102,84,1292,
20221007,742,107,남사진위,안성,1593,35,51,31,11,123,1844,1417,51,51,25,6,121,1671,
20221007,742,108,남사진위,천안,1250,35,51,32,8,75,1451,1370,29,45,20,5,82,1551,
20221007,752,252,기장철마,대동,1986,77,58,48,71,159,2399,1921,73,65,44,124,144,2371,
20221007,753,252,금정,대동,1153,64,67,61,90,69,1504,1953,107,105,100,191,109,2565,
20221007,755,140,광재,부산,1016,27,13,22,25,72,1175,1100,30,22,15,25,58,1250,
20221007,755,252,광재,대동,2411,105,89,117,503,135,3360,2388,106,78,117,374,134,3197,
20221007,756,252,한림,대동,905,52,52,35,166,44,1254,846,50,39,26,114,55,1130,
20221007,757,289,진영,마산,943,60,55,45,77,56,1236,808,53,52,50,96,51,1110,
20221007,772,774,북달성,남칠곡,2601,55,62,34,37,149,2938,2681,47,56,38,22,153,2997,
20221007,773,774,북다사,남칠곡,1452,23,16,13,9,74,1587,1327,22,25,12,12,85,1483,
20221007,774,772,남칠곡,북달성,2681,47,56,38,22,153,2997,2601,55,62,34,37,149,2938,
20221007,774,773,남칠곡,북다사,1327,22,25,12,12,85,1483,1452,23,16,13,9,74,1587,
20221007,775,203,동명동호,가산,1860,75,59,52,174,69,2289,1919,67,63,46,197,74,2366,
20221007,776,777,연경,파군재,3645,38,38,17,32,245,4015,2557,50,39,18,30,177,2871,
20221007,776,779,연경,율암,6658,108,113,92,111,478,7560,6400,115,126,74,106,488,7309,
20221007,777,776,파군재,연경,2557,50,39,18,30,177,2871,3645,38,38,17,32,245,4015,
20221007,777,779,파군재,율암,2515,26,17,7,5,237,2807,2504,25,21,6,4,220,2780,
20221007,779,776,율암,연경,6400,115,126,74,106,488,7309,6658,108,113,92,111,478,7560,
20221007,779,777,율암,파군재,2504,25,21,6,4,220,2780,2515,26,17,7,5,237,2807,
20221007,876,675,양감,서오산,2409,69,42,32,186,163,2901,1927,73,42,37,227,126,2432,
20221007,876,677,양감,북평택,2398,147,193,194,158,164,3254,2660,167,198,191,182,181,3579,
20221007,981,982,서영암,강진무위사,2413,44,98,64,46,74,2739,2190,47,83,69,48,81,2518,
20221007,981,987,서영암,남순천,2445,38,83,70,376,87,3099,2105,43,82,101,389,72,2792,
20221007,982,981,강진무위사,서영암,2190,47,83,69,48,81,2518,2413,44,98,64,46,74,2739,
20221007,982,987,강진무위사,남순천,1080,16,35,20,110,37,1298,880,18,28,31,92,25,1074,
20221007,984,985,보성,벌교,1706,30,48,43,64,57,1948,1762,41,58,44,36,59,2000,
20221007,984,987,보성,남순천,2267,49,86,74,282,70,2828,2316,55,94,74,278,65,2882,
20221007,985,984,벌교,보성,1762,41,58,44,36,59,2000,1706,30,48,43,64,57,1948,
20221007,986,987,고흥,남순천,4155,62,118,150,237,164,4886,4714,78,140,141,237,191,5501,
20221007,987,981,남순천,서영암,2105,43,82,101,389,72,2792,2445,38,83,70,376,87,3099,
20221007,987,982,남순천,강진무위사,880,18,28,31,92,25,1074,1080,16,35,20,110,37,1298,
20221007,987,984,남순천,보성,2316,55,94,74,278,65,2882,2267,49,86,74,282,70,2828,
20221007,987,986,남순천,고흥,4714,78,140,141,237,191,5501,4155,62,118,150,237,164,4886,
20221008,101,102,서울,동수원,3708,30,201,11,8,179,4137,4293,29,293,26,14,208,4863,
20221008,101,103,서울,수원신갈,14117,367,971,280,94,619,16448,13754,423,973,261,89,603,16103,
20221008,101,105,서울,기흥,6094,56,133,48,20,223,6574,5061,68,192,85,22,227,5655,
20221008,101,106,서울,오산,4728,202,319,97,48,281,5675,5344,303,349,118,49,283,6446,
20221008,101,107,서울,안성,3473,47,265,23,8,154,3970,3601,36,262,38,19,192,4148,
20221008,101,108,서울,천안,6006,37,360,31,9,217,6660,5265,32,358,22,16,200,5893,
20221008,101,111,서울,청주,798,10,387,14,18,34,1261,986,9,323,15,24,38,1395,
20221008,101,171,서울,마성,3460,51,106,52,6,139,3814,3142,20,113,53,6,133,3467,
20221008,101,172,서울,용인,2272,57,60,27,18,132,2566,2882,94,65,43,23,174,3281,
20221008,101,173,서울,양지,2360,103,96,38,28,67,2692,4245,271,107,84,58,133,4898,
20221008,101,528,서울,기흥동탄,7118,45,540,108,15,307,8133,6675,39,537,100,10,255,7616,
20221008,101,542,서울,서안성,976,21,59,61,14,45,1176,2379,37,66,131,28,116,2757,
20221008,101,543,서울,남안성,966,48,35,40,20,48,1157,1153,76,54,57,24,56,1420,
20221008,101,673,서울,북오산,1656,20,95,19,3,92,1885,1607,31,93,15,2,80,1828,
20221008,101,677,서울,북평택,3581,35,133,42,51,147,3989,2324,25,143,45,95,112,2744,
20221008,102,101,동수원,서울,4293,29,293,26,14,208,4863,3708,30,201,11,8,179,4137,
20221008,102,212,동수원,북수원,3407,20,143,7,15,181,3773,3890,25,160,8,8,183,4274,
20221008,102,214,동수원,동군포,1711,25,7,7,2,96,1848,1478,20,6,3,0,75,1582,
20221008,102,215,동수원,군포,1169,11,10,3,5,74,1272,1836,15,7,6,3,99,1966,
20221008,102,253,동수원,서서울,5457,42,32,19,19,298,5867,5595,31,37,15,10,325,6013,
20221008,102,254,동수원,군자,4381,31,42,11,13,181,4659,5597,41,52,27,28,248,5993,
20221008,102,255,동수원,서안산,1310,26,9,6,2,70,1423,1534,34,12,8,6,84,1678,
20221008,103,101,수원신갈,서울,13754,423,973,261,89,603,16103,14117,367,971,280,94,619,16448,
20221008,103,105,수원신갈,기흥,2054,12,11,6,20,100,2203,2232,18,8,3,33,74,2368,
20221008,103,106,수원신갈,오산,894,36,24,13,5,58,1030,1182,49,38,11,8,74,1362,
20221008,103,108,수원신갈,천안,1027,3,29,1,0,36,1096,1010,9,32,2,1,40,1094,
20221008,103,253,수원신갈,서서울,2235,107,54,44,28,105,2573,2477,76,58,35,35,112,2793,
20221008,103,254,수원신갈,군자,1877,66,43,39,39,90,2154,2326,71,43,71,49,98,2658,
20221008,103,528,수원신갈,기흥동탄,1503,9,20,5,1,58,1596,1625,7,11,1,1,68,1713,
20221008,105,101,기흥,서울,5061,68,192,85,22,227,5655,6094,56,133,48,20,223,6574,
20221008,105,103,기흥,수원신갈,2232,18,8,3,33,74,2368,2054,12,11,6,20,100,2203,
20221008,106,101,오산,서울,5344,303,349,118,49,283,6446,4728,202,319,97,48,281,5675,
20221008,106,103,오산,수원신갈,1182,49,38,11,8,74,1362,894,36,24,13,5,58,1030,
20221008,106,107,오산,안성,1293,20,20,5,12,92,1442,918,15,9,5,11,77,1035,
20221008,107,101,안성,서울,3601,36,262,38,19,192,4148,3473,47,265,23,8,154,3970,
20221008,107,106,안성,오산,918,15,9,5,11,77,1035,1293,20,20,5,12,92,1442,
20221008,107,108,안성,천안,1678,10,26,4,6,107,1831,1875,23,28,2,8,100,2036,
20221008,107,742,안성,남사진위,1003,35,39,19,5,66,1167,1509,20,35,25,8,84,1681,
20221008,108,101,천안,서울,5265,32,358,22,16,200,5893,6006,37,360,31,9,217,6660,
20221008,108,103,천안,수원신갈,1010,9,32,2,1,40,1094,1027,3,29,1,0,36,1096,
20221008,108,107,천안,안성,1875,23,28,2,8,100,2036,1678,10,26,4,6,107,1831,
20221008,108,229,천안,북천안,2112,28,81,18,17,100,2356,1917,55,82,22,38,111,2225,
20221008,108,742,천안,남사진위,977,17,16,12,8,44,1074,2039,22,19,13,9,81,2183,
20221008,111,101,청주,서울,986,9,323,15,24,38,1395,798,10,387,14,18,34,1261,
20221008,112,115,남청주,대전,1416,59,57,14,19,89,1654,1205,64,40,5,7,80,1401,
20221008,114,153,남대전,서대전,1748,33,34,31,15,98,1959,1564,32,36,25,11,81,1749,
20221008,115,112,대전,남청주,1205,64,40,5,7,80,1401,1416,59,57,14,19,89,1654,
20221008,115,116,대전,옥천,2202,79,28,12,5,165,2491,2103,38,26,17,10,163,2357,
20221008,116,115,옥천,대전,2103,38,26,17,10,163,2357,2202,79,28,12,5,165,2491,
20221008,119,153,판암,서대전,2216,16,9,7,115,147,2510,2051,20,10,4,96,134,2315,
20221008,123,127,구미,서대구,2087,20,26,14,5,96,2248,2034,24,31,10,3,102,2204,
20221008,123,129,구미,북대구,2089,16,61,6,2,96,2270,2357,10,58,8,6,119,2558,
20221008,125,127,남구미,서대구,1990,23,42,29,15,126,2225,1919,32,53,17,16,117,2154,
20221008,125,129,남구미,북대구,1633,14,21,6,6,95,1775,1889,16,26,12,3,105,2051,
20221008,126,127,왜관,서대구,2295,73,45,33,40,140,2626,2385,87,52,20,28,126,2698,
20221008,126,129,왜관,북대구,2626,64,30,15,55,115,2905,3196,68,40,17,84,164,3569,
20221008,127,123,서대구,구미,2034,24,31,10,3,102,2204,2087,20,26,14,5,96,2248,
20221008,127,125,서대구,남구미,1919,32,53,17,16,117,2154,1990,23,42,29,15,126,2225,
20221008,127,126,서대구,왜관,2385,87,52,20,28,126,2698,2295,73,45,33,40,140,2626,
20221008,127,131,서대구,경산,2033,119,49,46,27,93,2367,1406,81,29,29,36,71,1652,
20221008,127,203,서대구,가산,2074,32,44,17,21,91,2279,2255,41,41,24,36,114,2511,
20221008,127,527,서대구,포항,2063,24,33,10,33,87,2250,1280,16,22,9,22,51,1400,
20221008,127,621,서대구,동대구,1427,38,60,18,32,88,1663,969,24,23,15,20,65,1116,
20221008,129,123,북대구,구미,2357,10,58,8,6,119,2558,2089,16,61,6,2,96,2270,
20221008,129,125,북대구,남구미,1889,16,26,12,3,105,2051,1633,14,21,6,6,95,1775,
20221008,129,126,북대구,왜관,3196,68,40,17,84,164,3569,2626,64,30,15,55,115,2905,
20221008,129,131,북대구,경산,1826,69,56,28,30,88,2097,2365,112,76,36,42,132,2763,
20221008,129,524,북대구,청통와촌,943,19,20,4,24,32,1042,1158,50,21,14,35,44,1322,
20221008,129,527,북대구,포항,2777,14,13,20,32,112,2968,3157,32,28,14,60,138,3429,
20221008,131,127,경산,서대구,1406,81,29,29,36,71,1652,2033,119,49,46,27,93,2367,
20221008,131,129,경산,북대구,2365,112,76,36,42,132,2763,1826,69,56,28,30,88,2097,
20221008,131,230,경산,팔공산,1018,41,25,7,11,73,1175,1179,38,34,15,16,74,1356,
20221008,131,621,경산,동대구,1836,37,25,5,40,102,2045,1796,42,25,12,17,92,1984,
20221008,132,621,영천,동대구,1169,7,21,3,33,43,1276,1359,11,23,2,30,52,1477,
20221008,135,140,경주,부산,2548,6,15,6,15,109,2699,2565,8,23,4,14,124,2738,
20221008,135,252,경주,대동,1871,8,64,17,54,86,2100,2340,12,66,10,30,81,2539,
20221008,135,621,경주,동대구,1250,8,46,0,1,40,1345,1274,4,34,1,0,56,1369,
20221008,137,140,통도사,부산,889,33,11,4,17,49,1003,1098,23,14,3,17,46,1201,
20221008,138,140,양산,부산,3902,172,96,40,61,192,4463,4266,197,102,34,54,209,4862,
20221008,138,252,양산,대동,1746,176,77,63,91,75,2228,1973,162,51,69,97,83,2435,
20221008,139,140,서울산,부산,2065,39,20,1,6,92,2223,2260,36,17,3,7,105,2428,
20221008,139,252,서울산,대동,1282,19,18,14,38,76,1447,1287,20,16,14,20,68,1425,
20221008,139,641,서울산,울산,1676,23,34,11,26,112,1882,1750,19,40,3,34,82,1928,
20221008,140,135,부산,경주,2565,8,23,4,14,124,2738,2548,6,15,6,15,109,2699,
20221008,140,137,부산,통도사,1098,23,14,3,17,46,1201,889,33,11,4,17,49,1003,
20221008,140,138,부산,양산,4266,197,102,34,54,209,4862,3902,172,96,40,61,192,4463,
20221008,140,139,부산,서울산,2260,36,17,3,7,105,2428,2065,39,20,1,6,92,2223,
20221008,140,250,부산,남양산,7989,109,175,19,19,536,8847,7838,96,158,16,19,533,8660,
20221008,140,251,부산,물금,869,107,17,22,29,39,1083,1047,85,13,28,28,48,1249,
20221008,140,252,부산,대동,1115,25,32,23,36,80,1311,1036,20,26,19,87,65,1253,
20221008,140,286,부산,통도사휴게소,1042,4,4,0,0,34,1084,1124,3,3,0,0,27,1157,
20221008,140,289,부산,마산,1692,7,12,4,5,52,1772,1404,14,9,3,4,54,1488,
20221008,140,755,부산,광재,1110,9,14,6,12,56,1207,941,9,9,5,17,54,1035,
20221008,142,145,군북,산인,4792,40,78,31,47,263,5251,5792,39,72,26,38,285,6252,
20221008,143,145,장지,산인,929,5,16,8,26,67,1051,927,7,12,11,26,62,1045,
20221008,144,145,함안,산인,2252,19,23,18,73,153,2538,2329,34,15,12,59,148,2597,
20221008,145,142,산인,군북,5792,39,72,26,38,285,6252,4792,40,78,31,47,263,5251,
20221008,145,143,산인,장지,927,7,12,11,26,62,1045,929,5,16,8,26,67,1051,
20221008,145,144,산인,함안,2329,34,15,12,59,148,2597,2252,19,23,18,73,153,2538,
20221008,145,272,산인,광양,2091,9,54,14,12,54,2234,1201,7,43,18,4,34,1307,
20221008,145,291,산인,사천,3059,27,49,12,22,114,3283,2331,44,45,13,17,94,2544,
20221008,145,292,산인,진주,1979,20,143,3,16,108,2269,2225,20,150,10,19,85,2509,
20221008,145,293,산인,문산,1741,18,20,10,9,73,1871,1601,23,16,5,11,81,1737,
20221008,145,295,산인,진성,1290,13,10,5,9,59,1386,1135,11,15,6,9,42,1218,
20221008,146,150,동창원,북부산,1215,8,11,5,8,67,1314,1907,6,8,5,13,82,2021,
20221008,146,244,동창원,서부산,1345,8,21,8,16,93,1491,2407,19,31,9,45,121,2632,
20221008,146,289,동창원,마산,2682,51,41,20,41,205,3040,2417,55,38,15,37,178,2740,
20221008,147,244,진례,서부산,1058,35,22,29,64,68,1276,1201,47,24,23,65,88,1448,
20221008,148,150,서김해,북부산,6421,74,70,40,62,462,7129,6536,67,54,35,35,449,7176,
20221008,148,251,서김해,물금,1004,33,14,18,12,66,1147,946,32,12,31,10,62,1093,
20221008,148,289,서김해,마산,1958,13,46,3,5,97,2122,1859,22,48,5,11,100,2045,
20221008,149,150,동김해,북부산,10762,142,131,32,60,760,11887,9222,123,114,26,27,608,10120,
20221008,149,250,동김해,남양산,1003,11,51,5,6,92,1168,904,11,41,7,3,69,1035,
20221008,149,251,동김해,물금,1076,39,11,10,1,107,1244,972,36,12,8,3,102,1133,
20221008,149,289,동김해,마산,1046,18,32,14,5,61,1176,1093,14,27,13,8,57,1212,
20221008,150,146,북부산,동창원,1907,6,8,5,13,82,2021,1215,8,11,5,8,67,1314,
20221008,150,148,북부산,서김해,6536,67,54,35,35,449,7176,6421,74,70,40,62,462,7129,
20221008,150,149,북부산,동김해,9222,123,114,26,27,608,10120,10762,142,131,32,60,760,11887,
20221008,150,245,북부산,장유,4282,35,69,15,23,252,4676,3726,33,81,4,12,228,4084,
20221008,150,289,북부산,마산,5155,22,109,6,12,187,5491,4986,23,98,13,28,204,5352,
20221008,152,154,유성,안영,1142,12,31,4,36,57,1282,1040,15,18,11,31,58,1173,
20221008,153,114,서대전,남대전,1564,32,36,25,11,81,1749,1748,33,34,31,15,98,1959,
20221008,153,119,서대전,판암,2051,20,10,4,96,134,2315,2216,16,9,7,115,147,2510,
20221008,153,154,서대전,안영,1305,19,22,17,76,70,1509,1220,32,26,14,71,60,1423,
20221008,154,152,안영,유성,1040,15,18,11,31,58,1173,1142,12,31,4,36,57,1282,
20221008,154,153,안영,서대전,1220,32,26,14,71,60,1423,1305,19,22,17,76,70,1509,
20221008,158,167,전주,광주,976,25,61,20,4,34,1120,1136,28,69,25,6,40,1304,
20221008,159,167,서전주,광주,2225,53,35,22,32,57,2424,2196,49,37,25,23,56,2386,
20221008,163,167,정읍,광주,996,21,36,12,10,30,1105,966,28,37,18,8,34,1091,
20221008,166,167,장성,광주,3003,58,65,16,53,105,3300,3925,83,68,21,26,145,4268,
20221008,167,158,광주,전주,1136,28,69,25,6,40,1304,976,25,61,20,4,34,1120,
20221008,167,159,광주,서전주,2196,49,37,25,23,56,2386,2225,53,35,22,32,57,2424,
20221008,167,163,광주,정읍,966,28,37,18,8,34,1091,996,21,36,12,10,30,1105,
20221008,167,166,광주,장성,3925,83,68,21,26,145,4268,3003,58,65,16,53,105,3300,
20221008,167,567,광주,남고창,1795,18,33,14,10,82,1952,1723,12,33,7,8,71,1854,
20221008,171,101,마성,서울,3142,20,113,53,6,133,3467,3460,51,106,52,6,139,3814,
20221008,171,253,마성,서서울,1302,6,12,3,2,72,1397,1216,13,8,4,4,70,1315,
20221008,172,101,용인,서울,2882,94,65,43,23,174,3281,2272,57,60,27,18,132,2566,
20221008,172,173,용인,양지,2025,84,53,42,74,95,2373,1305,87,55,60,110,93,1710,
20221008,173,101,양지,서울,4245,271,107,84,58,133,4898,2360,103,96,38,28,67,2692,
20221008,173,172,양지,용인,1305,87,55,60,110,93,1710,2025,84,53,42,74,95,2373,
20221008,174,179,춘천,홍천,3545,36,74,23,21,267,3966,3582,52,66,24,38,244,4006,
20221008,174,216,춘천,횡성,1424,41,19,11,20,62,1577,1123,34,16,11,13,74,1271,
20221008,174,218,춘천,남원주,1541,29,60,5,2,73,1710,1520,20,60,10,4,91,1705,
20221008,174,554,춘천,동홍천,1662,19,36,10,9,92,1828,1328,18,18,3,15,78,1460,
20221008,176,190,이천,동서울,1709,35,75,115,39,85,2058,1175,16,44,28,23,68,1354,
20221008,177,190,여주,동서울,1043,9,31,27,16,27,1153,1048,5,31,24,14,31,1153,
20221008,179,174,홍천,춘천,3582,52,66,24,38,244,4006,3545,36,74,23,21,267,3966,
20221008,184,189,대관령,강릉,1685,36,54,3,8,82,1868,1770,32,52,10,9,92,1965,
20221008,189,184,강릉,대관령,1770,32,52,10,9,92,1965,1685,36,54,3,8,82,1868,
20221008,189,583,강릉,동해,942,17,13,6,29,54,1061,1041,8,31,2,26,64,1172,
20221008,190,176,동서울,이천,1175,16,44,28,23,68,1354,1709,35,75,115,39,85,2058,
20221008,190,177,동서울,여주,1048,5,31,24,14,31,1153,1043,9,31,27,16,27,1153,
20221008,190,191,동서울,경기광주,8790,278,264,106,108,554,10100,8443,283,281,177,184,501,9869,
20221008,190,192,동서울,곤지암,3688,192,100,86,40,190,4296,4090,245,67,91,36,220,4749,
20221008,190,193,동서울,일죽,2891,51,92,50,58,108,3250,2825,72,114,115,47,109,3282,
20221008,190,194,동서울,서이천,4365,325,198,125,70,190,5273,3600,262,159,104,48,163,4336,
20221008,190,198,동서울,서청주,1063,11,15,22,12,41,1164,1489,10,21,14,10,59,1603,
20221008,190,199,동서울,오창,1122,9,12,8,22,44,1217,1092,4,7,7,12,55,1177,
20221008,190,560,동서울,감곡,1003,5,7,18,28,31,1092,960,13,12,15,36,27,1063,
20221008,190,705,동서울,남이천,1189,31,28,37,76,40,1401,1719,39,31,73,57,53,1972,
20221008,191,190,경기광주,동서울,8443,283,281,177,184,501,9869,8790,278,264,106,108,554,10100,
20221008,192,190,곤지암,동서울,4090,245,67,91,36,220,4749,3688,192,100,86,40,190,4296,
20221008,192,194,곤지암,서이천,2135,173,80,60,64,115,2627,1242,95,46,46,38,73,1540,
20221008,193,190,일죽,동서울,2825,72,114,115,47,109,3282,2891,51,92,50,58,108,3250,
20221008,194,190,서이천,동서울,3600,262,159,104,48,163,4336,4365,325,198,125,70,190,5273,
20221008,194,192,서이천,곤지암,1242,95,46,46,38,73,1540,2135,173,80,60,64,115,2627,
20221008,196,198,진천,서청주,972,20,54,13,12,45,1116,901,17,48,17,15,43,1041,
20221008,198,190,서청주,동서울,1489,10,21,14,10,59,1603,1063,11,15,22,12,41,1164,
20221008,198,196,서청주,진천,901,17,48,17,15,43,1041,972,20,54,13,12,45,1116,
20221008,199,190,오창,동서울,1092,4,7,7,12,55,1177,1122,9,12,8,22,44,1217,
20221008,203,127,가산,서대구,2255,41,41,24,36,114,2511,2074,32,44,17,21,91,2279,
20221008,203,775,가산,동명동호,2246,34,26,22,212,79,2619,1488,30,15,9,55,53,1650,
20221008,207,775,남안동,동명동호,1109,7,7,1,1,38,1163,1034,13,6,1,2,35,1091,
20221008,212,102,북수원,동수원,3890,25,160,8,8,183,4274,3407,20,143,7,15,181,3773,
20221008,212,253,북수원,서서울,2550,32,22,11,11,112,2738,1236,19,12,5,4,70,1346,
20221008,212,254,북수원,군자,2158,24,32,12,19,111,2356,1839,20,25,15,10,91,2000,
20221008,213,253,부곡,서서울,1239,68,34,19,47,71,1478,1180,57,28,24,40,73,1402,
20221008,213,254,부곡,군자,862,23,9,11,169,51,1125,1082,21,14,12,137,62,1328,
20221008,214,102,동군포,동수원,1478,20,6,3,0,75,1582,1711,25,7,7,2,96,1848,
20221008,215,102,군포,동수원,1836,15,7,6,3,99,1966,1169,11,10,3,5,74,1272,
20221008,215,253,군포,서서울,3676,36,50,24,43,214,4043,5117,90,88,70,88,284,5737,
20221008,215,254,군포,군자,2401,42,30,22,45,148,2688,3453,58,56,49,103,201,3920,
20221008,216,174,횡성,춘천,1123,34,16,11,13,74,1271,1424,41,19,11,20,62,1577,
20221008,218,174,남원주,춘천,1520,20,60,10,4,91,1705,1541,29,60,5,2,73,1710,
20221008,218,240,남원주,제천,2285,28,47,11,46,122,2539,2337,54,42,17,31,128,2609,
20221008,229,108,북천안,천안,1917,55,82,22,38,111,2225,2112,28,81,18,17,100,2356,
20221008,230,131,팔공산,경산,1179,38,34,15,16,74,1356,1018,41,25,7,11,73,1175,
20221008,230,524,팔공산,청통와촌,1210,25,27,9,13,59,1343,934,23,21,9,11,50,1048,
20221008,230,527,팔공산,포항,3015,21,18,9,23,116,3202,2396,21,17,2,40,90,2566,
20221008,231,519,화원옥포,남대구,5512,92,65,36,224,389,6318,5662,88,69,24,156,397,6396,
20221008,232,519,달성,남대구,2006,53,62,24,21,134,2300,2061,49,54,23,7,151,2345,
20221008,233,519,현풍,남대구,3943,93,100,41,91,251,4519,3687,66,81,45,87,247,4213,
20221008,237,239,남지,칠원,990,13,42,13,70,51,1179,1017,13,45,13,63,58,1209,
20221008,238,239,칠서,칠원,1200,40,57,113,290,71,1771,1263,37,52,89,176,85,1702,
20221008,239,237,칠원,남지,1017,13,45,13,63,58,1209,990,13,42,13,70,51,1179,
20221008,239,238,칠원,칠서,1263,37,52,89,176,85,1702,1200,40,57,113,290,71,1771,
20221008,239,519,칠원,남대구,2359,22,80,18,43,106,2628,2850,22,75,35,21,101,3104,
20221008,240,218,제천,남원주,2337,54,42,17,31,128,2609,2285,28,47,11,46,122,2539,
20221008,241,519,동고령,남대구,3127,46,70,31,56,170,3500,3510,52,55,23,51,163,3854,
20221008,242,519,고령,남대구,2646,16,42,11,115,133,2963,3279,13,39,13,106,131,3581,
20221008,244,146,서부산,동창원,2407,19,31,9,45,121,2632,1345,8,21,8,16,93,1491,
20221008,244,147,서부산,진례,1201,47,24,23,65,88,1448,1058,35,22,29,64,68,1276,
20221008,244,245,서부산,장유,14694,109,275,65,106,928,16177,13947,109,283,57,148,941,15485,
20221008,244,289,서부산,마산,5973,29,303,16,39,238,6598,5093,39,306,17,32,222,5709,
20221008,245,150,장유,북부산,3726,33,81,4,12,228,4084,4282,35,69,15,23,252,4676,
20221008,245,244,장유,서부산,13947,109,283,57,148,941,15485,14694,109,275,65,106,928,16177,
20221008,245,289,장유,마산,1853,14,36,9,9,105,2026,1893,16,39,26,10,118,2102,
20221008,248,261,순창,동광주,1925,18,18,1,25,66,2053,1939,15,29,2,20,74,2079,
20221008,249,261,담양,동광주,2998,21,98,10,30,106,3263,2767,23,100,11,28,101,3030,
20221008,250,140,남양산,부산,7838,96,158,16,19,533,8660,7989,109,175,19,19,536,8847,
20221008,250,149,남양산,동김해,904,11,41,7,3,69,1035,1003,11,51,5,6,92,1168,
20221008,250,252,남양산,대동,2867,93,56,30,58,191,3295,3568,91,78,58,71,239,4105,
20221008,251,140,물금,부산,1047,85,13,28,28,48,1249,869,107,17,22,29,39,1083,
20221008,251,148,물금,서김해,946,32,12,31,10,62,1093,1004,33,14,18,12,66,1147,
20221008,251,149,물금,동김해,972,36,12,8,3,102,1133,1076,39,11,10,1,107,1244,
20221008,251,252,물금,대동,2690,150,48,65,301,196,3450,3475,160,48,44,313,246,4286,
20221008,252,135,대동,경주,2340,12,66,10,30,81,2539,1871,8,64,17,54,86,2100,
20221008,252,138,대동,양산,1973,162,51,69,97,83,2435,1746,176,77,63,91,75,2228,
20221008,252,139,대동,서울산,1287,20,16,14,20,68,1425,1282,19,18,14,38,76,1447,
20221008,252,140,대동,부산,1036,20,26,19,87,65,1253,1115,25,32,23,36,80,1311,
20221008,252,250,대동,남양산,3568,91,78,58,71,239,4105,2867,93,56,30,58,191,3295,
20221008,252,251,대동,물금,3475,160,48,44,313,246,4286,2690,150,48,65,301,196,3450,
20221008,252,641,대동,울산,2005,32,54,6,29,111,2237,2102,31,50,19,25,110,2337,
20221008,252,752,대동,기장철마,1625,21,24,17,48,112,1847,1939,24,22,8,40,125,2158,
20221008,252,753,대동,금정,1610,37,46,32,129,85,1939,903,25,17,23,66,48,1082,
20221008,252,755,대동,광재,1867,26,37,27,143,118,2218,1750,30,33,30,173,98,2114,
20221008,253,102,서서울,동수원,5595,31,37,15,10,325,6013,5457,42,32,19,19,298,5867,
20221008,253,103,서서울,수원신갈,2477,76,58,35,35,112,2793,2235,107,54,44,28,105,2573,
20221008,253,171,서서울,마성,1216,13,8,4,4,70,1315,1302,6,12,3,2,72,1397,
20221008,253,212,서서울,북수원,1236,19,12,5,4,70,1346,2550,32,22,11,11,112,2738,
20221008,253,213,서서울,부곡,1180,57,28,24,40,73,1402,1239,68,34,19,47,71,1478,
20221008,253,215,서서울,군포,5117,90,88,70,88,284,5737,3676,36,50,24,43,214,4043,
20221008,253,255,서서울,서안산,11414,217,131,158,213,688,12821,11425,221,112,108,207,689,12762,
20221008,253,256,서서울,안산,9444,103,52,37,38,609,10283,6382,81,46,17,47,405,6978,
20221008,253,257,서서울,홍성,1607,9,6,6,2,47,1677,1078,4,8,6,1,41,1138,
20221008,253,259,서서울,대천,1431,4,15,5,0,56,1511,964,3,8,4,2,31,1012,
20221008,253,281,서서울,매송,3901,36,27,11,32,209,4216,4794,44,25,17,60,253,5193,
20221008,253,282,서서울,비봉,5207,96,88,60,372,253,6076,5128,125,99,88,439,293,6172,
20221008,253,283,서서울,발안,5424,62,37,51,131,252,5957,4140,101,46,68,152,242,4749,
20221008,253,285,서서울,서평택,1453,11,29,46,91,75,1705,1334,20,33,75,168,81,1711,
20221008,253,287,서서울,송악,1972,17,14,26,93,88,2210,3048,24,27,48,223,132,3502,
20221008,253,288,서서울,당진,1438,5,22,12,17,66,1560,1981,9,33,19,36,86,2164,
20221008,253,298,서서울,서산,3627,21,32,21,8,139,3848,3500,17,32,18,26,145,3738,
20221008,253,520,서서울,평택,3159,25,40,55,57,117,3453,2923,30,41,58,44,117,3213,
20221008,253,540,서서울,청북,1536,16,15,32,29,58,1686,871,32,23,49,53,53,1081,
20221008,253,741,서서울,평택고덕,1231,12,7,8,5,76,1339,1640,18,10,14,8,117,1807,
20221008,254,102,군자,동수원,5597,41,52,27,28,248,5993,4381,31,42,11,13,181,4659,
20221008,254,103,군자,수원신갈,2326,71,43,71,49,98,2658,1877,66,43,39,39,90,2154,
20221008,254,212,군자,북수원,1839,20,25,15,10,91,2000,2158,24,32,12,19,111,2356,
20221008,254,213,군자,부곡,1082,21,14,12,137,62,1328,862,23,9,11,169,51,1125,
20221008,254,215,군자,군포,3453,58,56,49,103,201,3920,2401,42,30,22,45,148,2688,
20221008,254,255,군자,서안산,9768,204,138,121,178,544,10953,7422,202,99,109,187,445,8464,
20221008,254,256,군자,안산,5113,93,118,32,53,328,5737,5419,88,113,35,41,383,6079,
20221008,254,281,군자,매송,1238,13,9,9,19,66,1354,1248,14,5,8,18,78,1371,
20221008,254,282,군자,비봉,1271,42,32,31,101,76,1553,972,44,23,24,91,61,1215,
20221008,254,283,군자,발안,2019,18,31,31,76,112,2287,1149,20,31,23,42,55,1320,
20221008,255,102,서안산,동수원,1534,34,12,8,6,84,1678,1310,26,9,6,2,70,1423,
20221008,255,253,서안산,서서울,11425,221,112,108,207,689,12762,11414,217,131,158,213,688,12821,
20221008,255,254,서안산,군자,7422,202,99,109,187,445,8464,9768,204,138,121,178,544,10953,
20221008,256,253,안산,서서울,6382,81,46,17,47,405,6978,9444,103,52,37,38,609,10283,
20221008,256,254,안산,군자,5419,88,113,35,41,383,6079,5113,93,118,32,53,328,5737,
20221008,257,253,홍성,서서울,1078,4,8,6,1,41,1138,1607,9,6,6,2,47,1677,
20221008,259,253,대천,서서울,964,3,8,4,2,31,1012,1431,4,15,5,0,56,1511,
20221008,261,248,동광주,순창,1939,15,29,2,20,74,2079,1925,18,18,1,25,66,2053,
20221008,261,249,동광주,담양,2767,23,100,11,28,101,3030,2998,21,98,10,30,106,3263,
20221008,261,262,동광주,창평,1925,64,26,17,22,60,2114,1899,56,31,28,32,61,2107,
20221008,261,263,동광주,옥과,3051,14,90,12,16,125,3308,2591,15,84,8,16,118,2832,
20221008,261,265,동광주,곡성,2112,17,33,14,25,70,2271,1656,13,34,8,19,63,1793,
20221008,261,270,동광주,서순천,1333,17,55,3,4,38,1450,1332,18,57,10,9,29,1455,
20221008,261,271,동광주,순천,5236,58,90,18,46,153,5601,4873,69,80,18,52,156,5248,
20221008,262,261,창평,동광주,1899,56,31,28,32,61,2107,1925,64,26,17,22,60,2114,
20221008,263,261,옥과,동광주,2591,15,84,8,16,118,2832,3051,14,90,12,16,125,3308,
20221008,265,261,곡성,동광주,1656,13,34,8,19,63,1793,2112,17,33,14,25,70,2271,
20221008,270,261,서순천,동광주,1332,18,57,10,9,29,1455,1333,17,55,3,4,38,1450,
20221008,271,261,순천,동광주,4873,69,80,18,52,156,5248,5236,58,90,18,46,153,5601,
20221008,271,569,순천,북광주,1213,45,20,11,70,28,1387,1342,41,20,23,29,30,1485,
20221008,272,145,광양,산인,1201,7,43,18,4,34,1307,2091,9,54,14,12,54,2234,
20221008,280,519,거창,남대구,1689,10,41,5,7,79,1831,1979,15,39,5,9,107,2154,
20221008,281,253,매송,서서울,4794,44,25,17,60,253,5193,3901,36,27,11,32,209,4216,
20221008,281,254,매송,군자,1248,14,5,8,18,78,1371,1238,13,9,9,19,66,1354,
20221008,282,253,비봉,서서울,5128,125,99,88,439,293,6172,5207,96,88,60,372,253,6076,
20221008,282,254,비봉,군자,972,44,23,24,91,61,1215,1271,42,32,31,101,76,1553,
20221008,283,253,발안,서서울,4140,101,46,68,152,242,4749,5424,62,37,51,131,252,5957,
20221008,283,254,발안,군자,1149,20,31,23,42,55,1320,2019,18,31,31,76,112,2287,
20221008,285,253,서평택,서서울,1334,20,33,75,168,81,1711,1453,11,29,46,91,75,1705,
20221008,286,140,통도사휴게소,부산,1124,3,3,0,0,27,1157,1042,4,4,0,0,34,1084,
20221008,287,253,송악,서서울,3048,24,27,48,223,132,3502,1972,17,14,26,93,88,2210,
20221008,288,253,당진,서서울,1981,9,33,19,36,86,2164,1438,5,22,12,17,66,1560,
20221008,289,140,마산,부산,1404,14,9,3,4,54,1488,1692,7,12,4,5,52,1772,
20221008,289,146,마산,동창원,2417,55,38,15,37,178,2740,2682,51,41,20,41,205,3040,
20221008,289,148,마산,서김해,1859,22,48,5,11,100,2045,1958,13,46,3,5,97,2122,
20221008,289,149,마산,동김해,1093,14,27,13,8,57,1212,1046,18,32,14,5,61,1176,
20221008,289,150,마산,북부산,4986,23,98,13,28,204,5352,5155,22,109,6,12,187,5491,
20221008,289,244,마산,서부산,5093,39,306,17,32,222,5709,5973,29,303,16,39,238,6598,
20221008,289,245,마산,장유,1893,16,39,26,10,118,2102,1853,14,36,9,9,105,2026,
20221008,291,145,사천,산인,2331,44,45,13,17,94,2544,3059,27,49,12,22,114,3283,
20221008,291,292,사천,진주,2132,51,52,35,22,162,2454,2858,66,65,54,36,209,3288,
20221008,292,145,진주,산인,2225,20,150,10,19,85,2509,1979,20,143,3,16,108,2269,
20221008,292,291,진주,사천,2858,66,65,54,36,209,3288,2132,51,52,35,22,162,2454,
20221008,292,516,진주,통영,1026,8,27,5,4,51,1121,948,20,22,4,6,83,1083,
20221008,293,145,문산,산인,1601,23,16,5,11,81,1737,1741,18,20,10,9,73,1871,
20221008,295,145,진성,산인,1135,11,15,6,9,42,1218,1290,13,10,5,9,59,1386,
20221008,298,253,서산,서서울,3500,17,32,18,26,145,3738,3627,21,32,21,8,139,3848,
20221008,508,509,무안,목포,971,26,27,18,29,43,1114,1397,29,30,12,43,51,1562,
20221008,508,553,무안,동광산,1598,16,27,16,14,58,1729,2671,27,30,13,32,91,2864,
20221008,509,508,목포,무안,1397,29,30,12,43,51,1562,971,26,27,18,29,43,1114,
20221008,509,553,목포,동광산,10943,154,205,72,206,357,11937,10018,138,189,121,189,315,10970,
20221008,513,515,고성,북통영,2656,24,63,11,19,162,2935,2550,18,71,8,15,156,2818,
20221008,513,516,고성,통영,6127,47,84,34,78,327,6697,4925,54,76,33,77,323,5488,
20221008,514,516,동고성,통영,1283,14,22,19,31,120,1489,1254,7,30,23,38,130,1482,
20221008,515,513,북통영,고성,2550,18,71,8,15,156,2818,2656,24,63,11,19,162,2935,
20221008,516,292,통영,진주,948,20,22,4,6,83,1083,1026,8,27,5,4,51,1121,
20221008,516,513,통영,고성,4925,54,76,33,77,323,5488,6127,47,84,34,78,327,6697,
20221008,516,514,통영,동고성,1254,7,30,23,38,130,1482,1283,14,22,19,31,120,1489,
20221008,517,597,양평,서여주,922,15,25,32,13,49,1056,1095,24,28,25,15,56,1243,
20221008,517,598,양평,북여주,3423,18,12,17,32,107,3609,2199,17,8,14,18,62,2318,
20221008,519,231,남대구,화원옥포,5662,88,69,24,156,397,6396,5512,92,65,36,224,389,6318,
20221008,519,232,남대구,달성,2061,49,54,23,7,151,2345,2006,53,62,24,21,134,2300,
20221008,519,233,남대구,현풍,3687,66,81,45,87,247,4213,3943,93,100,41,91,251,4519,
20221008,519,239,남대구,칠원,2850,22,75,35,21,101,3104,2359,22,80,18,43,106,2628,
20221008,519,241,남대구,동고령,3510,52,55,23,51,163,3854,3127,46,70,31,56,170,3500,
20221008,519,242,남대구,고령,3279,13,39,13,106,131,3581,2646,16,42,11,115,133,2963,
20221008,519,280,남대구,거창,1979,15,39,5,9,107,2154,1689,10,41,5,7,79,1831,
20221008,519,730,남대구,유천,2213,19,9,1,8,122,2372,2527,30,4,0,0,165,2726,
20221008,519,731,남대구,북현풍,1638,16,16,0,0,92,1762,1514,11,2,0,0,90,1617,
20221008,520,253,평택,서서울,2923,30,41,58,44,117,3213,3159,25,40,55,57,117,3453,
20221008,520,540,평택,청북,1667,30,70,34,31,68,1900,2062,28,63,83,42,61,2339,
20221008,520,741,평택,평택고덕,1145,12,47,7,6,69,1286,1008,15,63,8,9,78,1181,
20221008,524,129,청통와촌,북대구,1158,50,21,14,35,44,1322,943,19,20,4,24,32,1042,
20221008,524,230,청통와촌,팔공산,934,23,21,9,11,50,1048,1210,25,27,9,13,59,1343,
20221008,524,527,청통와촌,포항,1147,37,19,5,31,46,1285,1059,24,12,9,33,45,1182,
20221008,526,527,서포항,포항,1096,3,13,2,16,62,1192,1625,8,11,1,6,84,1735,
20221008,527,127,포항,서대구,1280,16,22,9,22,51,1400,2063,24,33,10,33,87,2250,
20221008,527,129,포항,북대구,3157,32,28,14,60,138,3429,2777,14,13,20,32,112,2968,
20221008,527,230,포항,팔공산,2396,21,17,2,40,90,2566,3015,21,18,9,23,116,3202,
20221008,527,524,포항,청통와촌,1059,24,12,9,33,45,1182,1147,37,19,5,31,46,1285,
20221008,527,526,포항,서포항,1625,8,11,1,6,84,1735,1096,3,13,2,16,62,1192,
20221008,527,621,포항,동대구,905,12,62,4,6,29,1018,1199,9,62,1,1,39,1311,
20221008,528,101,기흥동탄,서울,6675,39,537,100,10,255,7616,7118,45,540,108,15,307,8133,
20221008,528,103,기흥동탄,수원신갈,1625,7,11,1,1,68,1713,1503,9,20,5,1,58,1596,
20221008,540,253,청북,서서울,871,32,23,49,53,53,1081,1536,16,15,32,29,58,1686,
20221008,540,520,청북,평택,2062,28,63,83,42,61,2339,1667,30,70,34,31,68,1900,
20221008,540,741,청북,평택고덕,883,20,21,32,84,68,1108,1010,15,23,32,91,71,1242,
20221008,542,101,서안성,서울,2379,37,66,131,28,116,2757,976,21,59,61,14,45,1176,
20221008,542,543,서안성,남안성,1053,17,42,59,71,65,1307,931,22,42,75,69,64,1203,
20221008,543,101,남안성,서울,1153,76,54,57,24,56,1420,966,48,35,40,20,48,1157,
20221008,543,542,남안성,서안성,931,22,42,75,69,64,1203,1053,17,42,59,71,65,1307,
20221008,548,553,북무안,동광산,2219,20,22,13,37,51,2362,3807,24,30,25,39,86,4011,
20221008,549,553,동함평,동광산,3503,20,43,12,44,114,3736,3756,30,47,10,41,126,4010,
20221008,551,553,나주,동광산,1187,4,13,10,31,46,1291,1367,8,12,10,25,47,1469,
20221008,552,553,서광산,동광산,4166,117,114,111,201,139,4848,6432,142,134,128,160,173,7169,
20221008,553,508,동광산,무안,2671,27,30,13,32,91,2864,1598,16,27,16,14,58,1729,
20221008,553,509,동광산,목포,10018,138,189,121,189,315,10970,10943,154,205,72,206,357,11937,
20221008,553,548,동광산,북무안,3807,24,30,25,39,86,4011,2219,20,22,13,37,51,2362,
20221008,553,549,동광산,동함평,3756,30,47,10,41,126,4010,3503,20,43,12,44,114,3736,
20221008,553,551,동광산,나주,1367,8,12,10,25,47,1469,1187,4,13,10,31,46,1291,
20221008,553,552,동광산,서광산,6432,142,134,128,160,173,7169,4166,117,114,111,201,139,4848,
20221008,554,174,동홍천,춘천,1328,18,18,3,15,78,1460,1662,19,36,10,9,92,1828,
20221008,556,557,동순천,황전,1381,15,13,8,20,50,1487,1126,11,14,6,15,36,1208,
20221008,556,589,동순천,상관,907,4,16,5,136,14,1082,1266,3,16,14,65,32,1396,
20221008,557,556,황전,동순천,1126,11,14,6,15,36,1208,1381,15,13,8,20,50,1487,
20221008,560,190,감곡,동서울,960,13,12,15,36,27,1063,1003,5,7,18,28,31,1092,
20221008,567,167,남고창,광주,1723,12,33,7,8,71,1854,1795,18,33,14,10,82,1952,
20221008,569,271,북광주,순천,1342,41,20,23,29,30,1485,1213,45,20,11,70,28,1387,
20221008,573,578,예산수덕사,서세종,1102,13,12,11,12,35,1185,1588,10,13,12,6,53,1682,
20221008,578,573,서세종,예산수덕사,1588,10,13,12,6,53,1682,1102,13,12,11,12,35,1185,
20221008,583,189,동해,강릉,1041,8,31,2,26,64,1172,942,17,13,6,29,54,1061,
20221008,583,584,동해,남강릉,1091,25,11,4,32,50,1213,1007,20,15,7,31,63,1143,
20221008,583,704,동해,근덕,1126,6,28,6,65,56,1287,1166,10,39,3,38,66,1322,
20221008,584,583,남강릉,동해,1007,20,15,7,31,63,1143,1091,25,11,4,32,50,1213,
20221008,587,589,오수,상관,1268,9,46,20,50,31,1424,1580,18,34,15,117,46,1810,
20221008,589,556,상관,동순천,1266,3,16,14,65,32,1396,907,4,16,5,136,14,1082,
20221008,589,587,상관,오수,1580,18,34,15,117,46,1810,1268,9,46,20,50,31,1424,
20221008,597,517,서여주,양평,1095,24,28,25,15,56,1243,922,15,25,32,13,49,1056,
20221008,597,598,서여주,북여주,1111,46,110,24,26,49,1366,858,17,38,16,20,54,1003,
20221008,598,517,북여주,양평,2199,17,8,14,18,62,2318,3423,18,12,17,32,107,3609,
20221008,598,597,북여주,서여주,858,17,38,16,20,54,1003,1111,46,110,24,26,49,1366,
20221008,621,127,동대구,서대구,969,24,23,15,20,65,1116,1427,38,60,18,32,88,1663,
20221008,621,131,동대구,경산,1796,42,25,12,17,92,1984,1836,37,25,5,40,102,2045,
20221008,621,132,동대구,영천,1359,11,23,2,30,52,1477,1169,7,21,3,33,43,1276,
20221008,621,135,동대구,경주,1274,4,34,1,0,56,1369,1250,8,46,0,1,40,1345,
20221008,621,527,동대구,포항,1199,9,62,1,1,39,1311,905,12,62,4,6,29,1018,
20221008,624,626,청도,남밀양,1083,16,16,12,19,48,1194,1035,19,17,14,18,47,1150,
20221008,625,626,밀양,남밀양,1894,40,35,21,39,82,2111,2392,32,29,26,48,95,2622,
20221008,626,624,남밀양,청도,1035,19,17,14,18,47,1150,1083,16,16,12,19,48,1194,
20221008,626,625,남밀양,밀양,2392,32,29,26,48,95,2622,1894,40,35,21,39,82,2111,
20221008,626,627,남밀양,삼랑진,1025,20,18,8,16,102,1189,1144,19,18,6,29,100,1316,
20221008,627,626,삼랑진,남밀양,1144,19,18,6,29,100,1316,1025,20,18,8,16,102,1189,
20221008,641,139,울산,서울산,1750,19,40,3,34,82,1928,1676,23,34,11,26,112,1882,
20221008,641,252,울산,대동,2102,31,50,19,25,110,2337,2005,32,54,6,29,111,2237,
20221008,641,648,울산,해운대,1327,2,0,0,2,70,1401,1625,5,7,1,1,83,1722,
20221008,641,706,울산,남경주,1564,7,16,8,20,66,1681,1637,2,9,11,18,73,1750,
20221008,641,707,울산,남포항,2180,14,24,16,107,108,2449,1914,12,23,18,77,93,2137,
20221008,643,648,청량,해운대,3895,11,14,7,27,224,4178,4208,13,63,28,256,223,4791,
20221008,645,648,장안,해운대,1487,4,2,2,1,73,1569,3196,13,8,12,50,150,3429,
20221008,646,648,기장일광,해운대,4838,10,18,3,3,278,5150,6002,29,23,10,84,303,6451,
20221008,648,641,해운대,울산,1625,5,7,1,1,83,1722,1327,2,0,0,2,70,1401,
20221008,648,643,해운대,청량,4208,13,63,28,256,223,4791,3895,11,14,7,27,224,4178,
20221008,648,645,해운대,장안,3196,13,8,12,50,150,3429,1487,4,2,2,1,73,1569,
20221008,648,646,해운대,기장일광,6002,29,23,10,84,303,6451,4838,10,18,3,3,278,5150,
20221008,648,707,해운대,남포항,1892,8,29,5,25,65,2024,1382,3,16,2,2,56,1461,
20221008,651,652,남양주,화도,7620,142,240,237,129,509,8877,7997,153,242,243,77,423,9135,
20221008,651,653,남양주,서종,1886,8,6,0,1,70,1971,2629,11,8,6,3,100,2757,
20221008,651,654,남양주,설악,6242,24,54,12,10,207,6549,4244,30,59,7,9,146,4495,
20221008,651,655,남양주,강촌,4241,26,89,17,16,124,4513,3406,15,105,11,14,113,3664,
20221008,651,656,남양주,남춘천,4506,16,55,16,15,138,4746,2427,9,49,10,8,59,2562,
20221008,652,651,화도,남양주,7997,153,242,243,77,423,9135,7620,142,240,237,129,509,8877,
20221008,652,653,화도,서종,982,14,3,4,4,71,1078,1431,22,10,9,6,98,1576,
20221008,652,654,화도,설악,1531,12,5,8,1,80,1637,1120,11,12,4,4,65,1216,
20221008,653,651,서종,남양주,2629,11,8,6,3,100,2757,1886,8,6,0,1,70,1971,
20221008,653,652,서종,화도,1431,22,10,9,6,98,1576,982,14,3,4,4,71,1078,
20221008,654,651,설악,남양주,4244,30,59,7,9,146,4495,6242,24,54,12,10,207,6549,
20221008,654,652,설악,화도,1120,11,12,4,4,65,1216,1531,12,5,8,1,80,1637,
20221008,655,651,강촌,남양주,3406,15,105,11,14,113,3664,4241,26,89,17,16,124,4513,
20221008,656,651,남춘천,남양주,2427,9,49,10,8,59,2562,4506,16,55,16,15,138,4746,
20221008,671,672,봉담,정남,2720,71,44,30,137,124,3126,2435,65,34,32,248,116,2930,
20221008,671,673,봉담,북오산,1717,32,22,13,11,117,1912,2208,27,34,14,18,142,2443,
20221008,671,677,봉담,북평택,11279,70,89,56,93,501,12088,10924,88,94,66,87,558,11817,
20221008,672,671,정남,봉담,2435,65,34,32,248,116,2930,2720,71,44,30,137,124,3126,
20221008,673,101,북오산,서울,1607,31,93,15,2,80,1828,1656,20,95,19,3,92,1885,
20221008,673,671,북오산,봉담,2208,27,34,14,18,142,2443,1717,32,22,13,11,117,1912,
20221008,673,677,북오산,북평택,2517,19,19,17,16,98,2686,1754,21,25,6,18,99,1923,
20221008,675,676,서오산,향남,2648,57,33,12,83,144,2977,1946,44,28,10,58,112,2198,
20221008,675,677,서오산,북평택,17037,117,171,103,130,760,18318,13343,117,172,93,121,669,14515,
20221008,676,675,향남,서오산,1946,44,28,10,58,112,2198,2648,57,33,12,83,144,2977,
20221008,676,677,향남,북평택,1780,70,51,47,73,88,2109,1682,73,57,64,45,79,2000,
20221008,677,101,북평택,서울,2324,25,143,45,95,112,2744,3581,35,133,42,51,147,3989,
20221008,677,671,북평택,봉담,10924,88,94,66,87,558,11817,11279,70,89,56,93,501,12088,
20221008,677,673,북평택,북오산,1754,21,25,6,18,99,1923,2517,19,19,17,16,98,2686,
20221008,677,675,북평택,서오산,13343,117,172,93,121,669,14515,17037,117,171,103,130,760,18318,
20221008,677,676,북평택,향남,1682,73,57,64,45,79,2000,1780,70,51,47,73,88,2109,
20221008,677,876,북평택,양감,3258,60,56,48,64,173,3659,5035,47,64,51,62,209,5468,
20221008,682,685,조암,서시흥,1523,68,54,61,170,84,1960,2039,47,70,64,162,100,2482,
20221008,683,684,송산마도,남안산,2154,87,68,47,154,130,2640,2266,67,44,34,73,122,2606,
20221008,683,685,송산마도,서시흥,5491,103,99,82,584,286,6645,4560,72,80,83,517,246,5558,
20221008,684,683,남안산,송산마도,2266,67,44,34,73,122,2606,2154,87,68,47,154,130,2640,
20221008,684,685,남안산,서시흥,4159,169,114,219,250,281,5192,4691,142,127,194,168,317,5639,
20221008,685,682,서시흥,조암,2039,47,70,64,162,100,2482,1523,68,54,61,170,84,1960,
20221008,685,683,서시흥,송산마도,4560,72,80,83,517,246,5558,5491,103,99,82,584,286,6645,
20221008,685,684,서시흥,남안산,4691,142,127,194,168,317,5639,4159,169,114,219,250,281,5192,
20221008,704,583,근덕,동해,1166,10,39,3,38,66,1322,1126,6,28,6,65,56,1287,
20221008,705,190,남이천,동서울,1719,39,31,73,57,53,1972,1189,31,28,37,76,40,1401,
20221008,706,641,남경주,울산,1637,2,9,11,18,73,1750,1564,7,16,8,20,66,1681,
20221008,706,707,남경주,남포항,1904,21,49,12,129,87,2202,1640,26,50,17,118,74,1925,
20221008,707,641,남포항,울산,1914,12,23,18,77,93,2137,2180,14,24,16,107,108,2449,
20221008,707,648,남포항,해운대,1382,3,16,2,2,56,1461,1892,8,29,5,25,65,2024,
20221008,707,706,남포항,남경주,1640,26,50,17,118,74,1925,1904,21,49,12,129,87,2202,
20221008,707,708,남포항,동경주,2164,17,15,9,263,98,2566,2205,15,18,11,271,110,2630,
20221008,708,707,동경주,남포항,2205,15,18,11,271,110,2630,2164,17,15,9,263,98,2566,
20221008,715,716,동안동,청송,1072,17,5,6,14,43,1157,950,19,3,5,19,48,1044,
20221008,715,749,동안동,영덕,1452,8,24,4,66,50,1604,1088,7,21,5,58,42,1221,
20221008,716,715,청송,동안동,950,19,3,5,19,48,1044,1072,17,5,6,14,43,1157,
20221008,730,519,유천,남대구,2527,30,4,0,0,165,2726,2213,19,9,1,8,122,2372,
20221008,731,519,북현풍,남대구,1514,11,2,0,0,90,1617,1638,16,16,0,0,92,1762,
20221008,741,253,평택고덕,서서울,1640,18,10,14,8,117,1807,1231,12,7,8,5,76,1339,
20221008,741,520,평택고덕,평택,1008,15,63,8,9,78,1181,1145,12,47,7,6,69,1286,
20221008,741,540,평택고덕,청북,1010,15,23,32,91,71,1242,883,20,21,32,84,68,1108,
20221008,742,107,남사진위,안성,1509,20,35,25,8,84,1681,1003,35,39,19,5,66,1167,
20221008,742,108,남사진위,천안,2039,22,19,13,9,81,2183,977,17,16,12,8,44,1074,
20221008,749,715,영덕,동안동,1088,7,21,5,58,42,1221,1452,8,24,4,66,50,1604,
20221008,752,252,기장철마,대동,1939,24,22,8,40,125,2158,1625,21,24,17,48,112,1847,
20221008,753,252,금정,대동,903,25,17,23,66,48,1082,1610,37,46,32,129,85,1939,
20221008,755,140,광재,부산,941,9,9,5,17,54,1035,1110,9,14,6,12,56,1207,
20221008,755,252,광재,대동,1750,30,33,30,173,98,2114,1867,26,37,27,143,118,2218,
20221008,772,774,북달성,남칠곡,2470,26,32,16,19,111,2674,2392,33,29,22,19,113,2608,
20221008,773,774,북다사,남칠곡,1427,13,7,3,11,61,1522,1208,22,11,8,10,55,1314,
20221008,774,772,남칠곡,북달성,2392,33,29,22,19,113,2608,2470,26,32,16,19,111,2674,
20221008,774,773,남칠곡,북다사,1208,22,11,8,10,55,1314,1427,13,7,3,11,61,1522,
20221008,775,203,동명동호,가산,1488,30,15,9,55,53,1650,2246,34,26,22,212,79,2619,
20221008,775,207,동명동호,남안동,1034,13,6,1,2,35,1091,1109,7,7,1,1,38,1163,
20221008,776,777,연경,파군재,4740,29,20,12,12,233,5046,3368,22,17,9,9,181,3606,
20221008,776,779,연경,율암,6083,59,48,61,242,338,6831,6457,55,56,43,214,344,7169,
20221008,777,776,파군재,연경,3368,22,17,9,9,181,3606,4740,29,20,12,12,233,5046,
20221008,777,779,파군재,율암,2767,16,8,8,4,188,2991,2840,14,13,4,5,203,3079,
20221008,779,776,율암,연경,6457,55,56,43,214,344,7169,6083,59,48,61,242,338,6831,
20221008,779,777,율암,파군재,2840,14,13,4,5,203,3079,2767,16,8,8,4,188,2991,
20221008,876,677,양감,북평택,5035,47,64,51,62,209,5468,3258,60,56,48,64,173,3659,
20221008,981,982,서영암,강진무위사,3601,20,86,44,25,95,3871,2386,25,89,28,25,62,2615,
20221008,981,987,서영암,남순천,2891,22,76,37,125,97,3248,3139,30,87,48,150,80,3534,
20221008,982,981,강진무위사,서영암,2386,25,89,28,25,62,2615,3601,20,86,44,25,95,3871,
20221008,982,987,강진무위사,남순천,1236,11,19,16,48,43,1373,1628,15,20,20,79,49,1811,
20221008,983,987,장흥,남순천,1005,5,31,2,15,38,1096,1446,9,33,6,20,42,1556,
20221008,984,985,보성,벌교,2818,34,48,23,51,71,3045,2000,33,41,9,45,49,2177,
20221008,984,987,보성,남순천,2566,18,49,39,116,63,2851,2916,27,48,28,145,76,3240,
20221008,985,984,벌교,보성,2000,33,41,9,45,49,2177,2818,34,48,23,51,71,3045,
20221008,986,987,고흥,남순천,4460,41,97,53,123,170,4944,6821,49,98,100,159,229,7456,
20221008,987,981,남순천,서영암,3139,30,87,48,150,80,3534,2891,22,76,37,125,97,3248,
20221008,987,982,남순천,강진무위사,1628,15,20,20,79,49,1811,1236,11,19,16,48,43,1373,
20221008,987,983,남순천,장흥,1446,9,33,6,20,42,1556,1005,5,31,2,15,38,1096,
20221008,987,984,남순천,보성,2916,27,48,28,145,76,3240,2566,18,49,39,116,63,2851,
20221008,987,986,남순천,고흥,6821,49,98,100,159,229,7456,4460,41,97,53,123,170,4944,
20221009,101,102,서울,동수원,2769,14,149,8,2,163,3105,3193,18,256,25,5,186,3683,
20221009,101,103,서울,수원신갈,10688,177,825,257,21,437,12405,9304,213,815,233,18,390,10973,
20221009,101,105,서울,기흥,4883,22,118,32,4,174,5233,4607,16,150,65,3,159,5000,
20221009,101,106,서울,오산,4395,132,214,50,8,259,5058,4558,118,238,64,5,263,5246,
20221009,101,107,서울,안성,3033,30,227,4,5,170,3469,2579,26,260,17,0,123,3005,
20221009,101,108,서울,천안,4885,10,301,4,3,205,5408,4822,13,327,19,3,178,5362,
20221009,101,171,서울,마성,1770,13,86,48,3,61,1981,1626,11,88,45,0,75,1845,
20221009,101,172,서울,용인,2677,28,51,11,3,155,2925,2895,23,45,18,3,166,3150,
20221009,101,173,서울,양지,2588,50,54,21,16,86,2815,4151,93,62,39,34,128,4507,
20221009,101,528,서울,기흥동탄,5456,14,404,98,2,222,6196,5279,15,405,102,1,242,6044,
20221009,101,542,서울,서안성,1458,9,47,55,4,61,1634,1605,17,37,60,8,76,1803,
20221009,101,543,서울,남안성,1261,25,32,30,4,40,1392,988,26,23,42,4,42,1125,
20221009,101,673,서울,북오산,1474,7,90,4,2,100,1677,1286,10,88,4,1,60,1449,
20221009,101,677,서울,북평택,2111,7,220,24,33,89,2484,2692,9,129,14,25,107,2976,
20221009,102,101,동수원,서울,3193,18,256,25,5,186,3683,2769,14,149,8,2,163,3105,
20221009,102,212,동수원,북수원,2244,9,132,4,3,111,2503,2140,6,135,0,1,90,2372,
20221009,102,253,동수원,서서울,4812,16,30,5,2,241,5106,4877,24,25,7,2,262,5197,
20221009,102,254,동수원,군자,3591,11,32,4,3,154,3795,4544,13,31,7,6,163,4764,
20221009,103,101,수원신갈,서울,9304,213,815,233,18,390,10973,10688,177,825,257,21,437,12405,
20221009,103,105,수원신갈,기흥,1577,9,7,3,9,74,1679,2596,8,5,2,6,98,2715,
20221009,103,253,수원신갈,서서울,1573,36,12,30,4,88,1743,2260,37,23,15,7,116,2458,
20221009,103,254,수원신갈,군자,1372,21,14,17,12,69,1505,2086,38,19,47,14,96,2300,
20221009,105,101,기흥,서울,4607,16,150,65,3,159,5000,4883,22,118,32,4,174,5233,
20221009,105,103,기흥,수원신갈,2596,8,5,2,6,98,2715,1577,9,7,3,9,74,1679,
20221009,106,101,오산,서울,4558,118,238,64,5,263,5246,4395,132,214,50,8,259,5058,
20221009,107,101,안성,서울,2579,26,260,17,0,123,3005,3033,30,227,4,5,170,3469,
20221009,107,108,안성,천안,1821,7,24,0,4,91,1947,1642,9,23,1,3,89,1767,
20221009,108,101,천안,서울,4822,13,327,19,3,178,5362,4885,10,301,4,3,205,5408,
20221009,108,107,천안,안성,1642,9,23,1,3,89,1767,1821,7,24,0,4,91,1947,
20221009,108,229,천안,북천안,1386,23,40,12,6,54,1521,1694,22,45,7,13,81,1862,
20221009,114,153,남대전,서대전,1247,3,9,6,0,74,1339,974,4,15,10,0,68,1071,
20221009,115,116,대전,옥천,1636,9,14,1,4,104,1768,1644,10,15,4,6,101,1780,
20221009,116,115,옥천,대전,1644,10,15,4,6,101,1780,1636,9,14,1,4,104,1768,
20221009,119,153,판암,서대전,1355,6,5,3,1,88,1458,1430,6,9,1,0,78,1524,
20221009,123,127,구미,서대구,1503,10,19,2,2,82,1618,1518,9,20,2,1,94,1644,
20221009,123,129,구미,북대구,1692,3,59,2,0,71,1827,1844,7,53,1,0,72,1977,
20221009,125,127,남구미,서대구,1297,8,35,3,2,91,1436,1437,9,32,5,2,80,1565,
20221009,125,129,남구미,북대구,1286,0,18,3,1,66,1374,1584,2,18,0,0,86,1690,
20221009,126,127,왜관,서대구,1725,33,16,8,0,94,1876,1874,37,15,11,5,79,2021,
20221009,126,129,왜관,북대구,2360,21,10,1,7,86,2485,2512,21,11,2,7,103,2656,
20221009,127,123,서대구,구미,1518,9,20,2,1,94,1644,1503,10,19,2,2,82,1618,
20221009,127,125,서대구,남구미,1437,9,32,5,2,80,1565,1297,8,35,3,2,91,1436,
20221009,127,126,서대구,왜관,1874,37,15,11,5,79,2021,1725,33,16,8,0,94,1876,
20221009,127,131,서대구,경산,1483,35,26,11,15,87,1657,1069,30,6,6,10,43,1164,
20221009,127,203,서대구,가산,1896,13,19,4,1,67,2000,2039,7,12,2,2,77,2139,
20221009,127,527,서대구,포항,2003,10,25,1,5,73,2117,1563,7,20,0,4,65,1659,
20221009,129,123,북대구,구미,1844,7,53,1,0,72,1977,1692,3,59,2,0,71,1827,
20221009,129,125,북대구,남구미,1584,2,18,0,0,86,1690,1286,0,18,3,1,66,1374,
20221009,129,126,북대구,왜관,2512,21,11,2,7,103,2656,2360,21,10,1,7,86,2485,
20221009,129,131,북대구,경산,1230,27,16,6,3,61,1343,1727,33,16,3,6,91,1876,
20221009,129,527,북대구,포항,2379,16,13,7,7,79,2501,3380,27,19,12,16,137,3591,
20221009,131,127,경산,서대구,1069,30,6,6,10,43,1164,1483,35,26,11,15,87,1657,
20221009,131,129,경산,북대구,1727,33,16,3,6,91,1876,1230,27,16,6,3,61,1343,
20221009,131,621,경산,동대구,1346,20,9,1,8,61,1445,1298,12,11,3,9,60,1393,
20221009,135,140,경주,부산,2736,3,12,7,2,95,2855,2768,8,18,0,2,128,2924,
20221009,135,252,경주,대동,2128,8,51,14,2,98,2301,2323,6,46,6,8,117,2506,
20221009,135,621,경주,동대구,1300,5,44,1,0,47,1397,1268,2,38,1,0,52,1361,
20221009,137,140,통도사,부산,944,14,5,3,1,46,1013,990,6,7,0,0,62,1065,
20221009,138,140,양산,부산,3073,41,43,3,4,114,3278,2849,50,47,5,16,121,3088,
20221009,138,252,양산,대동,1176,24,15,12,58,54,1339,1306,38,29,9,33,52,1467,
20221009,139,140,서울산,부산,2452,5,13,0,0,85,2555,2048,8,12,2,1,90,2161,
20221009,139,252,서울산,대동,1411,6,25,0,1,73,1516,1349,3,4,1,0,66,1423,
20221009,139,641,서울산,울산,1537,10,46,0,3,71,1667,1448,5,45,1,5,72,1576,
20221009,140,135,부산,경주,2768,8,18,0,2,128,2924,2736,3,12,7,2,95,2855,
20221009,140,137,부산,통도사,990,6,7,0,0,62,1065,944,14,5,3,1,46,1013,
20221009,140,138,부산,양산,2849,50,47,5,16,121,3088,3073,41,43,3,4,114,3278,
20221009,140,139,부산,서울산,2048,8,12,2,1,90,2161,2452,5,13,0,0,85,2555,
20221009,140,250,부산,남양산,6199,30,126,6,4,385,6750,6135,37,120,7,2,404,6705,
20221009,140,286,부산,통도사휴게소,1196,5,2,0,0,30,1233,1202,4,3,0,0,36,1245,
20221009,140,289,부산,마산,966,4,7,2,0,38,1017,1215,2,11,2,0,35,1265,
20221009,142,145,군북,산인,4729,12,55,4,6,224,5030,4015,10,30,1,10,199,4265,
20221009,144,145,함안,산인,2024,7,9,3,3,114,2160,2154,6,11,2,6,127,2306,
20221009,145,142,산인,군북,4015,10,30,1,10,199,4265,4729,12,55,4,6,224,5030,
20221009,145,144,산인,함안,2154,6,11,2,6,127,2306,2024,7,9,3,3,114,2160,
20221009,145,272,산인,광양,1115,4,32,2,4,30,1187,1484,6,47,5,4,22,1568,
20221009,145,291,산인,사천,1936,12,43,7,1,86,2085,2453,10,47,7,4,109,2630,
20221009,145,292,산인,진주,1304,6,123,1,2,82,1518,1853,4,133,3,1,107,2101,
20221009,145,293,산인,문산,1218,3,14,1,3,54,1293,1365,3,11,2,2,58,1441,
20221009,146,150,동창원,북부산,1000,3,2,0,0,60,1065,1029,2,5,1,1,56,1094,
20221009,146,244,동창원,서부산,1241,9,18,3,3,66,1340,1459,8,15,4,3,91,1580,
20221009,146,289,동창원,마산,1766,18,9,3,0,137,1933,2054,13,9,1,1,131,2209,
20221009,148,150,서김해,북부산,5205,48,36,6,5,334,5634,4896,26,37,6,9,351,5325,
20221009,148,289,서김해,마산,1208,6,41,5,1,74,1335,1591,4,42,3,1,74,1715,
20221009,149,150,동김해,북부산,8499,84,97,3,16,596,9295,7178,65,71,3,3,470,7790,
20221009,150,146,북부산,동창원,1029,2,5,1,1,56,1094,1000,3,2,0,0,60,1065,
20221009,150,148,북부산,서김해,4896,26,37,6,9,351,5325,5205,48,36,6,5,334,5634,
20221009,150,149,북부산,동김해,7178,65,71,3,3,470,7790,8499,84,97,3,16,596,9295,
20221009,150,245,북부산,장유,3888,13,72,2,19,221,4215,2838,12,68,2,13,165,3098,
20221009,150,289,북부산,마산,3190,8,82,3,0,105,3388,5244,15,128,1,10,153,5551,
20221009,153,114,서대전,남대전,974,4,15,10,0,68,1071,1247,3,9,6,0,74,1339,
20221009,153,119,서대전,판암,1430,6,9,1,0,78,1524,1355,6,5,3,1,88,1458,
20221009,159,167,서전주,광주,1674,13,27,9,1,43,1767,1800,16,13,4,6,42,1881,
20221009,166,167,장성,광주,2598,23,44,3,1,97,2766,3565,33,47,4,3,112,3764,
20221009,167,159,광주,서전주,1800,16,13,4,6,42,1881,1674,13,27,9,1,43,1767,
20221009,167,166,광주,장성,3565,33,47,4,3,112,3764,2598,23,44,3,1,97,2766,
20221009,167,567,광주,남고창,1387,11,21,7,3,46,1475,1433,8,24,6,3,52,1526,
20221009,171,101,마성,서울,1626,11,88,45,0,75,1845,1770,13,86,48,3,61,1981,
20221009,172,101,용인,서울,2895,23,45,18,3,166,3150,2677,28,51,11,3,155,2925,
20221009,172,173,용인,양지,1014,64,19,19,4,67,1187,1076,28,19,9,7,65,1204,
20221009,172,253,용인,서서울,941,6,4,6,2,51,1010,943,14,8,6,2,64,1037,
20221009,173,101,양지,서울,4151,93,62,39,34,128,4507,2588,50,54,21,16,86,2815,
20221009,173,172,양지,용인,1076,28,19,9,7,65,1204,1014,64,19,19,4,67,1187,
20221009,174,179,춘천,홍천,3571,21,56,4,2,199,3853,2495,16,49,2,1,182,2745,
20221009,174,218,춘천,남원주,1214,6,41,2,0,47,1310,1244,4,47,2,2,53,1352,
20221009,174,554,춘천,동홍천,1036,9,10,3,2,53,1113,1243,7,9,0,0,77,1336,
20221009,176,190,이천,동서울,1443,14,34,11,3,60,1565,1189,6,59,5,0,53,1312,
20221009,177,190,여주,동서울,1050,4,23,8,3,43,1131,1216,1,32,12,4,41,1306,
20221009,179,174,홍천,춘천,2495,16,49,2,1,182,2745,3571,21,56,4,2,199,3853,
20221009,184,189,대관령,강릉,1949,15,42,2,3,67,2078,1918,13,45,7,3,61,2047,
20221009,189,184,강릉,대관령,1918,13,45,7,3,61,2047,1949,15,42,2,3,67,2078,
20221009,190,176,동서울,이천,1189,6,59,5,0,53,1312,1443,14,34,11,3,60,1565,
20221009,190,177,동서울,여주,1216,1,32,12,4,41,1306,1050,4,23,8,3,43,1131,
20221009,190,191,동서울,경기광주,8550,163,224,54,19,494,9504,7335,114,218,45,28,424,8164,
20221009,190,192,동서울,곤지암,3539,119,59,49,18,174,3958,3017,80,50,44,15,121,3327,
20221009,190,193,동서울,일죽,2565,28,55,31,13,107,2799,2616,25,39,52,15,96,2843,
20221009,190,194,동서울,서이천,3507,112,103,64,14,180,3980,2800,36,64,48,15,147,3110,
20221009,190,198,동서울,서청주,1170,4,15,2,2,49,1242,1083,3,14,5,1,48,1154,
20221009,190,199,동서울,오창,990,0,10,1,5,49,1055,1018,4,7,5,6,44,1084,
20221009,190,560,동서울,감곡,1058,4,9,10,3,28,1112,1258,4,4,14,10,28,1318,
20221009,190,705,동서울,남이천,1279,21,16,11,3,36,1366,1909,32,7,14,5,60,2027,
20221009,191,190,경기광주,동서울,7335,114,218,45,28,424,8164,8550,163,224,54,19,494,9504,
20221009,192,190,곤지암,동서울,3017,80,50,44,15,121,3327,3539,119,59,49,18,174,3958,
20221009,192,194,곤지암,서이천,1273,62,31,22,3,78,1469,1359,35,18,22,1,69,1504,
20221009,193,190,일죽,동서울,2616,25,39,52,15,96,2843,2565,28,55,31,13,107,2799,
20221009,194,190,서이천,동서울,2800,36,64,48,15,147,3110,3507,112,103,64,14,180,3980,
20221009,194,192,서이천,곤지암,1359,35,18,22,1,69,1504,1273,62,31,22,3,78,1469,
20221009,198,190,서청주,동서울,1083,3,14,5,1,48,1154,1170,4,15,2,2,49,1242,
20221009,199,190,오창,동서울,1018,4,7,5,6,44,1084,990,0,10,1,5,49,1055,
20221009,203,127,가산,서대구,2039,7,12,2,2,77,2139,1896,13,19,4,1,67,2000,
20221009,203,775,가산,동명동호,1759,8,6,3,3,69,1848,1509,10,9,4,3,57,1592,
20221009,212,102,북수원,동수원,2140,6,135,0,1,90,2372,2244,9,132,4,3,111,2503,
20221009,212,254,북수원,군자,1851,4,19,6,3,87,1970,1316,8,12,14,2,64,1416,
20221009,215,253,군포,서서울,2975,12,31,7,6,170,3201,2512,27,47,5,9,159,2759,
20221009,215,254,군포,군자,1978,9,14,4,13,101,2119,1988,22,15,12,9,108,2154,
20221009,218,174,남원주,춘천,1244,4,47,2,2,53,1352,1214,6,41,2,0,47,1310,
20221009,218,240,남원주,제천,1770,10,27,1,8,85,1901,2032,7,26,7,5,88,2165,
20221009,229,108,북천안,천안,1694,22,45,7,13,81,1862,1386,23,40,12,6,54,1521,
20221009,230,527,팔공산,포항,2538,8,4,1,2,83,2636,2444,9,10,0,4,82,2549,
20221009,231,519,화원옥포,남대구,4076,27,32,8,1,279,4423,3997,36,29,7,3,260,4332,
20221009,232,519,달성,남대구,1401,20,27,4,0,98,1550,1451,18,14,3,1,80,1567,
20221009,233,519,현풍,남대구,3132,33,42,9,6,177,3399,2655,27,39,16,4,148,2889,
20221009,239,519,칠원,남대구,2323,18,44,11,3,91,2490,2421,12,45,5,1,94,2578,
20221009,240,218,제천,남원주,2032,7,26,7,5,88,2165,1770,10,27,1,8,85,1901,
20221009,241,519,동고령,남대구,3417,10,58,6,2,156,3649,2883,12,42,3,2,159,3101,
20221009,242,519,고령,남대구,2645,11,35,5,2,113,2811,2779,10,32,2,2,110,2935,
20221009,243,519,해인사,남대구,1159,4,2,1,0,41,1207,1128,4,4,0,0,37,1173,
20221009,244,146,서부산,동창원,1459,8,15,4,3,91,1580,1241,9,18,3,3,66,1340,
20221009,244,245,서부산,장유,12613,53,256,18,24,776,13740,12339,53,225,18,32,791,13458,
20221009,244,289,서부산,마산,3902,17,236,6,10,179,4350,5274,23,310,12,3,218,5840,
20221009,245,150,장유,북부산,2838,12,68,2,13,165,3098,3888,13,72,2,19,221,4215,
20221009,245,244,장유,서부산,12339,53,225,18,32,791,13458,12613,53,256,18,24,776,13740,
20221009,245,289,장유,마산,1271,2,17,2,0,68,1360,2012,4,28,6,0,99,2149,
20221009,248,261,순창,동광주,1734,4,11,1,0,59,1809,1600,3,14,2,0,44,1663,
20221009,249,261,담양,동광주,2724,10,92,2,3,78,2909,2387,11,89,1,1,79,2568,
20221009,250,140,남양산,부산,6135,37,120,7,2,404,6705,6199,30,126,6,4,385,6750,
20221009,250,252,남양산,대동,2177,16,11,2,11,146,2363,2946,26,12,8,18,181,3191,
20221009,251,252,물금,대동,2202,81,15,12,64,154,2528,3258,88,11,12,65,210,3644,
20221009,252,135,대동,경주,2323,6,46,6,8,117,2506,2128,8,51,14,2,98,2301,
20221009,252,138,대동,양산,1306,38,29,9,33,52,1467,1176,24,15,12,58,54,1339,
20221009,252,139,대동,서울산,1349,3,4,1,0,66,1423,1411,6,25,0,1,73,1516,
20221009,252,250,대동,남양산,2946,26,12,8,18,181,3191,2177,16,11,2,11,146,2363,
20221009,252,251,대동,물금,3258,88,11,12,65,210,3644,2202,81,15,12,64,154,2528,
20221009,252,641,대동,울산,2207,13,35,3,2,127,2387,1697,10,26,7,1,85,1826,
20221009,252,752,대동,기장철마,1550,6,13,1,11,98,1679,1684,14,11,1,7,108,1825,
20221009,252,755,대동,광재,1300,9,7,3,4,79,1402,1186,10,11,2,8,62,1279,
20221009,253,102,서서울,동수원,4877,24,25,7,2,262,5197,4812,16,30,5,2,241,5106,
20221009,253,103,서서울,수원신갈,2260,37,23,15,7,116,2458,1573,36,12,30,4,88,1743,
20221009,253,172,서서울,용인,943,14,8,6,2,64,1037,941,6,4,6,2,51,1010,
20221009,253,215,서서울,군포,2512,27,47,5,9,159,2759,2975,12,31,7,6,170,3201,
20221009,253,255,서서울,서안산,7831,91,63,62,74,445,8566,8038,102,50,40,72,441,8743,
20221009,253,256,서서울,안산,6777,78,37,13,11,444,7360,4252,44,21,4,9,298,4628,
20221009,253,257,서서울,홍성,1569,4,11,1,0,56,1641,1910,7,9,4,0,72,2002,
20221009,253,259,서서울,대천,1220,2,18,3,0,40,1283,1547,2,11,2,0,41,1603,
20221009,253,281,서서울,매송,2578,14,9,8,0,162,2771,2162,8,3,7,6,125,2311,
20221009,253,282,서서울,비봉,3212,50,22,16,301,177,3778,4391,55,36,20,202,231,4935,
20221009,253,283,서서울,발안,2856,27,23,16,64,178,3164,3049,20,18,12,48,144,3291,
20221009,253,285,서서울,서평택,1737,5,19,36,73,106,1976,2193,12,17,48,82,114,2466,
20221009,253,287,서서울,송악,2438,5,14,14,33,116,2620,4102,16,21,25,66,134,4364,
20221009,253,288,서서울,당진,1965,1,27,4,4,87,2088,2636,6,31,16,4,119,2812,
20221009,253,298,서서울,서산,3979,11,28,11,4,160,4193,3753,14,28,20,2,134,3951,
20221009,253,520,서서울,평택,3771,21,24,24,19,139,3998,3401,15,21,24,9,119,3589,
20221009,253,741,서서울,평택고덕,1664,8,1,2,6,105,1786,1016,8,4,6,6,58,1098,
20221009,254,102,군자,동수원,4544,13,31,7,6,163,4764,3591,11,32,4,3,154,3795,
20221009,254,103,군자,수원신갈,2086,38,19,47,14,96,2300,1372,21,14,17,12,69,1505,
20221009,254,212,군자,북수원,1316,8,12,14,2,64,1416,1851,4,19,6,3,87,1970,
20221009,254,215,군자,군포,1988,22,15,12,9,108,2154,1978,9,14,4,13,101,2119,
20221009,254,255,군자,서안산,5822,51,50,15,16,372,6326,6940,55,40,33,17,429,7514,
20221009,254,256,군자,안산,3669,29,88,5,9,236,4036,4018,29,90,15,13,248,4413,
20221009,255,253,서안산,서서울,8038,102,50,40,72,441,8743,7831,91,63,62,74,445,8566,
20221009,255,254,서안산,군자,6940,55,40,33,17,429,7514,5822,51,50,15,16,372,6326,
20221009,256,253,안산,서서울,4252,44,21,4,9,298,4628,6777,78,37,13,11,444,7360,
20221009,256,254,안산,군자,4018,29,90,15,13,248,4413,3669,29,88,5,9,236,4036,
20221009,257,253,홍성,서서울,1910,7,9,4,0,72,2002,1569,4,11,1,0,56,1641,
20221009,259,253,대천,서서울,1547,2,11,2,0,41,1603,1220,2,18,3,0,40,1283,
20221009,261,248,동광주,순창,1600,3,14,2,0,44,1663,1734,4,11,1,0,59,1809,
20221009,261,249,동광주,담양,2387,11,89,1,1,79,2568,2724,10,92,2,3,78,2909,
20221009,261,262,동광주,창평,1680,21,13,7,6,48,1775,1760,12,10,3,6,44,1835,
20221009,261,263,동광주,옥과,2350,6,73,2,1,70,2502,2264,5,69,1,4,78,2421,
20221009,261,265,동광주,곡성,1573,9,27,3,0,56,1668,1690,4,29,3,0,62,1788,
20221009,261,270,동광주,서순천,1025,7,40,1,0,31,1104,979,6,39,0,1,32,1057,
20221009,261,271,동광주,순천,4206,25,47,3,4,115,4400,4088,23,46,2,10,117,4286,
20221009,262,261,창평,동광주,1760,12,10,3,6,44,1835,1680,21,13,7,6,48,1775,
20221009,263,261,옥과,동광주,2264,5,69,1,4,78,2421,2350,6,73,2,1,70,2502,
20221009,265,261,곡성,동광주,1690,4,29,3,0,62,1788,1573,9,27,3,0,56,1668,
20221009,270,261,서순천,동광주,979,6,39,0,1,32,1057,1025,7,40,1,0,31,1104,
20221009,271,261,순천,동광주,4088,23,46,2,10,117,4286,4206,25,47,3,4,115,4400,
20221009,272,145,광양,산인,1484,6,47,5,4,22,1568,1115,4,32,2,4,30,1187,
20221009,280,519,거창,남대구,1618,9,31,0,1,87,1746,1621,15,37,3,0,64,1740,
20221009,281,253,매송,서서울,2162,8,3,7,6,125,2311,2578,14,9,8,0,162,2771,
20221009,282,253,비봉,서서울,4391,55,36,20,202,231,4935,3212,50,22,16,301,177,3778,
20221009,283,253,발안,서서울,3049,20,18,12,48,144,3291,2856,27,23,16,64,178,3164,
20221009,285,253,서평택,서서울,2193,12,17,48,82,114,2466,1737,5,19,36,73,106,1976,
20221009,286,140,통도사휴게소,부산,1202,4,3,0,0,36,1245,1196,5,2,0,0,30,1233,
20221009,287,253,송악,서서울,4102,16,21,25,66,134,4364,2438,5,14,14,33,116,2620,
20221009,288,253,당진,서서울,2636,6,31,16,4,119,2812,1965,1,27,4,4,87,2088,
20221009,289,140,마산,부산,1215,2,11,2,0,35,1265,966,4,7,2,0,38,1017,
20221009,289,146,마산,동창원,2054,13,9,1,1,131,2209,1766,18,9,3,0,137,1933,
20221009,289,148,마산,서김해,1591,4,42,3,1,74,1715,1208,6,41,5,1,74,1335,
20221009,289,150,마산,북부산,5244,15,128,1,10,153,5551,3190,8,82,3,0,105,3388,
20221009,289,244,마산,서부산,5274,23,310,12,3,218,5840,3902,17,236,6,10,179,4350,
20221009,289,245,마산,장유,2012,4,28,6,0,99,2149,1271,2,17,2,0,68,1360,
20221009,291,145,사천,산인,2453,10,47,7,4,109,2630,1936,12,43,7,1,86,2085,
20221009,291,292,사천,진주,1584,5,23,5,4,115,1736,1934,19,21,3,4,128,2109,
20221009,292,145,진주,산인,1853,4,133,3,1,107,2101,1304,6,123,1,2,82,1518,
20221009,292,291,진주,사천,1934,19,21,3,4,128,2109,1584,5,23,5,4,115,1736,
20221009,293,145,문산,산인,1365,3,11,2,2,58,1441,1218,3,14,1,3,54,1293,
20221009,298,253,서산,서서울,3753,14,28,20,2,134,3951,3979,11,28,11,4,160,4193,
20221009,508,509,무안,목포,1009,11,17,5,12,30,1084,1207,9,12,9,20,44,1301,
20221009,508,553,무안,동광산,1415,8,17,4,3,39,1486,1530,8,20,3,2,31,1594,
20221009,509,508,목포,무안,1207,9,12,9,20,44,1301,1009,11,17,5,12,30,1084,
20221009,509,553,목포,동광산,9504,42,125,33,23,272,9999,8979,40,113,24,22,259,9437,
20221009,513,515,고성,북통영,2194,16,64,4,2,102,2382,2717,14,45,3,5,134,2918,
20221009,513,516,고성,통영,4848,30,51,6,6,244,5185,5117,27,37,8,14,248,5451,
20221009,514,516,동고성,통영,997,6,8,5,2,95,1113,943,2,7,2,1,96,1051,
20221009,515,513,북통영,고성,2717,14,45,3,5,134,2918,2194,16,64,4,2,102,2382,
20221009,516,513,통영,고성,5117,27,37,8,14,248,5451,4848,30,51,6,6,244,5185,
20221009,516,514,통영,동고성,943,2,7,2,1,96,1051,997,6,8,5,2,95,1113,
20221009,517,598,양평,북여주,1311,6,1,3,9,46,1376,1260,1,4,8,10,43,1326,
20221009,519,231,남대구,화원옥포,3997,36,29,7,3,260,4332,4076,27,32,8,1,279,4423,
20221009,519,232,남대구,달성,1451,18,14,3,1,80,1567,1401,20,27,4,0,98,1550,
20221009,519,233,남대구,현풍,2655,27,39,16,4,148,2889,3132,33,42,9,6,177,3399,
20221009,519,239,남대구,칠원,2421,12,45,5,1,94,2578,2323,18,44,11,3,91,2490,
20221009,519,241,남대구,동고령,2883,12,42,3,2,159,3101,3417,10,58,6,2,156,3649,
20221009,519,242,남대구,고령,2779,10,32,2,2,110,2935,2645,11,35,5,2,113,2811,
20221009,519,243,남대구,해인사,1128,4,4,0,0,37,1173,1159,4,2,1,0,41,1207,
20221009,519,280,남대구,거창,1621,15,37,3,0,64,1740,1618,9,31,0,1,87,1746,
20221009,519,730,남대구,유천,1532,8,11,0,0,80,1631,1708,9,6,0,0,85,1808,
20221009,519,731,남대구,북현풍,1333,3,15,0,0,68,1419,1156,8,6,0,0,59,1229,
20221009,520,253,평택,서서울,3401,15,21,24,9,119,3589,3771,21,24,24,19,139,3998,
20221009,526,527,서포항,포항,1242,3,10,2,0,60,1317,1359,11,11,2,0,58,1441,
20221009,527,127,포항,서대구,1563,7,20,0,4,65,1659,2003,10,25,1,5,73,2117,
20221009,527,129,포항,북대구,3380,27,19,12,16,137,3591,2379,16,13,7,7,79,2501,
20221009,527,230,포항,팔공산,2444,9,10,0,4,82,2549,2538,8,4,1,2,83,2636,
20221009,527,526,포항,서포항,1359,11,11,2,0,58,1441,1242,3,10,2,0,60,1317,
20221009,527,621,포항,동대구,951,4,54,2,0,39,1050,905,1,57,0,0,43,1006,
20221009,528,101,기흥동탄,서울,5279,15,405,102,1,242,6044,5456,14,404,98,2,222,6196,
20221009,542,101,서안성,서울,1605,17,37,60,8,76,1803,1458,9,47,55,4,61,1634,
20221009,543,101,남안성,서울,988,26,23,42,4,42,1125,1261,25,32,30,4,40,1392,
20221009,548,553,북무안,동광산,2586,13,15,13,4,63,2694,2351,9,16,9,7,50,2442,
20221009,549,553,동함평,동광산,2912,15,28,3,8,101,3067,2808,19,31,4,8,94,2964,
20221009,551,553,나주,동광산,1090,5,10,1,3,24,1133,1064,2,4,2,1,28,1101,
20221009,552,553,서광산,동광산,2957,43,72,46,24,77,3219,3831,51,89,53,17,110,4151,
20221009,553,508,동광산,무안,1530,8,20,3,2,31,1594,1415,8,17,4,3,39,1486,
20221009,553,509,동광산,목포,8979,40,113,24,22,259,9437,9504,42,125,33,23,272,9999,
20221009,553,548,동광산,북무안,2351,9,16,9,7,50,2442,2586,13,15,13,4,63,2694,
20221009,553,549,동광산,동함평,2808,19,31,4,8,94,2964,2912,15,28,3,8,101,3067,
20221009,553,551,동광산,나주,1064,2,4,2,1,28,1101,1090,5,10,1,3,24,1133,
20221009,553,552,동광산,서광산,3831,51,89,53,17,110,4151,2957,43,72,46,24,77,3219,
20221009,554,174,동홍천,춘천,1243,7,9,0,0,77,1336,1036,9,10,3,2,53,1113,
20221009,556,557,동순천,황전,1359,7,12,1,2,36,1417,1022,8,11,1,2,29,1073,
20221009,556,589,동순천,상관,1102,0,7,0,54,24,1187,1043,1,11,5,38,23,1121,
20221009,557,556,황전,동순천,1022,8,11,1,2,29,1073,1359,7,12,1,2,36,1417,
20221009,560,190,감곡,동서울,1258,4,4,14,10,28,1318,1058,4,9,10,3,28,1112,
20221009,567,167,남고창,광주,1433,8,24,6,3,52,1526,1387,11,21,7,3,46,1475,
20221009,583,704,동해,근덕,1088,4,20,1,20,54,1187,1168,8,29,3,15,47,1270,
20221009,587,589,오수,상관,958,5,28,16,4,24,1035,1116,3,34,8,4,25,1190,
20221009,589,556,상관,동순천,1043,1,11,5,38,23,1121,1102,0,7,0,54,24,1187,
20221009,589,587,상관,오수,1116,3,34,8,4,25,1190,958,5,28,16,4,24,1035,
20221009,598,517,북여주,양평,1260,1,4,8,10,43,1326,1311,6,1,3,9,46,1376,
20221009,621,131,동대구,경산,1298,12,11,3,9,60,1393,1346,20,9,1,8,61,1445,
20221009,621,135,동대구,경주,1268,2,38,1,0,52,1361,1300,5,44,1,0,47,1397,
20221009,621,527,동대구,포항,905,1,57,0,0,43,1006,951,4,54,2,0,39,1050,
20221009,624,626,청도,남밀양,1085,11,6,8,10,42,1162,1035,10,4,6,8,50,1113,
20221009,625,626,밀양,남밀양,2059,15,14,8,5,83,2184,1884,6,12,11,6,67,1986,
20221009,626,624,남밀양,청도,1035,10,4,6,8,50,1113,1085,11,6,8,10,42,1162,
20221009,626,625,남밀양,밀양,1884,6,12,11,6,67,1986,2059,15,14,8,5,83,2184,
20221009,641,139,울산,서울산,1448,5,45,1,5,72,1576,1537,10,46,0,3,71,1667,
20221009,641,252,울산,대동,1697,10,26,7,1,85,1826,2207,13,35,3,2,127,2387,
20221009,641,648,울산,해운대,1026,1,1,0,0,57,1085,1439,2,3,0,1,74,1519,
20221009,641,706,울산,남경주,1305,2,3,0,0,53,1363,1476,2,9,5,2,76,1570,
20221009,641,707,울산,남포항,1787,8,21,4,21,73,1914,2134,4,24,14,24,90,2290,
20221009,643,648,청량,해운대,3107,1,18,1,2,155,3284,4303,5,51,4,10,227,4600,
20221009,645,648,장안,해운대,1151,1,4,0,0,50,1206,2870,3,9,2,1,135,3020,
20221009,646,648,기장일광,해운대,4180,15,7,0,0,210,4412,6084,9,13,3,15,295,6419,
20221009,648,641,해운대,울산,1439,2,3,0,1,74,1519,1026,1,1,0,0,57,1085,
20221009,648,643,해운대,청량,4303,5,51,4,10,227,4600,3107,1,18,1,2,155,3284,
20221009,648,645,해운대,장안,2870,3,9,2,1,135,3020,1151,1,4,0,0,50,1206,
20221009,648,646,해운대,기장일광,6084,9,13,3,15,295,6419,4180,15,7,0,0,210,4412,
20221009,648,707,해운대,남포항,1752,6,26,3,10,57,1854,1206,3,10,2,1,52,1274,
20221009,651,652,남양주,화도,10362,85,239,174,38,586,11484,12370,103,271,194,32,621,13591,
20221009,651,653,남양주,서종,1911,1,0,1,2,76,1991,4547,6,8,3,1,150,4715,
20221009,651,654,남양주,설악,4516,9,47,5,3,154,4734,4586,6,42,4,0,174,4812,
20221009,651,655,남양주,강촌,3049,12,85,13,10,104,3273,3009,10,58,19,6,103,3205,
20221009,651,656,남양주,남춘천,3168,10,27,3,4,100,3312,1895,4,15,3,6,40,1963,
20221009,652,651,화도,남양주,12370,103,271,194,32,621,13591,10362,85,239,174,38,586,11484,
20221009,652,653,화도,서종,1173,11,3,1,0,67,1255,2207,14,3,4,1,114,2343,
20221009,652,654,화도,설악,1068,10,5,0,1,45,1129,1055,5,2,3,1,38,1104,
20221009,653,651,서종,남양주,4547,6,8,3,1,150,4715,1911,1,0,1,2,76,1991,
20221009,653,652,서종,화도,2207,14,3,4,1,114,2343,1173,11,3,1,0,67,1255,
20221009,654,651,설악,남양주,4586,6,42,4,0,174,4812,4516,9,47,5,3,154,4734,
20221009,654,652,설악,화도,1055,5,2,3,1,38,1104,1068,10,5,0,1,45,1129,
20221009,655,651,강촌,남양주,3009,10,58,19,6,103,3205,3049,12,85,13,10,104,3273,
20221009,656,651,남춘천,남양주,1895,4,15,3,6,40,1963,3168,10,27,3,4,100,3312,
20221009,671,672,봉담,정남,1349,19,18,2,65,88,1541,1595,16,12,3,76,89,1791,
20221009,671,673,봉담,북오산,1379,15,16,6,2,75,1493,1545,9,21,6,3,77,1661,
20221009,671,677,봉담,북평택,8714,42,52,19,11,416,9254,9794,43,41,24,11,359,10272,
20221009,672,671,정남,봉담,1595,16,12,3,76,89,1791,1349,19,18,2,65,88,1541,
20221009,673,101,북오산,서울,1286,10,88,4,1,60,1449,1474,7,90,4,2,100,1677,
20221009,673,671,북오산,봉담,1545,9,21,6,3,77,1661,1379,15,16,6,2,75,1493,
20221009,673,677,북오산,북평택,1921,9,15,3,3,87,2038,1815,13,11,2,8,80,1929,
20221009,675,676,서오산,향남,1328,14,9,3,20,89,1463,1132,21,13,4,20,78,1268,
20221009,675,677,서오산,북평택,9827,57,116,30,37,516,10583,13355,64,110,45,35,575,14184,
20221009,676,675,향남,서오산,1132,21,13,4,20,78,1268,1328,14,9,3,20,89,1463,
20221009,676,677,향남,북평택,1114,15,19,19,44,55,1266,1672,17,27,22,40,73,1851,
20221009,677,101,북평택,서울,2692,9,129,14,25,107,2976,2111,7,220,24,33,89,2484,
20221009,677,671,북평택,봉담,9794,43,41,24,11,359,10272,8714,42,52,19,11,416,9254,
20221009,677,673,북평택,북오산,1815,13,11,2,8,80,1929,1921,9,15,3,3,87,2038,
20221009,677,675,북평택,서오산,13355,64,110,45,35,575,14184,9827,57,116,30,37,516,10583,
20221009,677,676,북평택,향남,1672,17,27,22,40,73,1851,1114,15,19,19,44,55,1266,
20221009,677,876,북평택,양감,3483,14,21,10,10,148,3686,919,7,10,5,6,55,1002,
20221009,682,685,조암,서시흥,1054,11,21,10,81,43,1220,1137,15,13,13,70,53,1301,
20221009,683,684,송산마도,남안산,1382,25,15,7,67,70,1566,1377,20,12,9,59,93,1570,
20221009,683,685,송산마도,서시흥,4371,30,44,13,116,227,4801,4304,32,33,21,116,197,4703,
20221009,684,683,남안산,송산마도,1377,20,12,9,59,93,1570,1382,25,15,7,67,70,1566,
20221009,684,685,남안산,서시흥,2004,76,73,141,63,155,2512,3450,92,84,116,53,233,4028,
20221009,685,682,서시흥,조암,1137,15,13,13,70,53,1301,1054,11,21,10,81,43,1220,
20221009,685,683,서시흥,송산마도,4304,32,33,21,116,197,4703,4371,30,44,13,116,227,4801,
20221009,685,684,서시흥,남안산,3450,92,84,116,53,233,4028,2004,76,73,141,63,155,2512,
20221009,704,583,근덕,동해,1168,8,29,3,15,47,1270,1088,4,20,1,20,54,1187,
20221009,705,190,남이천,동서울,1909,32,7,14,5,60,2027,1279,21,16,11,3,36,1366,
20221009,706,641,남경주,울산,1476,2,9,5,2,76,1570,1305,2,3,0,0,53,1363,
20221009,706,707,남경주,남포항,1992,6,31,3,24,98,2154,2038,10,30,2,26,98,2204,
20221009,707,641,남포항,울산,2134,4,24,14,24,90,2290,1787,8,21,4,21,73,1914,
20221009,707,648,남포항,해운대,1206,3,10,2,1,52,1274,1752,6,26,3,10,57,1854,
20221009,707,706,남포항,남경주,2038,10,30,2,26,98,2204,1992,6,31,3,24,98,2154,
20221009,707,708,남포항,동경주,2169,10,14,0,6,98,2297,2327,7,20,4,0,84,2442,
20221009,708,707,동경주,남포항,2327,7,20,4,0,84,2442,2169,10,14,0,6,98,2297,
20221009,715,749,동안동,영덕,1332,4,17,3,1,41,1398,1339,4,16,1,1,43,1404,
20221009,730,519,유천,남대구,1708,9,6,0,0,85,1808,1532,8,11,0,0,80,1631,
20221009,731,519,북현풍,남대구,1156,8,6,0,0,59,1229,1333,3,15,0,0,68,1419,
20221009,741,253,평택고덕,서서울,1016,8,4,6,6,58,1098,1664,8,1,2,6,105,1786,
20221009,749,715,영덕,동안동,1339,4,16,1,1,43,1404,1332,4,17,3,1,41,1398,
20221009,752,252,기장철마,대동,1684,14,11,1,7,108,1825,1550,6,13,1,11,98,1679,
20221009,755,252,광재,대동,1186,10,11,2,8,62,1279,1300,9,7,3,4,79,1402,
20221009,772,774,북달성,남칠곡,1817,14,22,6,7,91,1957,2155,11,18,8,3,92,2287,
20221009,773,774,북다사,남칠곡,940,3,4,1,2,50,1000,964,3,1,2,3,42,1015,
20221009,774,772,남칠곡,북달성,2155,11,18,8,3,92,2287,1817,14,22,6,7,91,1957,
20221009,774,773,남칠곡,북다사,964,3,1,2,3,42,1015,940,3,4,1,2,50,1000,
20221009,775,203,동명동호,가산,1509,10,9,4,3,57,1592,1759,8,6,3,3,69,1848,
20221009,776,777,연경,파군재,3984,15,6,3,1,194,4203,3345,11,10,1,1,154,3522,
20221009,776,779,연경,율암,4213,18,29,21,8,232,4521,4326,15,34,22,6,249,4652,
20221009,777,776,파군재,연경,3345,11,10,1,1,154,3522,3984,15,6,3,1,194,4203,
20221009,777,779,파군재,율암,2590,2,0,1,0,158,2751,2573,2,4,0,0,171,2750,
20221009,779,776,율암,연경,4326,15,34,22,6,249,4652,4213,18,29,21,8,232,4521,
20221009,779,777,율암,파군재,2573,2,4,0,0,171,2750,2590,2,0,1,0,158,2751,
20221009,876,677,양감,북평택,919,7,10,5,6,55,1002,3483,14,21,10,10,148,3686,
20221009,981,982,서영암,강진무위사,2033,9,67,19,11,62,2201,3069,12,73,40,10,74,3278,
20221009,981,987,서영암,남순천,2614,14,58,13,42,69,2810,2674,13,50,12,35,83,2867,
20221009,982,981,강진무위사,서영암,3069,12,73,40,10,74,3278,2033,9,67,19,11,62,2201,
20221009,982,987,강진무위사,남순천,1430,9,30,10,17,44,1540,1198,8,39,11,15,27,1298,
20221009,983,987,장흥,남순천,1083,8,43,5,4,21,1164,1026,9,26,1,8,30,1100,
20221009,984,985,보성,벌교,2013,14,26,3,7,57,2120,2334,13,28,4,6,59,2444,
20221009,984,987,보성,남순천,2499,13,46,33,46,74,2711,2421,18,32,11,47,53,2582,
20221009,985,984,벌교,보성,2334,13,28,4,6,59,2444,2013,14,26,3,7,57,2120,
20221009,986,987,고흥,남순천,5357,29,52,24,30,139,5631,4247,21,52,23,22,137,4502,
20221009,987,981,남순천,서영암,2674,13,50,12,35,83,2867,2614,14,58,13,42,69,2810,
20221009,987,982,남순천,강진무위사,1198,8,39,11,15,27,1298,1430,9,30,10,17,44,1540,
20221009,987,983,남순천,장흥,1026,9,26,1,8,30,1100,1083,8,43,5,4,21,1164,
20221009,987,984,남순천,보성,2421,18,32,11,47,53,2582,2499,13,46,33,46,74,2711,
20221009,987,986,남순천,고흥,4247,21,52,23,22,137,4502,5357,29,52,24,30,139,5631,
20221010,101,102,서울,동수원,2778,20,146,10,2,130,3086,3187,35,252,24,9,184,3691,
20221010,101,103,서울,수원신갈,10838,397,898,277,112,447,12969,9493,431,903,262,92,436,11617,
20221010,101,105,서울,기흥,4877,36,109,40,10,194,5266,4602,39,160,61,18,179,5059,
20221010,101,106,서울,오산,4735,274,321,127,58,302,5817,4131,332,339,126,62,241,5231,
20221010,101,107,서울,안성,3522,47,265,25,6,160,4025,2613,42,259,25,12,122,3073,
20221010,101,108,서울,천안,4923,29,299,17,6,187,5461,4220,31,319,22,10,161,4763,
20221010,101,171,서울,마성,1559,13,99,46,1,65,1783,1696,9,93,48,1,81,1928,
20221010,101,172,서울,용인,2682,111,60,27,20,187,3087,3153,104,56,23,22,198,3556,
20221010,101,173,서울,양지,2818,141,79,41,22,104,3205,3837,264,81,64,54,122,4422,
20221010,101,528,서울,기흥동탄,5983,32,409,100,10,246,6780,5480,25,421,104,8,230,6268,
20221010,101,542,서울,서안성,1345,20,72,81,26,54,1598,1472,27,66,111,19,74,1769,
20221010,101,543,서울,남안성,1129,44,47,54,60,42,1376,998,53,66,64,59,35,1275,
20221010,101,673,서울,북오산,1539,20,95,5,2,104,1765,1420,18,85,7,5,84,1619,
20221010,101,677,서울,북평택,1882,25,266,30,59,93,2355,2238,23,157,26,59,103,2606,
20221010,102,101,동수원,서울,3187,35,252,24,9,184,3691,2778,20,146,10,2,130,3086,
20221010,102,173,동수원,양지,957,27,17,4,8,53,1066,1174,25,14,7,1,58,1279,
20221010,102,212,동수원,북수원,2082,10,128,45,17,117,2399,2147,12,128,46,8,98,2439,
20221010,102,215,동수원,군포,959,10,8,0,8,51,1036,1378,8,7,1,1,66,1461,
20221010,102,253,동수원,서서울,4311,33,31,9,16,250,4650,4633,33,32,11,7,287,5003,
20221010,102,254,동수원,군자,3316,28,34,8,13,163,3562,4117,35,39,15,15,180,4401,
20221010,102,255,동수원,서안산,1010,27,5,5,4,47,1098,1141,20,13,8,3,60,1245,
20221010,103,101,수원신갈,서울,9493,431,903,262,92,436,11617,10838,397,898,277,112,447,12969,
20221010,103,105,수원신갈,기흥,1513,7,9,2,17,73,1621,2504,13,8,2,18,123,2668,
20221010,103,253,수원신갈,서서울,1484,85,46,39,4,83,1741,2037,78,56,37,11,121,2340,
20221010,103,254,수원신갈,군자,1304,61,27,29,44,69,1534,1888,74,39,54,49,95,2199,
20221010,103,528,수원신갈,기흥동탄,1015,8,15,1,0,52,1091,1270,10,11,0,0,72,1363,
20221010,105,101,기흥,서울,4602,39,160,61,18,179,5059,4877,36,109,40,10,194,5266,
20221010,105,103,기흥,수원신갈,2504,13,8,2,18,123,2668,1513,7,9,2,17,73,1621,
20221010,106,101,오산,서울,4131,332,339,126,62,241,5231,4735,274,321,127,58,302,5817,
20221010,107,101,안성,서울,2613,42,259,25,12,122,3073,3522,47,265,25,6,160,4025,
20221010,107,108,안성,천안,1675,12,25,3,4,86,1805,1536,17,27,2,1,87,1670,
20221010,107,742,안성,남사진위,927,23,32,15,7,55,1059,1139,26,35,19,3,69,1291,
20221010,108,101,천안,서울,4220,31,319,22,10,161,4763,4923,29,299,17,6,187,5461,
20221010,108,107,천안,안성,1536,17,27,2,1,87,1670,1675,12,25,3,4,86,1805,
20221010,108,229,천안,북천안,1367,27,57,31,17,67,1566,1860,44,77,25,24,91,2121,
20221010,112,115,남청주,대전,1013,63,46,6,3,69,1200,1135,73,42,5,1,77,1333,
20221010,114,153,남대전,서대전,1338,23,19,14,5,75,1474,1227,19,20,25,17,60,1368,
20221010,115,112,대전,남청주,1135,73,42,5,1,77,1333,1013,63,46,6,3,69,1200,
20221010,115,116,대전,옥천,1859,78,17,7,7,134,2102,1818,45,26,9,5,132,2035,
20221010,116,115,옥천,대전,1818,45,26,9,5,132,2035,1859,78,17,7,7,134,2102,
20221010,119,153,판암,서대전,1567,6,11,8,81,119,1792,1578,10,17,14,74,97,1790,
20221010,123,127,구미,서대구,1471,18,5,5,1,95,1595,1571,12,12,10,3,73,1681,
20221010,123,129,구미,북대구,1699,7,45,4,1,73,1829,1809,12,45,5,0,80,1951,
20221010,125,127,남구미,서대구,1411,20,40,11,11,99,1592,1719,23,40,21,5,111,1919,
20221010,125,129,남구미,북대구,1324,14,15,2,1,61,1417,1603,11,22,2,3,62,1703,
20221010,126,127,왜관,서대구,1994,80,45,18,56,111,2304,2169,78,37,11,62,96,2453,
20221010,126,129,왜관,북대구,2419,54,31,4,72,90,2670,2600,66,23,7,87,119,2902,
20221010,127,123,서대구,구미,1571,12,12,10,3,73,1681,1471,18,5,5,1,95,1595,
20221010,127,125,서대구,남구미,1719,23,40,21,5,111,1919,1411,20,40,11,11,99,1592,
20221010,127,126,서대구,왜관,2169,78,37,11,62,96,2453,1994,80,45,18,56,111,2304,
20221010,127,131,서대구,경산,1828,110,68,37,43,93,2179,1244,69,29,22,37,75,1476,
20221010,127,203,서대구,가산,2182,35,36,18,22,117,2410,1749,25,20,12,17,87,1910,
20221010,127,527,서대구,포항,1563,28,32,7,38,68,1736,1216,27,21,3,24,52,1343,
20221010,129,123,북대구,구미,1809,12,45,5,0,80,1951,1699,7,45,4,1,73,1829,
20221010,129,125,북대구,남구미,1603,11,22,2,3,62,1703,1324,14,15,2,1,61,1417,
20221010,129,126,북대구,왜관,2600,66,23,7,87,119,2902,2419,54,31,4,72,90,2670,
20221010,129,131,북대구,경산,1666,72,46,19,23,69,1895,2153,121,66,35,50,97,2522,
20221010,129,527,북대구,포항,1975,21,14,8,24,77,2119,2889,39,21,13,59,110,3131,
20221010,131,127,경산,서대구,1244,69,29,22,37,75,1476,1828,110,68,37,43,93,2179,
20221010,131,129,경산,북대구,2153,121,66,35,50,97,2522,1666,72,46,19,23,69,1895,
20221010,131,230,경산,팔공산,936,52,23,4,13,50,1078,1002,46,24,10,12,54,1148,
20221010,131,621,경산,동대구,1609,46,28,8,46,69,1806,1575,63,21,7,32,76,1774,
20221010,132,621,영천,동대구,919,6,18,3,39,30,1015,954,6,17,0,40,39,1056,
20221010,135,140,경주,부산,2507,14,14,5,13,111,2664,2307,12,15,2,15,92,2443,
20221010,135,252,경주,대동,1881,10,55,25,38,94,2103,2077,17,58,21,21,104,2298,
20221010,135,621,경주,동대구,1176,10,44,2,1,47,1280,1040,9,41,2,1,52,1145,
20221010,138,140,양산,부산,3875,187,98,28,62,162,4412,3603,207,99,31,55,164,4159,
20221010,138,252,양산,대동,1562,182,66,83,104,62,2059,1824,195,71,95,100,77,2362,
20221010,139,140,서울산,부산,2486,34,15,0,4,105,2644,1695,36,14,5,7,90,1847,
20221010,139,252,서울산,대동,1287,18,19,9,16,66,1415,1112,12,13,9,8,47,1201,
20221010,139,641,서울산,울산,1456,18,42,9,15,71,1611,1050,12,35,1,6,62,1166,
20221010,140,135,부산,경주,2307,12,15,2,15,92,2443,2507,14,14,5,13,111,2664,
20221010,140,138,부산,양산,3603,207,99,31,55,164,4159,3875,187,98,28,62,162,4412,
20221010,140,139,부산,서울산,1695,36,14,5,7,90,1847,2486,34,15,0,4,105,2644,
20221010,140,250,부산,남양산,6409,97,160,18,11,415,7110,6217,101,145,24,19,414,6920,
20221010,140,252,부산,대동,848,22,26,32,50,41,1019,978,20,20,15,48,48,1129,
20221010,140,286,부산,통도사휴게소,1147,11,3,0,0,34,1195,1168,8,2,0,0,36,1214,
20221010,142,145,군북,산인,4517,30,63,13,45,243,4911,3789,27,54,10,34,213,4127,
20221010,144,145,함안,산인,2372,26,17,13,31,155,2614,2361,25,19,9,31,146,2591,
20221010,145,142,산인,군북,3789,27,54,10,34,213,4127,4517,30,63,13,45,243,4911,
20221010,145,144,산인,함안,2361,25,19,9,31,146,2591,2372,26,17,13,31,155,2614,
20221010,145,291,산인,사천,1476,29,35,8,8,67,1623,2055,48,41,14,12,75,2245,
20221010,145,292,산인,진주,1708,16,143,7,4,83,1961,1941,16,135,2,6,93,2193,
20221010,145,293,산인,문산,1307,14,9,4,1,62,1397,1245,14,11,4,6,62,1342,
20221010,146,244,동창원,서부산,1237,15,22,13,11,71,1369,1320,17,17,9,14,78,1455,
20221010,146,289,동창원,마산,1933,44,27,15,30,149,2198,2094,50,31,19,15,150,2359,
20221010,147,244,진례,서부산,946,48,22,23,14,78,1131,1085,49,29,21,13,76,1273,
20221010,148,150,서김해,북부산,5601,78,55,24,28,368,6154,5315,73,50,22,24,364,5848,
20221010,148,289,서김해,마산,1359,13,40,2,1,75,1490,1657,13,36,7,5,98,1816,
20221010,149,150,동김해,북부산,8661,136,102,34,59,625,9617,7537,113,85,28,37,524,8324,
20221010,150,148,북부산,서김해,5315,73,50,22,24,364,5848,5601,78,55,24,28,368,6154,
20221010,150,149,북부산,동김해,7537,113,85,28,37,524,8324,8661,136,102,34,59,625,9617,
20221010,150,245,북부산,장유,3580,22,64,10,23,240,3939,2722,28,66,3,12,165,2996,
20221010,150,289,북부산,마산,2753,13,56,2,4,99,2927,4211,20,67,6,4,147,4455,
20221010,153,114,서대전,남대전,1227,19,20,25,17,60,1368,1338,23,19,14,5,75,1474,
20221010,153,119,서대전,판암,1578,10,17,14,74,97,1790,1567,6,11,8,81,119,1792,
20221010,159,167,서전주,광주,1600,31,44,16,16,55,1762,1693,39,34,19,14,56,1855,
20221010,166,167,장성,광주,3126,52,54,9,14,122,3377,3432,67,47,10,2,119,3677,
20221010,167,159,광주,서전주,1693,39,34,19,14,56,1855,1600,31,44,16,16,55,1762,
20221010,167,166,광주,장성,3432,67,47,10,2,119,3677,3126,52,54,9,14,122,3377,
20221010,167,567,광주,남고창,1494,20,37,3,12,55,1621,1659,21,27,5,9,63,1784,
20221010,171,101,마성,서울,1696,9,93,48,1,81,1928,1559,13,99,46,1,65,1783,
20221010,172,101,용인,서울,3153,104,56,23,22,198,3556,2682,111,60,27,20,187,3087,
20221010,172,173,용인,양지,1149,121,59,39,35,73,1476,1016,85,41,33,44,60,1279,
20221010,172,253,용인,서서울,948,21,11,17,10,43,1050,980,38,6,12,10,52,1098,
20221010,173,101,양지,서울,3837,264,81,64,54,122,4422,2818,141,79,41,22,104,3205,
20221010,173,102,양지,동수원,1174,25,14,7,1,58,1279,957,27,17,4,8,53,1066,
20221010,173,172,양지,용인,1016,85,41,33,44,60,1279,1149,121,59,39,35,73,1476,
20221010,173,212,양지,북수원,1164,37,19,12,21,45,1298,868,51,26,20,22,41,1028,
20221010,173,253,양지,서서울,1313,55,32,44,21,41,1506,952,60,30,44,18,49,1153,
20221010,174,179,춘천,홍천,3394,47,80,63,11,208,3803,2448,39,59,57,8,196,2807,
20221010,174,218,춘천,남원주,1137,21,47,7,4,65,1281,1182,11,53,8,4,70,1328,
20221010,174,554,춘천,동홍천,916,11,9,6,2,62,1006,1016,8,16,3,2,70,1115,
20221010,176,190,이천,동서울,1331,35,59,13,21,51,1510,1518,30,79,43,42,73,1785,
20221010,179,174,홍천,춘천,2448,39,59,57,8,196,2807,3394,47,80,63,11,208,3803,
20221010,184,189,대관령,강릉,1262,33,54,2,6,64,1421,1393,29,49,6,5,56,1538,
20221010,189,184,강릉,대관령,1393,29,49,6,5,56,1538,1262,33,54,2,6,64,1421,
20221010,190,176,동서울,이천,1518,30,79,43,42,73,1785,1331,35,59,13,21,51,1510,
20221010,190,191,동서울,경기광주,8957,324,276,118,65,498,10238,7621,282,264,109,66,390,8732,
20221010,190,192,동서울,곤지암,3752,261,107,96,38,207,4461,3224,201,75,93,17,160,3770,
20221010,190,193,동서울,일죽,2384,53,114,69,52,90,2762,2528,48,78,82,48,85,2869,
20221010,190,194,동서울,서이천,3807,385,216,132,69,192,4801,2897,260,169,101,47,152,3626,
20221010,190,198,동서울,서청주,1136,11,24,9,7,50,1237,1010,7,12,13,4,39,1085,
20221010,190,560,동서울,감곡,889,8,12,22,44,28,1003,1093,9,10,16,69,40,1237,
20221010,190,705,동서울,남이천,1270,48,33,42,17,36,1446,1859,47,19,29,12,39,2005,
20221010,191,190,경기광주,동서울,7621,282,264,109,66,390,8732,8957,324,276,118,65,498,10238,
20221010,192,190,곤지암,동서울,3224,201,75,93,17,160,3770,3752,261,107,96,38,207,4461,
20221010,192,194,곤지암,서이천,1284,168,63,94,71,73,1753,1258,69,56,104,77,68,1632,
20221010,193,190,일죽,동서울,2528,48,78,82,48,85,2869,2384,53,114,69,52,90,2762,
20221010,194,190,서이천,동서울,2897,260,169,101,47,152,3626,3807,385,216,132,69,192,4801,
20221010,194,192,서이천,곤지암,1258,69,56,104,77,68,1632,1284,168,63,94,71,73,1753,
20221010,198,190,서청주,동서울,1010,7,12,13,4,39,1085,1136,11,24,9,7,50,1237,
20221010,201,203,칠곡,가산,773,26,16,20,152,47,1034,724,26,25,22,173,40,1010,
20221010,203,127,가산,서대구,1749,25,20,12,17,87,1910,2182,35,36,18,22,117,2410,
20221010,203,201,가산,칠곡,724,26,25,22,173,40,1010,773,26,16,20,152,47,1034,
20221010,203,775,가산,동명동호,1547,29,19,21,180,48,1844,1844,34,24,18,152,51,2123,
20221010,212,102,북수원,동수원,2147,12,128,46,8,98,2439,2082,10,128,45,17,117,2399,
20221010,212,173,북수원,양지,868,51,26,20,22,41,1028,1164,37,19,12,21,45,1298,
20221010,212,254,북수원,군자,1569,22,18,9,6,70,1694,1289,19,17,14,13,57,1409,
20221010,213,253,부곡,서서울,1078,50,21,15,48,71,1283,974,48,15,26,39,69,1171,
20221010,215,102,군포,동수원,1378,8,7,1,1,66,1461,959,10,8,0,8,51,1036,
20221010,215,253,군포,서서울,2557,38,35,7,26,149,2812,2661,58,73,45,32,165,3034,
20221010,215,254,군포,군자,1742,21,26,8,25,98,1920,2033,47,21,38,40,122,2301,
20221010,218,174,남원주,춘천,1182,11,53,8,4,70,1328,1137,21,47,7,4,65,1281,
20221010,218,240,남원주,제천,1720,20,32,3,39,97,1911,1689,37,33,7,23,102,1891,
20221010,229,108,북천안,천안,1860,44,77,25,24,91,2121,1367,27,57,31,17,67,1566,
20221010,230,131,팔공산,경산,1002,46,24,10,12,54,1148,936,52,23,4,13,50,1078,
20221010,230,527,팔공산,포항,1927,13,8,6,11,91,2056,2004,18,7,3,13,76,2121,
20221010,231,519,화원옥포,남대구,5224,108,73,21,115,345,5886,5133,101,67,19,50,350,5720,
20221010,232,519,달성,남대구,1757,68,60,23,7,111,2026,1935,72,66,20,4,107,2204,
20221010,233,519,현풍,남대구,3562,105,86,35,55,218,4061,3271,97,80,61,64,194,3767,
20221010,238,239,칠서,칠원,1113,38,38,55,272,61,1577,1032,39,35,36,270,60,1472,
20221010,239,238,칠원,칠서,1032,39,35,36,270,60,1472,1113,38,38,55,272,61,1577,
20221010,239,519,칠원,남대구,1769,26,71,20,21,68,1975,1771,35,69,16,16,83,1990,
20221010,240,218,제천,남원주,1689,37,33,7,23,102,1891,1720,20,32,3,39,97,1911,
20221010,241,519,동고령,남대구,3315,63,64,26,130,151,3749,2760,53,54,20,133,133,3153,
20221010,242,519,고령,남대구,2844,25,50,12,110,112,3153,2845,24,48,8,118,134,3177,
20221010,244,146,서부산,동창원,1320,17,17,9,14,78,1455,1237,15,22,13,11,71,1369,
20221010,244,147,서부산,진례,1085,49,29,21,13,76,1273,946,48,22,23,14,78,1131,
20221010,244,245,서부산,장유,12436,120,274,47,60,834,13771,11598,114,257,45,69,772,12855,
20221010,244,289,서부산,마산,3716,33,252,8,16,155,4180,4500,50,260,13,21,177,5021,
20221010,245,150,장유,북부산,2722,28,66,3,12,165,2996,3580,22,64,10,23,240,3939,
20221010,245,244,장유,서부산,11598,114,257,45,69,772,12855,12436,120,274,47,60,834,13771,
20221010,245,289,장유,마산,1325,19,27,9,13,91,1484,1991,20,30,17,3,100,2161,
20221010,248,261,순창,동광주,1660,12,21,4,52,43,1792,1594,17,24,4,37,43,1719,
20221010,249,261,담양,동광주,2694,26,95,9,9,92,2925,2386,20,95,7,9,77,2594,
20221010,250,140,남양산,부산,6217,101,145,24,19,414,6920,6409,97,160,18,11,415,7110,
20221010,250,252,남양산,대동,2343,82,54,30,40,156,2705,3259,103,63,34,32,216,3707,
20221010,251,252,물금,대동,2382,142,32,41,225,158,2980,3380,160,32,36,191,225,4024,
20221010,252,135,대동,경주,2077,17,58,21,21,104,2298,1881,10,55,25,38,94,2103,
20221010,252,138,대동,양산,1824,195,71,95,100,77,2362,1562,182,66,83,104,62,2059,
20221010,252,139,대동,서울산,1112,12,13,9,8,47,1201,1287,18,19,9,16,66,1415,
20221010,252,140,대동,부산,978,20,20,15,48,48,1129,848,22,26,32,50,41,1019,
20221010,252,250,대동,남양산,3259,103,63,34,32,216,3707,2343,82,54,30,40,156,2705,
20221010,252,251,대동,물금,3380,160,32,36,191,225,4024,2382,142,32,41,225,158,2980,
20221010,252,641,대동,울산,2039,24,43,16,38,108,2268,1474,35,45,14,46,85,1699,
20221010,252,752,대동,기장철마,1650,25,26,14,47,132,1894,1540,32,28,7,36,117,1760,
20221010,252,755,대동,광재,1835,38,46,27,163,97,2206,1667,36,31,29,226,95,2084,
20221010,253,102,서서울,동수원,4633,33,32,11,7,287,5003,4311,33,31,9,16,250,4650,
20221010,253,103,서서울,수원신갈,2037,78,56,37,11,121,2340,1484,85,46,39,4,83,1741,
20221010,253,172,서서울,용인,980,38,6,12,10,52,1098,948,21,11,17,10,43,1050,
20221010,253,173,서서울,양지,952,60,30,44,18,49,1153,1313,55,32,44,21,41,1506,
20221010,253,213,서서울,부곡,974,48,15,26,39,69,1171,1078,50,21,15,48,71,1283,
20221010,253,215,서서울,군포,2661,58,73,45,32,165,3034,2557,38,35,7,26,149,2812,
20221010,253,255,서서울,서안산,8577,172,99,146,133,473,9600,8167,169,73,119,158,441,9127,
20221010,253,256,서서울,안산,6771,82,40,17,21,422,7353,4261,44,24,15,41,274,4659,
20221010,253,281,서서울,매송,2762,31,13,6,22,166,3000,2449,21,10,6,34,137,2657,
20221010,253,282,서서울,비봉,4131,96,70,71,387,225,4980,4078,101,63,67,418,225,4952,
20221010,253,283,서서울,발안,3405,64,27,42,183,215,3936,2369,67,44,39,136,143,2798,
20221010,253,285,서서울,서평택,1966,16,34,49,169,108,2342,1311,23,30,67,193,81,1705,
20221010,253,287,서서울,송악,2630,6,30,34,124,112,2936,3228,15,26,39,216,110,3634,
20221010,253,288,서서울,당진,1952,13,32,18,9,80,2104,1760,12,36,24,20,90,1942,
20221010,253,298,서서울,서산,2844,13,40,23,14,125,3059,4297,12,33,24,14,141,4521,
20221010,253,520,서서울,평택,4067,29,54,52,81,173,4456,3566,31,33,52,35,140,3857,
20221010,253,540,서서울,청북,916,15,10,10,28,45,1024,915,21,8,14,37,43,1038,
20221010,254,102,군자,동수원,4117,35,39,15,15,180,4401,3316,28,34,8,13,163,3562,
20221010,254,103,군자,수원신갈,1888,74,39,54,49,95,2199,1304,61,27,29,44,69,1534,
20221010,254,212,군자,북수원,1289,19,17,14,13,57,1409,1569,22,18,9,6,70,1694,
20221010,254,215,군자,군포,2033,47,21,38,40,122,2301,1742,21,26,8,25,98,1920,
20221010,254,255,군자,서안산,6184,117,39,56,93,397,6886,7611,142,52,92,102,495,8494,
20221010,254,256,군자,안산,3757,68,83,20,24,234,4186,4353,53,85,27,37,280,4835,
20221010,255,102,서안산,동수원,1141,20,13,8,3,60,1245,1010,27,5,5,4,47,1098,
20221010,255,253,서안산,서서울,8167,169,73,119,158,441,9127,8577,172,99,146,133,473,9600,
20221010,255,254,서안산,군자,7611,142,52,92,102,495,8494,6184,117,39,56,93,397,6886,
20221010,256,253,안산,서서울,4261,44,24,15,41,274,4659,6771,82,40,17,21,422,7353,
20221010,256,254,안산,군자,4353,53,85,27,37,280,4835,3757,68,83,20,24,234,4186,
20221010,261,248,동광주,순창,1594,17,24,4,37,43,1719,1660,12,21,4,52,43,1792,
20221010,261,249,동광주,담양,2386,20,95,7,9,77,2594,2694,26,95,9,9,92,2925,
20221010,261,262,동광주,창평,1699,61,20,14,3,60,1857,1894,51,20,14,8,60,2047,
20221010,261,263,동광주,옥과,2227,12,82,13,58,88,2480,2296,7,82,7,61,94,2547,
20221010,261,265,동광주,곡성,1486,12,33,7,20,39,1597,1685,16,29,11,14,50,1805,
20221010,261,270,동광주,서순천,1018,22,58,1,6,32,1137,954,22,56,4,8,21,1065,
20221010,261,271,동광주,순천,3841,68,81,20,37,101,4148,3683,72,73,9,24,120,3981,
20221010,262,261,창평,동광주,1894,51,20,14,8,60,2047,1699,61,20,14,3,60,1857,
20221010,263,261,옥과,동광주,2296,7,82,7,61,94,2547,2227,12,82,13,58,88,2480,
20221010,265,261,곡성,동광주,1685,16,29,11,14,50,1805,1486,12,33,7,20,39,1597,
20221010,270,261,서순천,동광주,954,22,56,4,8,21,1065,1018,22,58,1,6,32,1137,
20221010,271,261,순천,동광주,3683,72,73,9,24,120,3981,3841,68,81,20,37,101,4148,
20221010,280,519,거창,남대구,1681,16,38,7,4,55,1801,1601,22,50,3,5,66,1747,
20221010,281,253,매송,서서울,2449,21,10,6,34,137,2657,2762,31,13,6,22,166,3000,
20221010,282,253,비봉,서서울,4078,101,63,67,418,225,4952,4131,96,70,71,387,225,4980,
20221010,283,253,발안,서서울,2369,67,44,39,136,143,2798,3405,64,27,42,183,215,3936,
20221010,285,253,서평택,서서울,1311,23,30,67,193,81,1705,1966,16,34,49,169,108,2342,
20221010,286,140,통도사휴게소,부산,1168,8,2,0,0,36,1214,1147,11,3,0,0,34,1195,
20221010,287,253,송악,서서울,3228,15,26,39,216,110,3634,2630,6,30,34,124,112,2936,
20221010,288,253,당진,서서울,1760,12,36,24,20,90,1942,1952,13,32,18,9,80,2104,
20221010,289,146,마산,동창원,2094,50,31,19,15,150,2359,1933,44,27,15,30,149,2198,
20221010,289,148,마산,서김해,1657,13,36,7,5,98,1816,1359,13,40,2,1,75,1490,
20221010,289,150,마산,북부산,4211,20,67,6,4,147,4455,2753,13,56,2,4,99,2927,
20221010,289,244,마산,서부산,4500,50,260,13,21,177,5021,3716,33,252,8,16,155,4180,
20221010,289,245,마산,장유,1991,20,30,17,3,100,2161,1325,19,27,9,13,91,1484,
20221010,291,145,사천,산인,2055,48,41,14,12,75,2245,1476,29,35,8,8,67,1623,
20221010,291,292,사천,진주,1794,35,37,17,17,139,2039,2271,51,51,23,21,158,2575,
20221010,292,145,진주,산인,1941,16,135,2,6,93,2193,1708,16,143,7,4,83,1961,
20221010,292,291,진주,사천,2271,51,51,23,21,158,2575,1794,35,37,17,17,139,2039,
20221010,292,516,진주,통영,970,11,18,2,0,65,1066,1000,24,16,2,2,51,1095,
20221010,293,145,문산,산인,1245,14,11,4,6,62,1342,1307,14,9,4,1,62,1397,
20221010,298,253,서산,서서울,4297,12,33,24,14,141,4521,2844,13,40,23,14,125,3059,
20221010,508,509,무안,목포,1050,34,34,10,12,45,1185,1328,24,35,15,23,62,1487,
20221010,508,553,무안,동광산,1369,15,21,9,14,38,1466,1584,18,31,14,15,57,1719,
20221010,509,508,목포,무안,1328,24,35,15,23,62,1487,1050,34,34,10,12,45,1185,
20221010,509,553,목포,동광산,8056,112,149,94,107,244,8762,8437,98,174,83,93,282,9167,
20221010,513,515,고성,북통영,1667,23,55,8,15,90,1858,2371,25,62,8,13,140,2619,
20221010,513,516,고성,통영,3616,57,68,20,53,231,4045,4493,56,64,28,49,255,4945,
20221010,514,516,동고성,통영,1183,15,21,11,39,110,1379,1145,9,18,9,55,119,1355,
20221010,515,513,북통영,고성,2371,25,62,8,13,140,2619,1667,23,55,8,15,90,1858,
20221010,516,292,통영,진주,1000,24,16,2,2,51,1095,970,11,18,2,0,65,1066,
20221010,516,513,통영,고성,4493,56,64,28,49,255,4945,3616,57,68,20,53,231,4045,
20221010,516,514,통영,동고성,1145,9,18,9,55,119,1355,1183,15,21,11,39,110,1379,
20221010,519,231,남대구,화원옥포,5133,101,67,19,50,350,5720,5224,108,73,21,115,345,5886,
20221010,519,232,남대구,달성,1935,72,66,20,4,107,2204,1757,68,60,23,7,111,2026,
20221010,519,233,남대구,현풍,3271,97,80,61,64,194,3767,3562,105,86,35,55,218,4061,
20221010,519,239,남대구,칠원,1771,35,69,16,16,83,1990,1769,26,71,20,21,68,1975,
20221010,519,241,남대구,동고령,2760,53,54,20,133,133,3153,3315,63,64,26,130,151,3749,
20221010,519,242,남대구,고령,2845,24,48,8,118,134,3177,2844,25,50,12,110,112,3153,
20221010,519,280,남대구,거창,1601,22,50,3,5,66,1747,1681,16,38,7,4,55,1801,
20221010,519,730,남대구,유천,1884,28,8,0,6,112,2038,2208,29,4,0,0,131,2372,
20221010,519,731,남대구,북현풍,1629,10,14,0,0,81,1734,1386,9,4,0,0,85,1484,
20221010,520,253,평택,서서울,3566,31,33,52,35,140,3857,4067,29,54,52,81,173,4456,
20221010,526,527,서포항,포항,1093,11,12,3,13,57,1189,962,8,11,5,7,68,1061,
20221010,527,127,포항,서대구,1216,27,21,3,24,52,1343,1563,28,32,7,38,68,1736,
20221010,527,129,포항,북대구,2889,39,21,13,59,110,3131,1975,21,14,8,24,77,2119,
20221010,527,230,포항,팔공산,2004,18,7,3,13,76,2121,1927,13,8,6,11,91,2056,
20221010,527,526,포항,서포항,962,8,11,5,7,68,1061,1093,11,12,3,13,57,1189,
20221010,528,101,기흥동탄,서울,5480,25,421,104,8,230,6268,5983,32,409,100,10,246,6780,
20221010,528,103,기흥동탄,수원신갈,1270,10,11,0,0,72,1363,1015,8,15,1,0,52,1091,
20221010,540,253,청북,서서울,915,21,8,14,37,43,1038,916,15,10,10,28,45,1024,
20221010,542,101,서안성,서울,1472,27,66,111,19,74,1769,1345,20,72,81,26,54,1598,
20221010,543,101,남안성,서울,998,53,66,64,59,35,1275,1129,44,47,54,60,42,1376,
20221010,548,553,북무안,동광산,2147,17,26,14,5,68,2277,1931,18,32,19,6,47,2053,
20221010,549,553,동함평,동광산,3170,13,39,18,27,101,3368,3058,28,45,28,31,112,3302,
20221010,551,553,나주,동광산,1262,15,14,10,23,51,1375,1028,16,8,10,24,48,1134,
20221010,552,553,서광산,동광산,3555,118,130,117,107,103,4130,4209,123,153,118,102,121,4826,
20221010,553,508,동광산,무안,1584,18,31,14,15,57,1719,1369,15,21,9,14,38,1466,
20221010,553,509,동광산,목포,8437,98,174,83,93,282,9167,8056,112,149,94,107,244,8762,
20221010,553,548,동광산,북무안,1931,18,32,19,6,47,2053,2147,17,26,14,5,68,2277,
20221010,553,549,동광산,동함평,3058,28,45,28,31,112,3302,3170,13,39,18,27,101,3368,
20221010,553,551,동광산,나주,1028,16,8,10,24,48,1134,1262,15,14,10,23,51,1375,
20221010,553,552,동광산,서광산,4209,123,153,118,102,121,4826,3555,118,130,117,107,103,4130,
20221010,554,174,동홍천,춘천,1016,8,16,3,2,70,1115,916,11,9,6,2,62,1006,
20221010,556,557,동순천,황전,1220,6,15,3,16,28,1288,1050,5,8,1,13,41,1118,
20221010,557,556,황전,동순천,1050,5,8,1,13,41,1118,1220,6,15,3,16,28,1288,
20221010,560,190,감곡,동서울,1093,9,10,16,69,40,1237,889,8,12,22,44,28,1003,
20221010,567,167,남고창,광주,1659,21,27,5,9,63,1784,1494,20,37,3,12,55,1621,
20221010,583,704,동해,근덕,1024,7,29,5,74,63,1202,1039,7,24,3,42,67,1182,
20221010,621,131,동대구,경산,1575,63,21,7,32,76,1774,1609,46,28,8,46,69,1806,
20221010,621,132,동대구,영천,954,6,17,0,40,39,1056,919,6,18,3,39,30,1015,
20221010,621,135,동대구,경주,1040,9,41,2,1,52,1145,1176,10,44,2,1,47,1280,
20221010,625,626,밀양,남밀양,1979,32,23,19,69,74,2196,1559,35,26,19,82,61,1782,
20221010,626,625,남밀양,밀양,1559,35,26,19,82,61,1782,1979,32,23,19,69,74,2196,
20221010,641,139,울산,서울산,1050,12,35,1,6,62,1166,1456,18,42,9,15,71,1611,
20221010,641,252,울산,대동,1474,35,45,14,46,85,1699,2039,24,43,16,38,108,2268,
20221010,641,648,울산,해운대,1046,2,3,1,0,49,1101,1367,6,6,1,0,65,1445,
20221010,641,706,울산,남경주,1277,9,7,2,7,48,1350,1606,6,13,6,14,70,1715,
20221010,641,707,울산,남포항,1567,17,19,10,107,76,1796,2080,19,20,29,92,90,2330,
20221010,643,648,청량,해운대,3062,8,15,3,11,181,3280,4119,20,49,17,132,212,4549,
20221010,645,648,장안,해운대,1505,5,6,0,1,72,1589,3427,14,9,104,53,169,3776,
20221010,646,648,기장일광,해운대,4780,10,8,49,1,258,5106,5593,20,9,9,43,298,5972,
20221010,648,641,해운대,울산,1367,6,6,1,0,65,1445,1046,2,3,1,0,49,1101,
20221010,648,643,해운대,청량,4119,20,49,17,132,212,4549,3062,8,15,3,11,181,3280,
20221010,648,645,해운대,장안,3427,14,9,104,53,169,3776,1505,5,6,0,1,72,1589,
20221010,648,646,해운대,기장일광,5593,20,9,9,43,298,5972,4780,10,8,49,1,258,5106,
20221010,648,707,해운대,남포항,1500,5,32,5,20,70,1632,1308,4,7,2,4,47,1372,
20221010,651,652,남양주,화도,11180,254,302,252,86,680,12754,13798,240,338,291,82,780,15529,
20221010,651,653,남양주,서종,1881,7,6,0,1,82,1977,4158,12,10,4,0,128,4312,
20221010,651,654,남양주,설악,3743,22,70,17,3,132,3987,4556,13,45,18,4,135,4771,
20221010,651,655,남양주,강촌,2389,24,98,18,32,70,2631,2775,14,63,15,32,97,2996,
20221010,651,656,남양주,남춘천,2710,21,35,26,17,75,2884,2088,9,15,9,24,38,2183,
20221010,652,651,화도,남양주,13798,240,338,291,82,780,15529,11180,254,302,252,86,680,12754,
20221010,652,653,화도,서종,1095,19,4,6,6,74,1204,2347,22,4,4,8,136,2521,
20221010,652,654,화도,설악,970,15,4,1,1,65,1056,1230,10,9,4,1,53,1307,
20221010,653,651,서종,남양주,4158,12,10,4,0,128,4312,1881,7,6,0,1,82,1977,
20221010,653,652,서종,화도,2347,22,4,4,8,136,2521,1095,19,4,6,6,74,1204,
20221010,654,651,설악,남양주,4556,13,45,18,4,135,4771,3743,22,70,17,3,132,3987,
20221010,654,652,설악,화도,1230,10,9,4,1,53,1307,970,15,4,1,1,65,1056,
20221010,655,651,강촌,남양주,2775,14,63,15,32,97,2996,2389,24,98,18,32,70,2631,
20221010,656,651,남춘천,남양주,2088,9,15,9,24,38,2183,2710,21,35,26,17,75,2884,
20221010,671,672,봉담,정남,1741,75,24,41,81,106,2068,1825,56,25,31,103,111,2151,
20221010,671,673,봉담,북오산,1405,26,20,8,7,86,1552,1518,16,22,11,9,98,1674,
20221010,671,677,봉담,북평택,7816,48,74,55,94,387,8474,9023,68,75,61,60,406,9693,
20221010,672,671,정남,봉담,1825,56,25,31,103,111,2151,1741,75,24,41,81,106,2068,
20221010,673,101,북오산,서울,1420,18,85,7,5,84,1619,1539,20,95,5,2,104,1765,
20221010,673,671,북오산,봉담,1518,16,22,11,9,98,1674,1405,26,20,8,7,86,1552,
20221010,673,677,북오산,북평택,1642,12,22,7,10,93,1786,1801,21,21,8,5,67,1923,
20221010,675,676,서오산,향남,1692,37,22,23,30,89,1893,1384,40,24,12,22,73,1555,
20221010,675,677,서오산,북평택,8916,86,158,65,107,492,9824,12429,111,131,81,92,525,13369,
20221010,676,675,향남,서오산,1384,40,24,12,22,73,1555,1692,37,22,23,30,89,1893,
20221010,676,677,향남,북평택,1002,71,51,84,61,68,1337,1455,70,45,75,44,72,1761,
20221010,677,101,북평택,서울,2238,23,157,26,59,103,2606,1882,25,266,30,59,93,2355,
20221010,677,671,북평택,봉담,9023,68,75,61,60,406,9693,7816,48,74,55,94,387,8474,
20221010,677,673,북평택,북오산,1801,21,21,8,5,67,1923,1642,12,22,7,10,93,1786,
20221010,677,675,북평택,서오산,12429,111,131,81,92,525,13369,8916,86,158,65,107,492,9824,
20221010,677,676,북평택,향남,1455,70,45,75,44,72,1761,1002,71,51,84,61,68,1337,
20221010,677,876,북평택,양감,2758,46,38,64,58,136,3100,1047,34,31,71,61,57,1301,
20221010,682,685,조암,서시흥,907,46,53,37,84,43,1170,1531,49,68,43,112,79,1882,
20221010,683,684,송산마도,남안산,1531,48,37,38,91,89,1834,1622,51,37,26,86,86,1908,
20221010,683,685,송산마도,서시흥,3637,65,74,48,651,192,4667,4143,68,77,59,681,234,5262,
20221010,684,683,남안산,송산마도,1622,51,37,26,86,86,1908,1531,48,37,38,91,89,1834,
20221010,684,685,남안산,서시흥,2430,152,118,232,184,164,3280,4261,145,142,221,205,271,5245,
20221010,685,682,서시흥,조암,1531,49,68,43,112,79,1882,907,46,53,37,84,43,1170,
20221010,685,683,서시흥,송산마도,4143,68,77,59,681,234,5262,3637,65,74,48,651,192,4667,
20221010,685,684,서시흥,남안산,4261,145,142,221,205,271,5245,2430,152,118,232,184,164,3280,
20221010,704,583,근덕,동해,1039,7,24,3,42,67,1182,1024,7,29,5,74,63,1202,
20221010,705,190,남이천,동서울,1859,47,19,29,12,39,2005,1270,48,33,42,17,36,1446,
20221010,706,641,남경주,울산,1606,6,13,6,14,70,1715,1277,9,7,2,7,48,1350,
20221010,706,707,남경주,남포항,1416,23,31,11,124,72,1677,1672,26,34,10,97,81,1920,
20221010,707,641,남포항,울산,2080,19,20,29,92,90,2330,1567,17,19,10,107,76,1796,
20221010,707,648,남포항,해운대,1308,4,7,2,4,47,1372,1500,5,32,5,20,70,1632,
20221010,707,706,남포항,남경주,1672,26,34,10,97,81,1920,1416,23,31,11,124,72,1677,
20221010,707,708,남포항,동경주,1862,19,14,8,212,77,2192,1933,14,20,14,222,98,2301,
20221010,708,707,동경주,남포항,1933,14,20,14,222,98,2301,1862,19,14,8,212,77,2192,
20221010,730,519,유천,남대구,2208,29,4,0,0,131,2372,1884,28,8,0,6,112,2038,
20221010,731,519,북현풍,남대구,1386,9,4,0,0,85,1484,1629,10,14,0,0,81,1734,
20221010,742,107,남사진위,안성,1139,26,35,19,3,69,1291,927,23,32,15,7,55,1059,
20221010,752,252,기장철마,대동,1540,32,28,7,36,117,1760,1650,25,26,14,47,132,1894,
20221010,755,252,광재,대동,1667,36,31,29,226,95,2084,1835,38,46,27,163,97,2206,
20221010,772,774,북달성,남칠곡,1865,20,25,16,22,94,2042,2179,23,29,17,29,96,2373,
20221010,773,774,북다사,남칠곡,1065,17,10,1,8,46,1147,1120,12,6,5,12,48,1203,
20221010,774,772,남칠곡,북달성,2179,23,29,17,29,96,2373,1865,20,25,16,22,94,2042,
20221010,774,773,남칠곡,북다사,1120,12,6,5,12,48,1203,1065,17,10,1,8,46,1147,
20221010,775,203,동명동호,가산,1844,34,24,18,152,51,2123,1547,29,19,21,180,48,1844,
20221010,776,777,연경,파군재,3598,30,18,7,9,212,3874,3460,26,13,6,19,166,3690,
20221010,776,779,연경,율암,4641,52,26,31,46,250,5046,4800,59,38,39,58,248,5242,
20221010,777,776,파군재,연경,3460,26,13,6,19,166,3690,3598,30,18,7,9,212,3874,
20221010,777,779,파군재,율암,2652,9,8,4,6,184,2863,2612,3,9,4,6,170,2804,
20221010,779,776,율암,연경,4800,59,38,39,58,248,5242,4641,52,26,31,46,250,5046,
20221010,779,777,율암,파군재,2612,3,9,4,6,170,2804,2652,9,8,4,6,184,2863,
20221010,876,677,양감,북평택,1047,34,31,71,61,57,1301,2758,46,38,64,58,136,3100,
20221010,981,982,서영암,강진무위사,1766,20,78,31,23,65,1983,3334,31,86,50,28,94,3623,
20221010,981,987,서영암,남순천,2428,18,45,35,113,75,2714,2658,24,44,31,127,99,2983,
20221010,982,981,강진무위사,서영암,3334,31,86,50,28,94,3623,1766,20,78,31,23,65,1983,
20221010,982,987,강진무위사,남순천,1263,12,19,26,45,42,1407,1089,13,13,10,56,44,1225,
20221010,983,987,장흥,남순천,1036,8,16,6,10,34,1110,977,6,18,5,7,35,1048,
20221010,984,985,보성,벌교,1601,28,30,11,20,40,1730,2065,38,30,20,12,50,2215,
20221010,984,987,보성,남순천,2329,26,56,45,121,69,2646,2232,24,45,37,119,58,2515,
20221010,985,984,벌교,보성,2065,38,30,20,12,50,2215,1601,28,30,11,20,40,1730,
20221010,986,987,고흥,남순천,5129,46,68,100,87,165,5595,3813,53,53,74,102,143,4238,
20221010,987,981,남순천,서영암,2658,24,44,31,127,99,2983,2428,18,45,35,113,75,2714,
20221010,987,982,남순천,강진무위사,1089,13,13,10,56,44,1225,1263,12,19,26,45,42,1407,
20221010,987,983,남순천,장흥,977,6,18,5,7,35,1048,1036,8,16,6,10,34,1110,
20221010,987,984,남순천,보성,2232,24,45,37,119,58,2515,2329,26,56,45,121,69,2646,
20221010,987,986,남순천,고흥,3813,53,53,74,102,143,4238,5129,46,68,100,87,165,5595,
20221011,101,102,서울,동수원,4136,47,261,15,4,243,4706,4985,50,370,27,8,283,5723,
20221011,101,103,서울,수원신갈,16131,620,1620,422,114,819,19726,14384,653,1622,376,122,701,17858,
20221011,101,105,서울,기흥,7512,101,406,70,20,367,8476,5897,94,363,94,33,292,6773,
20221011,101,106,서울,오산,4623,377,444,164,87,327,6022,4292,412,458,169,102,321,5754,
20221011,101,107,서울,안성,3351,88,303,40,18,196,3996,2853,78,277,50,27,160,3445,
20221011,101,108,서울,천안,4009,48,333,30,12,173,4605,3856,51,346,41,17,157,4468,
20221011,101,111,서울,청주,1017,9,192,16,34,40,1308,857,19,207,26,33,40,1182,
20221011,101,171,서울,마성,2187,30,222,51,0,108,2598,2436,29,235,57,1,111,2869,
20221011,101,172,서울,용인,3501,141,124,40,26,214,4046,3751,152,113,44,31,235,4326,
20221011,101,173,서울,양지,3468,205,133,109,57,155,4127,4023,374,125,115,89,188,4914,
20221011,101,229,서울,북천안,951,40,44,42,19,44,1140,805,55,56,45,25,55,1041,
20221011,101,528,서울,기흥동탄,7688,72,1174,128,11,395,9468,7351,68,1278,123,14,345,9179,
20221011,101,542,서울,서안성,1295,47,91,90,26,62,1611,1819,57,89,130,44,92,2231,
20221011,101,543,서울,남안성,1068,69,64,57,58,43,1359,1173,85,88,109,78,51,1584,
20221011,101,673,서울,북오산,1774,29,120,29,17,112,2081,1600,42,122,21,16,105,1906,
20221011,101,677,서울,북평택,2267,66,286,79,107,111,2916,1601,77,310,75,143,77,2283,
20221011,102,101,동수원,서울,4985,50,370,27,8,283,5723,4136,47,261,15,4,243,4706,
20221011,102,172,동수원,용인,1095,24,14,2,6,84,1225,1061,36,12,2,2,93,1206,
20221011,102,173,동수원,양지,1215,43,34,9,33,72,1406,1395,43,35,6,15,85,1579,
20221011,102,212,동수원,북수원,4515,19,219,7,23,237,5020,4839,35,229,8,18,282,5411,
20221011,102,213,동수원,부곡,1061,15,14,3,18,89,1200,1060,12,19,5,20,79,1195,
20221011,102,214,동수원,동군포,1426,30,17,9,4,79,1565,1578,22,14,12,6,105,1737,
20221011,102,215,동수원,군포,1716,21,21,3,14,115,1890,2347,23,33,4,2,172,2581,
20221011,102,253,동수원,서서울,5713,68,62,18,18,355,6234,5159,61,62,11,15,342,5650,
20221011,102,254,동수원,군자,3808,50,63,16,31,227,4195,4133,73,82,18,29,258,4593,
20221011,102,255,동수원,서안산,1833,41,8,11,5,92,1990,1999,38,15,12,6,132,2202,
20221011,103,101,수원신갈,서울,14384,653,1622,376,122,701,17858,16131,620,1620,422,114,819,19726,
20221011,103,105,수원신갈,기흥,1604,30,44,78,30,110,1896,2039,25,33,80,26,125,2328,
20221011,103,106,수원신갈,오산,1064,54,68,32,13,77,1308,1328,68,76,49,10,92,1623,
20221011,103,108,수원신갈,천안,921,7,49,9,1,37,1024,1164,5,57,16,2,53,1297,
20221011,103,212,수원신갈,북수원,859,41,24,21,7,65,1017,1363,73,33,45,11,73,1598,
20221011,103,253,수원신갈,서서울,2209,143,75,54,23,119,2623,2110,148,70,73,32,101,2534,
20221011,103,254,수원신갈,군자,1545,110,66,81,71,94,1967,1810,123,83,109,113,114,2352,
20221011,103,528,수원신갈,기흥동탄,1436,12,188,5,8,90,1739,1941,23,161,1,4,108,2238,
20221011,105,101,기흥,서울,5897,94,363,94,33,292,6773,7512,101,406,70,20,367,8476,
20221011,105,103,기흥,수원신갈,2039,25,33,80,26,125,2328,1604,30,44,78,30,110,1896,
20221011,105,253,기흥,서서울,942,22,6,14,10,62,1056,1033,26,13,9,6,71,1158,
20221011,106,101,오산,서울,4292,412,458,169,102,321,5754,4623,377,444,164,87,327,6022,
20221011,106,103,오산,수원신갈,1328,68,76,49,10,92,1623,1064,54,68,32,13,77,1308,
20221011,106,107,오산,안성,1693,52,52,21,11,175,2004,1420,42,22,17,12,134,1647,
20221011,106,108,오산,천안,1075,27,20,14,7,65,1208,963,18,21,14,1,63,1080,
20221011,106,528,오산,기흥동탄,857,35,38,12,6,79,1027,937,40,58,11,9,76,1131,
20221011,107,101,안성,서울,2853,78,277,50,27,160,3445,3351,88,303,40,18,196,3996,
20221011,107,106,안성,오산,1420,42,22,17,12,134,1647,1693,52,52,21,11,175,2004,
20221011,107,108,안성,천안,1539,26,34,3,7,129,1738,1516,29,45,13,11,136,1750,
20221011,107,528,안성,기흥동탄,988,15,17,4,4,95,1123,1084,18,21,4,7,92,1226,
20221011,107,742,안성,남사진위,1164,32,55,24,5,100,1380,1545,45,50,30,9,113,1792,
20221011,108,101,천안,서울,3856,51,346,41,17,157,4468,4009,48,333,30,12,173,4605,
20221011,108,103,천안,수원신갈,1164,5,57,16,2,53,1297,921,7,49,9,1,37,1024,
20221011,108,106,천안,오산,963,18,21,14,1,63,1080,1075,27,20,14,7,65,1208,
20221011,108,107,천안,안성,1516,29,45,13,11,136,1750,1539,26,34,3,7,129,1738,
20221011,108,111,천안,청주,1141,38,63,21,46,69,1378,1051,27,51,22,31,65,1247,
20221011,108,229,천안,북천안,3454,61,113,42,34,214,3918,3849,94,133,55,52,230,4413,
20221011,108,528,천안,기흥동탄,1104,11,98,4,8,61,1286,1064,19,116,2,12,68,1281,
20221011,108,742,천안,남사진위,1151,30,36,19,7,67,1310,1307,29,43,26,10,79,1494,
20221011,111,101,청주,서울,857,19,207,26,33,40,1182,1017,9,192,16,34,40,1308,
20221011,111,108,청주,천안,1051,27,51,22,31,65,1247,1141,38,63,21,46,69,1378,
20221011,112,115,남청주,대전,1581,69,58,4,15,115,1842,1764,95,65,6,10,136,2076,
20221011,113,115,신탄진,대전,967,30,13,5,11,105,1131,1119,22,21,5,14,123,1304,
20221011,114,153,남대전,서대전,1900,50,64,52,18,124,2208,1747,42,91,62,14,124,2080,
20221011,115,112,대전,남청주,1764,95,65,6,10,136,2076,1581,69,58,4,15,115,1842,
20221011,115,113,대전,신탄진,1119,22,21,5,14,123,1304,967,30,13,5,11,105,1131,
20221011,115,116,대전,옥천,2286,108,44,28,23,182,2671,2026,69,43,26,25,176,2365,
20221011,115,151,대전,북대전,1117,15,8,3,14,109,1266,909,11,6,2,18,105,1051,
20221011,115,152,대전,유성,1015,10,19,11,0,89,1144,936,13,21,12,2,64,1048,
20221011,115,153,대전,서대전,981,22,6,1,2,78,1090,927,21,5,0,5,71,1029,
20221011,115,579,대전,남세종,1076,7,18,8,10,99,1218,1114,10,16,3,13,89,1245,
20221011,116,115,옥천,대전,2026,69,43,26,25,176,2365,2286,108,44,28,23,182,2671,
20221011,119,153,판암,서대전,1765,23,12,6,14,143,1963,1853,26,21,14,8,155,2077,
20221011,123,127,구미,서대구,1610,25,23,14,9,97,1778,1743,36,29,12,11,104,1935,
20221011,123,129,구미,북대구,1876,22,57,8,5,105,2073,1928,23,57,5,1,123,2137,
20221011,123,130,구미,동김천,1145,21,41,39,44,64,1354,1148,22,38,21,38,77,1344,
20221011,125,127,남구미,서대구,1847,56,108,32,17,109,2169,2224,67,109,54,24,151,2629,
20221011,125,129,남구미,북대구,1809,30,69,9,3,101,2021,2208,26,76,14,7,124,2455,
20221011,126,127,왜관,서대구,2380,136,57,32,128,123,2856,2898,121,66,43,100,145,3373,
20221011,126,129,왜관,북대구,2889,99,38,21,86,122,3255,3551,101,67,25,99,170,4013,
20221011,127,123,서대구,구미,1743,36,29,12,11,104,1935,1610,25,23,14,9,97,1778,
20221011,127,125,서대구,남구미,2224,67,109,54,24,151,2629,1847,56,108,32,17,109,2169,
20221011,127,126,서대구,왜관,2898,121,66,43,100,145,3373,2380,136,57,32,128,123,2856,
20221011,127,131,서대구,경산,2598,209,155,103,79,162,3306,1910,159,119,79,72,117,2456,
20221011,127,203,서대구,가산,2232,62,70,50,124,92,2630,1988,58,51,42,124,104,2367,
20221011,127,230,서대구,팔공산,1439,40,47,12,6,87,1631,1070,32,30,13,4,59,1208,
20221011,127,518,서대구,칠곡물류,936,119,89,104,38,45,1331,777,93,69,78,23,46,1086,
20221011,127,621,서대구,동대구,1763,51,76,36,42,139,2107,1344,44,34,33,29,104,1588,
20221011,129,123,북대구,구미,1928,23,57,5,1,123,2137,1876,22,57,8,5,105,2073,
20221011,129,125,북대구,남구미,2208,26,76,14,7,124,2455,1809,30,69,9,3,101,2021,
20221011,129,126,북대구,왜관,3551,101,67,25,99,170,4013,2889,99,38,21,86,122,3255,
20221011,129,131,북대구,경산,2416,165,84,51,37,120,2873,3074,212,118,78,49,154,3685,
20221011,129,524,북대구,청통와촌,898,49,19,8,16,38,1028,1167,85,25,19,28,50,1374,
20221011,129,527,북대구,포항,1657,28,18,15,56,76,1850,1956,44,27,27,85,94,2233,
20221011,130,123,동김천,구미,1148,22,38,21,38,77,1344,1145,21,41,39,44,64,1354,
20221011,131,127,경산,서대구,1910,159,119,79,72,117,2456,2598,209,155,103,79,162,3306,
20221011,131,129,경산,북대구,3074,212,118,78,49,154,3685,2416,165,84,51,37,120,2873,
20221011,131,132,경산,영천,900,51,48,56,72,46,1173,811,49,60,39,26,44,1029,
20221011,131,230,경산,팔공산,1318,83,44,21,16,89,1571,1613,78,65,64,25,99,1944,
20221011,131,621,경산,동대구,2273,71,38,250,67,134,2833,2448,64,46,210,29,145,2942,
20221011,132,131,영천,경산,811,49,60,39,26,44,1029,900,51,48,56,72,46,1173,
20221011,132,621,영천,동대구,1114,8,22,1,32,48,1225,1185,14,21,4,34,63,1321,
20221011,135,140,경주,부산,1159,13,49,4,42,45,1312,1311,15,52,8,33,62,1481,
20221011,135,252,경주,대동,928,34,70,52,159,58,1301,1237,40,89,51,131,62,1610,
20221011,138,140,양산,부산,5134,251,173,262,268,280,6368,5542,320,207,271,255,284,6879,
20221011,138,252,양산,대동,2785,338,199,166,301,142,3931,3109,349,188,156,252,156,4210,
20221011,139,140,서울산,부산,1266,37,26,11,25,82,1447,1241,47,28,7,32,84,1439,
20221011,139,252,서울산,대동,859,37,44,32,46,46,1064,867,29,32,41,47,46,1062,
20221011,139,641,서울산,울산,1200,35,65,21,49,110,1480,1153,21,48,11,30,84,1347,
20221011,140,135,부산,경주,1311,15,52,8,33,62,1481,1159,13,49,4,42,45,1312,
20221011,140,138,부산,양산,5542,320,207,271,255,284,6879,5134,251,173,262,268,280,6368,
20221011,140,139,부산,서울산,1241,47,28,7,32,84,1439,1266,37,26,11,25,82,1447,
20221011,140,250,부산,남양산,8192,136,222,25,40,645,9260,7840,131,221,28,34,668,8922,
20221011,140,251,부산,물금,1034,126,30,39,59,79,1367,1048,88,29,30,44,69,1308,
20221011,140,252,부산,대동,1818,45,65,46,79,104,2157,1681,38,39,35,144,78,2015,
20221011,140,755,부산,광재,1089,18,26,9,38,67,1247,951,14,20,6,41,68,1100,
20221011,142,145,군북,산인,3917,75,124,40,72,285,4513,4127,78,118,52,84,301,4760,
20221011,143,145,장지,산인,1254,25,34,21,35,92,1461,1334,18,36,25,31,83,1527,
20221011,144,145,함안,산인,2098,41,37,28,65,158,2427,2213,48,46,34,66,154,2561,
20221011,145,142,산인,군북,4127,78,118,52,84,301,4760,3917,75,124,40,72,285,4513,
20221011,145,143,산인,장지,1334,18,36,25,31,83,1527,1254,25,34,21,35,92,1461,
20221011,145,144,산인,함안,2213,48,46,34,66,154,2561,2098,41,37,28,65,158,2427,
20221011,145,291,산인,사천,1250,42,53,17,10,68,1440,1201,61,55,12,13,71,1413,
20221011,145,292,산인,진주,1362,35,149,14,18,92,1670,1513,29,133,20,19,105,1819,
20221011,145,293,산인,문산,1288,29,28,12,4,77,1438,1144,27,36,16,9,81,1313,
20221011,146,150,동창원,북부산,981,20,17,7,17,76,1118,947,12,17,2,6,76,1060,
20221011,146,244,동창원,서부산,1172,24,38,16,28,67,1345,1230,30,30,23,42,80,1435,
20221011,146,245,동창원,장유,929,5,17,117,16,83,1167,966,12,17,118,21,91,1225,
20221011,146,289,동창원,마산,2738,84,94,54,88,226,3284,2383,85,93,34,58,207,2860,
20221011,147,150,진례,북부산,1404,37,25,18,42,85,1611,1671,48,20,19,27,100,1885,
20221011,147,244,진례,서부산,1657,109,65,64,86,109,2090,1903,118,85,59,97,112,2374,
20221011,147,245,진례,장유,1089,67,90,71,19,114,1450,1424,62,94,66,33,148,1827,
20221011,147,289,진례,마산,1255,98,86,46,72,75,1632,1265,99,70,50,77,81,1642,
20221011,148,150,서김해,북부산,6570,137,72,56,111,518,7464,6527,131,57,41,81,519,7356,
20221011,148,251,서김해,물금,924,31,24,28,11,83,1101,876,39,20,29,16,93,1073,
20221011,148,289,서김해,마산,1549,34,58,9,12,104,1766,1438,25,54,11,14,93,1635,
20221011,149,150,동김해,북부산,10611,210,200,53,84,873,12031,9189,161,147,51,60,735,10343,
20221011,149,250,동김해,남양산,1110,23,45,9,5,90,1282,960,24,49,5,8,86,1132,
20221011,149,251,동김해,물금,1129,39,10,11,5,124,1318,1104,29,10,4,3,100,1250,
20221011,150,146,북부산,동창원,947,12,17,2,6,76,1060,981,20,17,7,17,76,1118,
20221011,150,147,북부산,진례,1671,48,20,19,27,100,1885,1404,37,25,18,42,85,1611,
20221011,150,148,북부산,서김해,6527,131,57,41,81,519,7356,6570,137,72,56,111,518,7464,
20221011,150,149,북부산,동김해,9189,161,147,51,60,735,10343,10611,210,200,53,84,873,12031,
20221011,150,245,북부산,장유,3899,39,71,19,41,241,4310,3201,36,67,10,25,212,3551,
20221011,150,289,북부산,마산,2617,35,76,15,13,125,2881,2607,50,69,15,16,121,2878,
20221011,151,115,북대전,대전,909,11,6,2,18,105,1051,1117,15,8,3,14,109,1266,
20221011,151,153,북대전,서대전,1138,15,14,18,23,103,1311,1277,16,22,29,19,87,1450,
20221011,152,115,유성,대전,936,13,21,12,2,64,1048,1015,10,19,11,0,89,1144,
20221011,152,154,유성,안영,1056,21,27,2,17,70,1193,1154,17,20,5,9,66,1271,
20221011,153,114,서대전,남대전,1747,42,91,62,14,124,2080,1900,50,64,52,18,124,2208,
20221011,153,115,서대전,대전,927,21,5,0,5,71,1029,981,22,6,1,2,78,1090,
20221011,153,119,서대전,판암,1853,26,21,14,8,155,2077,1765,23,12,6,14,143,1963,
20221011,153,151,서대전,북대전,1277,16,22,29,19,87,1450,1138,15,14,18,23,103,1311,
20221011,153,154,서대전,안영,1161,32,44,32,88,66,1423,1084,38,41,33,53,54,1303,
20221011,153,579,서대전,남세종,1198,15,12,8,9,101,1343,1032,19,18,12,16,86,1183,
20221011,154,152,안영,유성,1154,17,20,5,9,66,1271,1056,21,27,2,17,70,1193,
20221011,154,153,안영,서대전,1084,38,41,33,53,54,1303,1161,32,44,32,88,66,1423,
20221011,159,167,서전주,광주,1305,75,74,54,41,46,1595,1364,59,51,52,47,46,1619,
20221011,166,167,장성,광주,2252,76,75,30,66,106,2605,2824,120,81,33,44,120,3222,
20221011,167,159,광주,서전주,1364,59,51,52,47,46,1619,1305,75,74,54,41,46,1595,
20221011,167,166,광주,장성,2824,120,81,33,44,120,3222,2252,76,75,30,66,106,2605,
20221011,167,567,광주,남고창,1363,35,40,11,36,44,1529,1355,32,39,14,33,52,1525,
20221011,171,101,마성,서울,2436,29,235,57,1,111,2869,2187,30,222,51,0,108,2598,
20221011,172,101,용인,서울,3751,152,113,44,31,235,4326,3501,141,124,40,26,214,4046,
20221011,172,102,용인,동수원,1061,36,12,2,2,93,1206,1095,24,14,2,6,84,1225,
20221011,172,173,용인,양지,1992,221,161,158,61,125,2718,1796,184,159,142,52,146,2479,
20221011,172,212,용인,북수원,966,36,14,15,14,62,1107,1098,55,19,18,16,64,1270,
20221011,172,253,용인,서서울,1091,61,30,33,14,73,1302,1111,60,22,35,18,63,1309,
20221011,173,101,양지,서울,4023,374,125,115,89,188,4914,3468,205,133,109,57,155,4127,
20221011,173,102,양지,동수원,1395,43,35,6,15,85,1579,1215,43,34,9,33,72,1406,
20221011,173,172,양지,용인,1796,184,159,142,52,146,2479,1992,221,161,158,61,125,2718,
20221011,173,212,양지,북수원,1162,81,41,59,20,73,1436,1335,91,50,52,35,54,1617,
20221011,173,253,양지,서서울,1168,123,68,112,52,63,1586,962,132,66,105,36,55,1356,
20221011,173,254,양지,군자,745,117,85,160,204,38,1349,774,120,95,155,205,44,1393,
20221011,174,179,춘천,홍천,3214,70,88,79,35,326,3812,3113,80,76,75,31,312,3687,
20221011,174,216,춘천,횡성,1054,47,28,23,26,76,1254,1066,48,28,15,18,66,1241,
20221011,174,218,춘천,남원주,1125,16,61,14,9,65,1290,1065,17,58,11,10,70,1231,
20221011,174,554,춘천,동홍천,1268,23,29,7,7,101,1435,1185,19,19,6,3,101,1333,
20221011,176,190,이천,동서울,1513,75,178,96,115,66,2043,1786,68,194,147,79,98,2372,
20221011,179,174,홍천,춘천,3113,80,76,75,31,312,3687,3214,70,88,79,35,326,3812,
20221011,184,189,대관령,강릉,1235,43,48,4,11,82,1423,1353,47,50,8,14,96,1568,
20221011,189,184,강릉,대관령,1353,47,50,8,14,96,1568,1235,43,48,4,11,82,1423,
20221011,190,176,동서울,이천,1786,68,194,147,79,98,2372,1513,75,178,96,115,66,2043,
20221011,190,191,동서울,경기광주,10693,666,450,357,198,776,13140,10501,642,425,262,236,759,12825,
20221011,190,192,동서울,곤지암,5896,491,219,185,110,362,7263,5205,452,175,178,70,340,6420,
20221011,190,193,동서울,일죽,2489,161,187,177,113,91,3218,2433,156,173,259,106,84,3211,
20221011,190,194,동서울,서이천,4453,564,315,267,150,234,5983,3180,424,251,204,104,151,4314,
20221011,190,560,동서울,감곡,1038,34,42,42,115,26,1297,941,40,34,35,109,33,1192,
20221011,190,705,동서울,남이천,1338,81,59,108,124,47,1757,1430,94,46,82,78,49,1779,
20221011,191,190,경기광주,동서울,10501,642,425,262,236,759,12825,10693,666,450,357,198,776,13140,
20221011,192,190,곤지암,동서울,5205,452,175,178,70,340,6420,5896,491,219,185,110,362,7263,
20221011,192,194,곤지암,서이천,1408,249,109,162,102,109,2139,1086,156,81,168,126,80,1697,
20221011,193,190,일죽,동서울,2433,156,173,259,106,84,3211,2489,161,187,177,113,91,3218,
20221011,194,190,서이천,동서울,3180,424,251,204,104,151,4314,4453,564,315,267,150,234,5983,
20221011,194,192,서이천,곤지암,1086,156,81,168,126,80,1697,1408,249,109,162,102,109,2139,
20221011,196,198,진천,서청주,1348,44,77,43,31,80,1623,1317,33,76,36,27,77,1566,
20221011,198,196,서청주,진천,1317,33,76,36,27,77,1566,1348,44,77,43,31,80,1623,
20221011,201,203,칠곡,가산,869,41,42,68,91,51,1162,877,48,40,65,128,54,1212,
20221011,203,127,가산,서대구,1988,58,51,42,124,104,2367,2232,62,70,50,124,92,2630,
20221011,203,201,가산,칠곡,877,48,40,65,128,54,1212,869,41,42,68,91,51,1162,
20221011,203,775,가산,동명동호,1696,46,41,51,233,83,2150,1650,66,44,50,187,81,2078,
20221011,212,102,북수원,동수원,4839,35,229,8,18,282,5411,4515,19,219,7,23,237,5020,
20221011,212,103,북수원,수원신갈,1363,73,33,45,11,73,1598,859,41,24,21,7,65,1017,
20221011,212,172,북수원,용인,1098,55,19,18,16,64,1270,966,36,14,15,14,62,1107,
20221011,212,173,북수원,양지,1335,91,50,52,35,54,1617,1162,81,41,59,20,73,1436,
20221011,212,253,북수원,서서울,2555,44,29,8,12,183,2831,953,23,10,7,8,56,1057,
20221011,212,254,북수원,군자,1746,31,40,9,31,103,1960,1083,28,20,15,28,63,1237,
20221011,213,102,부곡,동수원,1060,12,19,5,20,79,1195,1061,15,14,3,18,89,1200,
20221011,213,253,부곡,서서울,1482,58,31,34,150,103,1858,1027,51,32,42,154,72,1378,
20221011,213,254,부곡,군자,1013,36,22,43,503,58,1675,861,29,22,37,404,53,1406,
20221011,214,102,동군포,동수원,1578,22,14,12,6,105,1737,1426,30,17,9,4,79,1565,
20221011,215,102,군포,동수원,2347,23,33,4,2,172,2581,1716,21,21,3,14,115,1890,
20221011,215,253,군포,서서울,3054,74,59,34,44,197,3462,3719,133,129,161,69,239,4450,
20221011,215,254,군포,군자,2068,72,57,41,72,153,2463,2791,147,95,145,143,215,3536,
20221011,215,255,군포,서안산,1394,41,36,20,11,106,1608,1534,74,64,107,83,127,1989,
20221011,216,174,횡성,춘천,1066,48,28,15,18,66,1241,1054,47,28,23,26,76,1254,
20221011,218,174,남원주,춘천,1065,17,58,11,10,70,1231,1125,16,61,14,9,65,1290,
20221011,218,240,남원주,제천,2191,55,56,19,59,157,2537,2059,48,49,19,41,129,2345,
20221011,225,291,서진주,사천,1009,30,16,11,48,77,1191,1032,27,26,6,42,76,1209,
20221011,229,101,북천안,서울,805,55,56,45,25,55,1041,951,40,44,42,19,44,1140,
20221011,229,108,북천안,천안,3849,94,133,55,52,230,4413,3454,61,113,42,34,214,3918,
20221011,230,127,팔공산,서대구,1070,32,30,13,4,59,1208,1439,40,47,12,6,87,1631,
20221011,230,131,팔공산,경산,1613,78,65,64,25,99,1944,1318,83,44,21,16,89,1571,
20221011,230,524,팔공산,청통와촌,1188,44,39,13,14,51,1349,1063,39,21,6,23,57,1209,
20221011,230,527,팔공산,포항,1657,30,9,7,22,57,1782,1322,23,15,4,24,54,1442,
20221011,231,519,화원옥포,남대구,6604,184,83,194,116,496,7677,6428,161,87,171,68,474,7389,
20221011,232,519,달성,남대구,2742,119,135,56,30,189,3271,2954,136,150,43,19,183,3485,
20221011,233,519,현풍,남대구,4915,223,194,75,113,357,5877,4472,202,195,97,95,300,5361,
20221011,238,239,칠서,칠원,1598,103,101,127,441,91,2461,1806,95,106,109,406,96,2618,
20221011,239,238,칠원,칠서,1806,95,106,109,406,96,2618,1598,103,101,127,441,91,2461,
20221011,239,519,칠원,남대구,1034,58,92,32,86,41,1343,1125,61,89,46,59,53,1433,
20221011,240,218,제천,남원주,2059,48,49,19,41,129,2345,2191,55,56,19,59,157,2537,
20221011,241,519,동고령,남대구,3052,95,87,315,205,146,3900,3019,97,96,317,238,148,3915,
20221011,242,519,고령,남대구,1654,39,47,22,155,75,1992,1742,36,55,16,148,80,2077,
20221011,244,146,서부산,동창원,1230,30,30,23,42,80,1435,1172,24,38,16,28,67,1345,
20221011,244,147,서부산,진례,1903,118,85,59,97,112,2374,1657,109,65,64,86,109,2090,
20221011,244,245,서부산,장유,13045,244,381,149,296,1010,15125,12171,240,386,127,332,952,14208,
20221011,244,289,서부산,마산,3048,66,260,38,67,173,3652,2516,70,227,43,55,141,3052,
20221011,245,146,장유,동창원,966,12,17,118,21,91,1225,929,5,17,117,16,83,1167,
20221011,245,147,장유,진례,1424,62,94,66,33,148,1827,1089,67,90,71,19,114,1450,
20221011,245,150,장유,북부산,3201,36,67,10,25,212,3551,3899,39,71,19,41,241,4310,
20221011,245,244,장유,서부산,12171,240,386,127,332,952,14208,13045,244,381,149,296,1010,15125,
20221011,245,289,장유,마산,1574,28,41,21,55,133,1852,1336,24,37,22,34,97,1550,
20221011,248,261,순창,동광주,1274,21,30,7,19,63,1414,1200,19,33,16,21,56,1345,
20221011,249,261,담양,동광주,2334,45,126,28,56,106,2695,1765,35,119,22,69,74,2084,
20221011,250,140,남양산,부산,7840,131,221,28,34,668,8922,8192,136,222,25,40,645,9260,
20221011,250,149,남양산,동김해,960,24,49,5,8,86,1132,1110,23,45,9,5,90,1282,
20221011,250,252,남양산,대동,3557,150,126,145,95,234,4307,4064,178,127,117,105,325,4916,
20221011,251,140,물금,부산,1048,88,29,30,44,69,1308,1034,126,30,39,59,79,1367,
20221011,251,148,물금,서김해,876,39,20,29,16,93,1073,924,31,24,28,11,83,1101,
20221011,251,149,물금,동김해,1104,29,10,4,3,100,1250,1129,39,10,11,5,124,1318,
20221011,251,252,물금,대동,3243,211,106,150,465,226,4401,3836,204,98,156,528,283,5105,
20221011,252,135,대동,경주,1237,40,89,51,131,62,1610,928,34,70,52,159,58,1301,
20221011,252,138,대동,양산,3109,349,188,156,252,156,4210,2785,338,199,166,301,142,3931,
20221011,252,139,대동,서울산,867,29,32,41,47,46,1062,859,37,44,32,46,46,1064,
20221011,252,140,대동,부산,1681,38,39,35,144,78,2015,1818,45,65,46,79,104,2157,
20221011,252,250,대동,남양산,4064,178,127,117,105,325,4916,3557,150,126,145,95,234,4307,
20221011,252,251,대동,물금,3836,204,98,156,528,283,5105,3243,211,106,150,465,226,4401,
20221011,252,641,대동,울산,1690,62,84,36,27,105,2004,1392,70,88,33,54,67,1704,
20221011,252,752,대동,기장철마,1848,63,62,33,118,140,2264,1884,63,69,40,65,159,2280,
20221011,252,753,대동,금정,1890,86,108,90,143,122,2439,1050,55,74,59,90,64,1392,
20221011,252,755,대동,광재,2426,108,106,60,289,160,3149,2362,109,90,49,399,141,3150,
20221011,252,756,대동,한림,877,55,33,22,98,44,1129,936,58,29,24,106,46,1199,
20221011,253,102,서서울,동수원,5159,61,62,11,15,342,5650,5713,68,62,18,18,355,6234,
20221011,253,103,서서울,수원신갈,2110,148,70,73,32,101,2534,2209,143,75,54,23,119,2623,
20221011,253,105,서서울,기흥,1033,26,13,9,6,71,1158,942,22,6,14,10,62,1056,
20221011,253,172,서서울,용인,1111,60,22,35,18,63,1309,1091,61,30,33,14,73,1302,
20221011,253,173,서서울,양지,962,132,66,105,36,55,1356,1168,123,68,112,52,63,1586,
20221011,253,212,서서울,북수원,953,23,10,7,8,56,1057,2555,44,29,8,12,183,2831,
20221011,253,213,서서울,부곡,1027,51,32,42,154,72,1378,1482,58,31,34,150,103,1858,
20221011,253,215,서서울,군포,3719,133,129,161,69,239,4450,3054,74,59,34,44,197,3462,
20221011,253,255,서서울,서안산,15754,491,651,525,271,953,18645,14761,495,620,494,258,934,17562,
20221011,253,256,서서울,안산,8913,152,85,42,33,640,9865,5965,96,59,36,63,440,6659,
20221011,253,281,서서울,매송,3764,68,44,25,25,241,4167,3658,60,31,31,66,222,4068,
20221011,253,282,서서울,비봉,5956,271,248,176,318,351,7320,5510,295,254,161,395,375,6990,
20221011,253,283,서서울,발안,3409,145,150,139,230,190,4263,3601,214,165,172,226,220,4598,
20221011,253,285,서서울,서평택,1866,61,110,251,378,103,2769,1478,112,112,320,498,85,2605,
20221011,253,287,서서울,송악,1912,42,52,73,242,65,2386,1662,44,56,75,457,76,2370,
20221011,253,288,서서울,당진,1356,18,38,32,35,64,1543,1349,23,45,46,51,61,1575,
20221011,253,298,서서울,서산,2243,23,67,47,22,80,2482,2300,25,61,52,52,100,2590,
20221011,253,520,서서울,평택,2116,103,100,145,124,104,2692,2068,110,112,221,117,87,2715,
20221011,253,540,서서울,청북,924,52,58,105,44,48,1231,890,58,47,81,86,42,1204,
20221011,253,741,서서울,평택고덕,1191,25,17,15,8,68,1324,982,38,24,21,12,65,1142,
20221011,254,102,군자,동수원,4133,73,82,18,29,258,4593,3808,50,63,16,31,227,4195,
20221011,254,103,군자,수원신갈,1810,123,83,109,113,114,2352,1545,110,66,81,71,94,1967,
20221011,254,173,군자,양지,774,120,95,155,205,44,1393,745,117,85,160,204,38,1349,
20221011,254,212,군자,북수원,1083,28,20,15,28,63,1237,1746,31,40,9,31,103,1960,
20221011,254,213,군자,부곡,861,29,22,37,404,53,1406,1013,36,22,43,503,58,1675,
20221011,254,215,군자,군포,2791,147,95,145,143,215,3536,2068,72,57,41,72,153,2463,
20221011,254,255,군자,서안산,10357,472,215,220,329,715,12308,9533,386,160,181,292,664,11216,
20221011,254,256,군자,안산,4535,111,107,42,55,361,5211,4975,111,110,45,66,383,5690,
20221011,254,281,군자,매송,1075,35,12,28,71,71,1292,846,23,18,20,66,63,1036,
20221011,254,282,군자,비봉,1388,129,96,77,165,102,1957,1106,121,69,49,165,83,1593,
20221011,254,283,군자,발안,1224,82,70,76,117,73,1642,1067,88,53,44,94,58,1404,
20221011,255,102,서안산,동수원,1999,38,15,12,6,132,2202,1833,41,8,11,5,92,1990,
20221011,255,215,서안산,군포,1534,74,64,107,83,127,1989,1394,41,36,20,11,106,1608,
20221011,255,253,서안산,서서울,14761,495,620,494,258,934,17562,15754,491,651,525,271,953,18645,
20221011,255,254,서안산,군자,9533,386,160,181,292,664,11216,10357,472,215,220,329,715,12308,
20221011,256,253,안산,서서울,5965,96,59,36,63,440,6659,8913,152,85,42,33,640,9865,
20221011,256,254,안산,군자,4975,111,110,45,66,383,5690,4535,111,107,42,55,361,5211,
20221011,261,248,동광주,순창,1200,19,33,16,21,56,1345,1274,21,30,7,19,63,1414,
20221011,261,249,동광주,담양,1765,35,119,22,69,74,2084,2334,45,126,28,56,106,2695,
20221011,261,262,동광주,창평,1579,97,29,36,56,76,1873,1741,72,39,33,56,70,2011,
20221011,261,263,동광주,옥과,2906,34,131,21,79,129,3300,2603,35,119,16,93,131,2997,
20221011,261,265,동광주,곡성,1434,22,32,18,35,67,1608,1413,11,35,12,30,51,1552,
20221011,261,271,동광주,순천,2940,83,78,44,103,110,3358,2650,85,67,34,113,85,3034,
20221011,262,261,창평,동광주,1741,72,39,33,56,70,2011,1579,97,29,36,56,76,1873,
20221011,263,261,옥과,동광주,2603,35,119,16,93,131,2997,2906,34,131,21,79,129,3300,
20221011,265,261,곡성,동광주,1413,11,35,12,30,51,1552,1434,22,32,18,35,67,1608,
20221011,267,271,주암송광사,순천,895,13,13,28,76,35,1060,868,18,8,28,73,29,1024,
20221011,271,261,순천,동광주,2650,85,67,34,113,85,3034,2940,83,78,44,103,110,3358,
20221011,271,267,순천,주암송광사,868,18,8,28,73,29,1024,895,13,13,28,76,35,1060,
20221011,271,569,순천,북광주,817,63,39,26,132,24,1101,807,61,41,24,110,27,1070,
20221011,280,519,거창,남대구,971,22,45,5,14,36,1093,974,28,56,9,8,42,1117,
20221011,281,253,매송,서서울,3658,60,31,31,66,222,4068,3764,68,44,25,25,241,4167,
20221011,281,254,매송,군자,846,23,18,20,66,63,1036,1075,35,12,28,71,71,1292,
20221011,282,253,비봉,서서울,5510,295,254,161,395,375,6990,5956,271,248,176,318,351,7320,
20221011,282,254,비봉,군자,1106,121,69,49,165,83,1593,1388,129,96,77,165,102,1957,
20221011,283,253,발안,서서울,3601,214,165,172,226,220,4598,3409,145,150,139,230,190,4263,
20221011,283,254,발안,군자,1067,88,53,44,94,58,1404,1224,82,70,76,117,73,1642,
20221011,285,253,서평택,서서울,1478,112,112,320,498,85,2605,1866,61,110,251,378,103,2769,
20221011,285,287,서평택,송악,667,34,88,72,685,36,1582,677,40,93,73,569,43,1495,
20221011,287,253,송악,서서울,1662,44,56,75,457,76,2370,1912,42,52,73,242,65,2386,
20221011,287,285,송악,서평택,677,40,93,73,569,43,1495,667,34,88,72,685,36,1582,
20221011,288,253,당진,서서울,1349,23,45,46,51,61,1575,1356,18,38,32,35,64,1543,
20221011,289,146,마산,동창원,2383,85,93,34,58,207,2860,2738,84,94,54,88,226,3284,
20221011,289,147,마산,진례,1265,99,70,50,77,81,1642,1255,98,86,46,72,75,1632,
20221011,289,148,마산,서김해,1438,25,54,11,14,93,1635,1549,34,58,9,12,104,1766,
20221011,289,150,마산,북부산,2607,50,69,15,16,121,2878,2617,35,76,15,13,125,2881,
20221011,289,244,마산,서부산,2516,70,227,43,55,141,3052,3048,66,260,38,67,173,3652,
20221011,289,245,마산,장유,1336,24,37,22,34,97,1550,1574,28,41,21,55,133,1852,
20221011,291,145,사천,산인,1201,61,55,12,13,71,1413,1250,42,53,17,10,68,1440,
20221011,291,225,사천,서진주,1032,27,26,6,42,76,1209,1009,30,16,11,48,77,1191,
20221011,291,292,사천,진주,2769,71,91,43,53,247,3274,3497,84,91,53,45,292,4062,
20221011,292,145,진주,산인,1513,29,133,20,19,105,1819,1362,35,149,14,18,92,1670,
20221011,292,291,진주,사천,3497,84,91,53,45,292,4062,2769,71,91,43,53,247,3274,
20221011,293,145,문산,산인,1144,27,36,16,9,81,1313,1288,29,28,12,4,77,1438,
20221011,298,253,서산,서서울,2300,25,61,52,52,100,2590,2243,23,67,47,22,80,2482,
20221011,508,509,무안,목포,1302,44,37,32,53,58,1526,1614,53,59,30,75,97,1928,
20221011,508,553,무안,동광산,1474,21,41,22,22,61,1641,1641,28,44,24,29,61,1827,
20221011,509,508,목포,무안,1614,53,59,30,75,97,1928,1302,44,37,32,53,58,1526,
20221011,509,553,목포,동광산,6568,185,193,151,338,267,7702,7061,164,195,154,379,283,8236,
20221011,513,515,고성,북통영,1464,29,74,8,29,102,1706,1472,28,75,16,25,99,1715,
20221011,513,516,고성,통영,3034,86,117,83,179,226,3725,2926,82,109,79,162,225,3583,
20221011,514,516,동고성,통영,1233,19,48,31,107,158,1596,1210,9,53,25,102,180,1579,
20221011,515,513,북통영,고성,1472,28,75,16,25,99,1715,1464,29,74,8,29,102,1706,
20221011,516,513,통영,고성,2926,82,109,79,162,225,3583,3034,86,117,83,179,226,3725,
20221011,516,514,통영,동고성,1210,9,53,25,102,180,1579,1233,19,48,31,107,158,1596,
20221011,517,598,양평,북여주,1235,32,26,24,62,44,1423,1204,31,20,19,35,58,1367,
20221011,518,127,칠곡물류,서대구,777,93,69,78,23,46,1086,936,119,89,104,38,45,1331,
20221011,519,231,남대구,화원옥포,6428,161,87,171,68,474,7389,6604,184,83,194,116,496,7677,
20221011,519,232,남대구,달성,2954,136,150,43,19,183,3485,2742,119,135,56,30,189,3271,
20221011,519,233,남대구,현풍,4472,202,195,97,95,300,5361,4915,223,194,75,113,357,5877,
20221011,519,239,남대구,칠원,1125,61,89,46,59,53,1433,1034,58,92,32,86,41,1343,
20221011,519,241,남대구,동고령,3019,97,96,317,238,148,3915,3052,95,87,315,205,146,3900,
20221011,519,242,남대구,고령,1742,36,55,16,148,80,2077,1654,39,47,22,155,75,1992,
20221011,519,280,남대구,거창,974,28,56,9,8,42,1117,971,22,45,5,14,36,1093,
20221011,519,730,남대구,유천,2387,60,18,3,3,160,2631,2859,52,16,0,0,193,3120,
20221011,519,731,남대구,북현풍,1866,28,28,0,4,121,2047,1583,25,8,0,0,119,1735,
20221011,520,253,평택,서서울,2068,110,112,221,117,87,2715,2116,103,100,145,124,104,2692,
20221011,520,540,평택,청북,980,104,148,139,88,66,1525,785,88,132,130,71,41,1247,
20221011,520,741,평택,평택고덕,996,11,203,16,19,80,1325,793,9,170,9,13,72,1066,
20221011,524,129,청통와촌,북대구,1167,85,25,19,28,50,1374,898,49,19,8,16,38,1028,
20221011,524,230,청통와촌,팔공산,1063,39,21,6,23,57,1209,1188,44,39,13,14,51,1349,
20221011,527,129,포항,북대구,1956,44,27,27,85,94,2233,1657,28,18,15,56,76,1850,
20221011,527,230,포항,팔공산,1322,23,15,4,24,54,1442,1657,30,9,7,22,57,1782,
20221011,528,101,기흥동탄,서울,7351,68,1278,123,14,345,9179,7688,72,1174,128,11,395,9468,
20221011,528,103,기흥동탄,수원신갈,1941,23,161,1,4,108,2238,1436,12,188,5,8,90,1739,
20221011,528,106,기흥동탄,오산,937,40,58,11,9,76,1131,857,35,38,12,6,79,1027,
20221011,528,107,기흥동탄,안성,1084,18,21,4,7,92,1226,988,15,17,4,4,95,1123,
20221011,528,108,기흥동탄,천안,1064,19,116,2,12,68,1281,1104,11,98,4,8,61,1286,
20221011,540,253,청북,서서울,890,58,47,81,86,42,1204,924,52,58,105,44,48,1231,
20221011,540,520,청북,평택,785,88,132,130,71,41,1247,980,104,148,139,88,66,1525,
20221011,540,741,청북,평택고덕,894,22,39,85,20,72,1132,888,32,65,86,21,88,1180,
20221011,542,101,서안성,서울,1819,57,89,130,44,92,2231,1295,47,91,90,26,62,1611,
20221011,542,543,서안성,남안성,1065,53,86,139,101,91,1535,1176,48,87,148,83,91,1633,
20221011,543,101,남안성,서울,1173,85,88,109,78,51,1584,1068,69,64,57,58,43,1359,
20221011,543,542,남안성,서안성,1176,48,87,148,83,91,1633,1065,53,86,139,101,91,1535,
20221011,543,555,남안성,북진천,851,109,175,173,146,40,1494,792,110,147,159,141,46,1395,
20221011,548,553,북무안,동광산,1289,26,26,18,111,30,1500,1567,26,31,18,140,46,1828,
20221011,549,553,동함평,동광산,3097,48,51,51,44,119,3410,3129,53,80,37,44,108,3451,
20221011,551,553,나주,동광산,1228,25,30,77,30,67,1457,1209,22,31,68,33,60,1423,
20221011,552,553,서광산,동광산,4430,181,158,212,221,176,5378,5607,202,208,221,158,203,6599,
20221011,553,508,동광산,무안,1641,28,44,24,29,61,1827,1474,21,41,22,22,61,1641,
20221011,553,509,동광산,목포,7061,164,195,154,379,283,8236,6568,185,193,151,338,267,7702,
20221011,553,548,동광산,북무안,1567,26,31,18,140,46,1828,1289,26,26,18,111,30,1500,
20221011,553,549,동광산,동함평,3129,53,80,37,44,108,3451,3097,48,51,51,44,119,3410,
20221011,553,551,동광산,나주,1209,22,31,68,33,60,1423,1228,25,30,77,30,67,1457,
20221011,553,552,동광산,서광산,5607,202,208,221,158,203,6599,4430,181,158,212,221,176,5378,
20221011,554,174,동홍천,춘천,1185,19,19,6,3,101,1333,1268,23,29,7,7,101,1435,
20221011,555,543,북진천,남안성,792,110,147,159,141,46,1395,851,109,175,173,146,40,1494,
20221011,560,190,감곡,동서울,941,40,34,35,109,33,1192,1038,34,42,42,115,26,1297,
20221011,567,167,남고창,광주,1355,32,39,14,33,52,1525,1363,35,40,11,36,44,1529,
20221011,569,271,북광주,순천,807,61,41,24,110,27,1070,817,63,39,26,132,24,1101,
20221011,579,115,남세종,대전,1114,10,16,3,13,89,1245,1076,7,18,8,10,99,1218,
20221011,579,153,남세종,서대전,1032,19,18,12,16,86,1183,1198,15,12,8,9,101,1343,
20221011,587,589,오수,상관,990,20,56,27,49,32,1174,1212,25,67,27,135,40,1506,
20221011,589,587,상관,오수,1212,25,67,27,135,40,1506,990,20,56,27,49,32,1174,
20221011,597,598,서여주,북여주,903,39,115,26,63,44,1190,1014,41,76,34,59,50,1274,
20221011,598,517,북여주,양평,1204,31,20,19,35,58,1367,1235,32,26,24,62,44,1423,
20221011,598,597,북여주,서여주,1014,41,76,34,59,50,1274,903,39,115,26,63,44,1190,
20221011,621,127,동대구,서대구,1344,44,34,33,29,104,1588,1763,51,76,36,42,139,2107,
20221011,621,131,동대구,경산,2448,64,46,210,29,145,2942,2273,71,38,250,67,134,2833,
20221011,621,132,동대구,영천,1185,14,21,4,34,63,1321,1114,8,22,1,32,48,1225,
20221011,625,626,밀양,남밀양,1116,76,46,65,63,56,1422,1093,69,51,55,74,49,1391,
20221011,626,625,남밀양,밀양,1093,69,51,55,74,49,1391,1116,76,46,65,63,56,1422,
20221011,626,627,남밀양,삼랑진,980,17,33,16,71,113,1230,980,31,21,16,85,108,1241,
20221011,627,626,삼랑진,남밀양,980,31,21,16,85,108,1241,980,17,33,16,71,113,1230,
20221011,641,139,울산,서울산,1153,21,48,11,30,84,1347,1200,35,65,21,49,110,1480,
20221011,641,252,울산,대동,1392,70,88,33,54,67,1704,1690,62,84,36,27,105,2004,
20221011,641,643,울산,청량,1234,10,20,10,60,97,1431,1353,9,14,12,26,132,1546,
20221011,641,706,울산,남경주,1140,8,10,11,17,66,1252,1200,11,14,12,16,60,1313,
20221011,641,707,울산,남포항,1335,12,20,15,151,71,1604,1242,12,12,36,125,55,1482,
20221011,643,641,청량,울산,1353,9,14,12,26,132,1546,1234,10,20,10,60,97,1431,
20221011,643,648,청량,해운대,2814,15,24,15,27,203,3098,3373,29,75,36,439,224,4176,
20221011,645,648,장안,해운대,1620,11,10,4,8,91,1744,3006,27,34,147,85,165,3464,
20221011,646,648,기장일광,해운대,4583,18,24,61,17,267,4970,5360,49,34,24,167,310,5944,
20221011,648,643,해운대,청량,3373,29,75,36,439,224,4176,2814,15,24,15,27,203,3098,
20221011,648,645,해운대,장안,3006,27,34,147,85,165,3464,1620,11,10,4,8,91,1744,
20221011,648,646,해운대,기장일광,5360,49,34,24,167,310,5944,4583,18,24,61,17,267,4970,
20221011,651,652,남양주,화도,14526,561,493,435,212,1108,17335,14834,542,555,461,173,1115,17680,
20221011,651,653,남양주,서종,1789,16,9,6,28,76,1924,1868,15,9,6,26,76,2000,
20221011,651,654,남양주,설악,3483,28,69,15,7,141,3743,3727,27,66,16,8,150,3994,
20221011,651,655,남양주,강촌,2469,47,109,27,36,78,2766,2757,33,107,33,39,93,3062,
20221011,651,656,남양주,남춘천,2668,26,44,26,53,83,2900,2131,15,28,12,45,67,2298,
20221011,652,651,화도,남양주,14834,542,555,461,173,1115,17680,14526,561,493,435,212,1108,17335,
20221011,652,653,화도,서종,1232,29,17,20,3,99,1400,1529,35,18,15,7,125,1729,
20221011,652,654,화도,설악,1022,15,12,42,8,60,1159,1232,16,11,46,6,80,1391,
20221011,653,651,서종,남양주,1868,15,9,6,26,76,2000,1789,16,9,6,28,76,1924,
20221011,653,652,서종,화도,1529,35,18,15,7,125,1729,1232,29,17,20,3,99,1400,
20221011,654,651,설악,남양주,3727,27,66,16,8,150,3994,3483,28,69,15,7,141,3743,
20221011,654,652,설악,화도,1232,16,11,46,6,80,1391,1022,15,12,42,8,60,1159,
20221011,655,651,강촌,남양주,2757,33,107,33,39,93,3062,2469,47,109,27,36,78,2766,
20221011,656,651,남춘천,남양주,2131,15,28,12,45,67,2298,2668,26,44,26,53,83,2900,
20221011,671,672,봉담,정남,3397,171,92,49,154,230,4093,3730,156,112,51,166,274,4489,
20221011,671,673,봉담,북오산,1941,50,53,23,24,147,2238,1929,45,44,23,18,167,2226,
20221011,671,676,봉담,향남,1353,113,55,48,31,119,1719,1205,103,45,35,29,88,1505,
20221011,671,677,봉담,북평택,8045,176,232,127,291,465,9336,7021,164,201,129,213,404,8132,
20221011,672,671,정남,봉담,3730,156,112,51,166,274,4489,3397,171,92,49,154,230,4093,
20221011,673,101,북오산,서울,1600,42,122,21,16,105,1906,1774,29,120,29,17,112,2081,
20221011,673,671,북오산,봉담,1929,45,44,23,18,167,2226,1941,50,53,23,24,147,2238,
20221011,673,677,북오산,북평택,1986,36,64,22,32,132,2272,1902,37,54,29,22,127,2171,
20221011,675,676,서오산,향남,3532,105,74,92,53,213,4069,3233,86,66,86,26,210,3707,
20221011,675,677,서오산,북평택,12341,237,409,170,212,771,14140,10693,232,364,174,161,702,12326,
20221011,675,876,서오산,양감,1859,58,43,50,151,116,2277,2054,75,37,38,124,144,2472,
20221011,676,671,향남,봉담,1205,103,45,35,29,88,1505,1353,113,55,48,31,119,1719,
20221011,676,675,향남,서오산,3233,86,66,86,26,210,3707,3532,105,74,92,53,213,4069,
20221011,676,677,향남,북평택,1829,196,146,204,146,120,2641,1647,149,138,176,120,97,2327,
20221011,677,101,북평택,서울,1601,77,310,75,143,77,2283,2267,66,286,79,107,111,2916,
20221011,677,671,북평택,봉담,7021,164,201,129,213,404,8132,8045,176,232,127,291,465,9336,
20221011,677,673,북평택,북오산,1902,37,54,29,22,127,2171,1986,36,64,22,32,132,2272,
20221011,677,675,북평택,서오산,10693,232,364,174,161,702,12326,12341,237,409,170,212,771,14140,
20221011,677,676,북평택,향남,1647,149,138,176,120,97,2327,1829,196,146,204,146,120,2641,
20221011,677,876,북평택,양감,2361,160,160,207,124,137,3149,2048,145,181,230,109,120,2833,
20221011,682,683,조암,송산마도,840,89,85,92,53,41,1200,978,98,103,90,62,57,1388,
20221011,682,684,조암,남안산,1118,166,190,103,112,43,1732,1155,182,164,140,94,49,1784,
20221011,682,685,조암,서시흥,1870,198,168,162,235,101,2734,2183,169,158,163,269,110,3052,
20221011,683,682,송산마도,조암,978,98,103,90,62,57,1388,840,89,85,92,53,41,1200,
20221011,683,684,송산마도,남안산,2564,208,165,103,207,144,3391,2267,177,133,91,175,134,2977,
20221011,683,685,송산마도,서시흥,5016,315,220,209,1032,268,7060,4587,289,222,208,961,262,6529,
20221011,684,682,남안산,조암,1155,182,164,140,94,49,1784,1118,166,190,103,112,43,1732,
20221011,684,683,남안산,송산마도,2267,177,133,91,175,134,2977,2564,208,165,103,207,144,3391,
20221011,684,685,남안산,서시흥,5744,539,312,446,589,410,8040,4816,396,324,368,461,368,6733,
20221011,685,682,서시흥,조암,2183,169,158,163,269,110,3052,1870,198,168,162,235,101,2734,
20221011,685,683,서시흥,송산마도,4587,289,222,208,961,262,6529,5016,315,220,209,1032,268,7060,
20221011,685,684,서시흥,남안산,4816,396,324,368,461,368,6733,5744,539,312,446,589,410,8040,
20221011,705,190,남이천,동서울,1430,94,46,82,78,49,1779,1338,81,59,108,124,47,1757,
20221011,706,641,남경주,울산,1200,11,14,12,16,60,1313,1140,8,10,11,17,66,1252,
20221011,706,707,남경주,남포항,1026,30,56,35,229,67,1443,1055,40,69,36,172,65,1437,
20221011,707,641,남포항,울산,1242,12,12,36,125,55,1482,1335,12,20,15,151,71,1604,
20221011,707,706,남포항,남경주,1055,40,69,36,172,65,1437,1026,30,56,35,229,67,1443,
20221011,707,708,남포항,동경주,1336,25,25,23,282,81,1772,1409,34,36,16,313,84,1892,
20221011,708,707,동경주,남포항,1409,34,36,16,313,84,1892,1336,25,25,23,282,81,1772,
20221011,715,716,동안동,청송,1151,23,21,22,21,65,1303,1092,29,14,20,29,63,1247,
20221011,716,715,청송,동안동,1092,29,14,20,29,63,1247,1151,23,21,22,21,65,1303,
20221011,730,519,유천,남대구,2859,52,16,0,0,193,3120,2387,60,18,3,3,160,2631,
20221011,731,519,북현풍,남대구,1583,25,8,0,0,119,1735,1866,28,28,0,4,121,2047,
20221011,741,253,평택고덕,서서울,982,38,24,21,12,65,1142,1191,25,17,15,8,68,1324,
20221011,741,520,평택고덕,평택,793,9,170,9,13,72,1066,996,11,203,16,19,80,1325,
20221011,741,540,평택고덕,청북,888,32,65,86,21,88,1180,894,22,39,85,20,72,1132,
20221011,742,107,남사진위,안성,1545,45,50,30,9,113,1792,1164,32,55,24,5,100,1380,
20221011,742,108,남사진위,천안,1307,29,43,26,10,79,1494,1151,30,36,19,7,67,1310,
20221011,752,252,기장철마,대동,1884,63,69,40,65,159,2280,1848,63,62,33,118,140,2264,
20221011,753,252,금정,대동,1050,55,74,59,90,64,1392,1890,86,108,90,143,122,2439,
20221011,755,140,광재,부산,951,14,20,6,41,68,1100,1089,18,26,9,38,67,1247,
20221011,755,252,광재,대동,2362,109,90,49,399,141,3150,2426,108,106,60,289,160,3149,
20221011,756,252,한림,대동,936,58,29,24,106,46,1199,877,55,33,22,98,44,1129,
20221011,772,774,북달성,남칠곡,2396,45,57,35,34,150,2717,2510,43,62,42,36,165,2858,
20221011,773,774,북다사,남칠곡,1291,28,15,16,21,76,1447,1261,27,19,12,18,71,1408,
20221011,774,772,남칠곡,북달성,2510,43,62,42,36,165,2858,2396,45,57,35,34,150,2717,
20221011,774,773,남칠곡,북다사,1261,27,19,12,18,71,1408,1291,28,15,16,21,76,1447,
20221011,775,203,동명동호,가산,1650,66,44,50,187,81,2078,1696,46,41,51,233,83,2150,
20221011,776,777,연경,파군재,3312,53,30,34,25,228,3682,2456,48,44,27,19,166,2760,
20221011,776,779,연경,율암,5811,83,66,76,155,457,6648,6146,95,88,79,142,460,7010,
20221011,777,776,파군재,연경,2456,48,44,27,19,166,2760,3312,53,30,34,25,228,3682,
20221011,777,779,파군재,율암,2354,16,11,7,8,219,2615,2285,14,18,4,12,228,2561,
20221011,779,776,율암,연경,6146,95,88,79,142,460,7010,5811,83,66,76,155,457,6648,
20221011,779,777,율암,파군재,2285,14,18,4,12,228,2561,2354,16,11,7,8,219,2615,
20221011,876,675,양감,서오산,2054,75,37,38,124,144,2472,1859,58,43,50,151,116,2277,
20221011,876,677,양감,북평택,2048,145,181,230,109,120,2833,2361,160,160,207,124,137,3149,
20221011,981,982,서영암,강진무위사,1870,43,80,61,54,85,2193,1788,37,91,73,59,86,2134,
20221011,981,987,서영암,남순천,1445,22,77,65,317,49,1975,1656,36,85,67,314,48,2206,
20221011,982,981,강진무위사,서영암,1788,37,91,73,59,86,2134,1870,43,80,61,54,85,2193,
20221011,984,985,보성,벌교,1486,48,59,41,80,32,1746,1269,47,54,30,61,29,1490,
20221011,984,987,보성,남순천,1782,51,67,79,320,56,2355,1860,47,58,55,284,58,2362,
20221011,985,984,벌교,보성,1269,47,54,30,61,29,1490,1486,48,59,41,80,32,1746,
20221011,986,987,고흥,남순천,3424,62,100,155,232,134,4107,3979,92,99,127,249,148,4694,
20221011,987,981,남순천,서영암,1656,36,85,67,314,48,2206,1445,22,77,65,317,49,1975,
20221011,987,984,남순천,보성,1860,47,58,55,284,58,2362,1782,51,67,79,320,56,2355,
20221011,987,986,남순천,고흥,3979,92,99,127,249,148,4694,3424,62,100,155,232,134,4107,
20221012,101,102,서울,동수원,3675,58,264,12,7,193,4209,4935,62,390,31,13,289,5720,
20221012,101,103,서울,수원신갈,15785,645,1762,403,143,796,19534,14447,690,1751,385,120,663,18056,
20221012,101,105,서울,기흥,6964,119,369,70,32,344,7898,6000,96,359,75,39,286,6855,
20221012,101,106,서울,오산,4451,385,438,161,88,268,5791,4145,425,443,184,101,281,5579,
20221012,101,107,서울,안성,3251,87,302,48,16,179,3883,2871,83,318,55,30,148,3505,
20221012,101,108,서울,천안,3736,71,322,47,11,171,4358,3495,63,355,53,27,150,4143,
20221012,101,111,서울,청주,890,22,179,29,29,43,1192,709,15,212,22,28,28,1014,
20221012,101,171,서울,마성,2040,31,264,49,4,96,2484,2448,37,310,54,4,127,2980,
20221012,101,172,서울,용인,3340,117,106,35,31,213,3842,3788,140,123,42,28,250,4371,
20221012,101,173,서울,양지,3394,219,142,115,78,137,4085,4097,384,153,173,113,166,5086,
20221012,101,229,서울,북천안,878,44,54,43,24,28,1071,822,52,53,55,25,43,1050,
20221012,101,528,서울,기흥동탄,7441,87,1198,129,11,368,9234,7473,72,1318,118,13,334,9328,
20221012,101,542,서울,서안성,1345,32,72,127,33,70,1679,1810,60,71,164,56,101,2262,
20221012,101,543,서울,남안성,1068,71,82,68,69,54,1412,1264,90,88,110,111,57,1720,
20221012,101,673,서울,북오산,1659,48,135,17,13,106,1978,1547,43,124,19,21,96,1850,
20221012,101,677,서울,북평택,2079,81,270,90,142,103,2765,1385,65,268,89,140,60,2007,
20221012,102,101,동수원,서울,4935,62,390,31,13,289,5720,3675,58,264,12,7,193,4209,
20221012,102,172,동수원,용인,1095,23,15,2,13,93,1241,1010,30,19,2,7,92,1160,
20221012,102,173,동수원,양지,1204,44,38,10,19,81,1396,1368,45,49,5,23,74,1564,
20221012,102,212,동수원,북수원,4337,25,227,48,42,243,4922,5140,52,246,62,36,310,5846,
20221012,102,213,동수원,부곡,1060,16,12,6,29,77,1200,1028,17,16,5,21,86,1173,
20221012,102,214,동수원,동군포,1502,31,21,14,7,108,1683,1570,31,16,13,8,105,1743,
20221012,102,215,동수원,군포,1589,31,22,6,25,101,1774,2353,26,45,7,20,161,2612,
20221012,102,253,동수원,서서울,5720,79,63,17,20,377,6276,5159,77,63,15,15,348,5677,
20221012,102,254,동수원,군자,3780,49,76,25,37,187,4154,3963,59,72,26,36,225,4381,
20221012,102,255,동수원,서안산,1761,41,13,14,9,88,1926,1870,39,19,11,8,126,2073,
20221012,103,101,수원신갈,서울,14447,690,1751,385,120,663,18056,15785,645,1762,403,143,796,19534,
20221012,103,105,수원신갈,기흥,1645,18,57,31,50,125,1926,2028,30,38,29,45,108,2278,
20221012,103,106,수원신갈,오산,1123,74,60,39,14,89,1399,1323,78,68,58,12,108,1647,
20221012,103,107,수원신갈,안성,914,20,43,7,5,65,1054,1079,13,43,5,4,56,1200,
20221012,103,108,수원신갈,천안,1004,7,52,12,4,42,1121,1116,12,48,15,1,53,1245,
20221012,103,253,수원신갈,서서울,1931,129,79,64,25,124,2352,2059,134,79,97,30,140,2539,
20221012,103,254,수원신갈,군자,1432,102,69,76,105,92,1876,1659,132,101,144,138,122,2296,
20221012,103,528,수원신갈,기흥동탄,1451,13,190,1,5,102,1762,2146,30,168,5,8,134,2491,
20221012,105,101,기흥,서울,6000,96,359,75,39,286,6855,6964,119,369,70,32,344,7898,
20221012,105,103,기흥,수원신갈,2028,30,38,29,45,108,2278,1645,18,57,31,50,125,1926,
20221012,105,253,기흥,서서울,900,25,5,13,12,49,1004,944,23,18,9,8,50,1052,
20221012,106,101,오산,서울,4145,425,443,184,101,281,5579,4451,385,438,161,88,268,5791,
20221012,106,103,오산,수원신갈,1323,78,68,58,12,108,1647,1123,74,60,39,14,89,1399,
20221012,106,107,오산,안성,1691,51,40,16,6,146,1950,1485,49,21,16,6,146,1723,
20221012,106,108,오산,천안,1051,29,25,14,13,65,1197,1069,22,29,23,14,79,1236,
20221012,106,528,오산,기흥동탄,866,29,44,18,9,77,1043,1002,37,52,16,11,98,1216,
20221012,107,101,안성,서울,2871,83,318,55,30,148,3505,3251,87,302,48,16,179,3883,
20221012,107,103,안성,수원신갈,1079,13,43,5,4,56,1200,914,20,43,7,5,65,1054,
20221012,107,106,안성,오산,1485,49,21,16,6,146,1723,1691,51,40,16,6,146,1950,
20221012,107,108,안성,천안,1576,27,36,11,9,139,1798,1577,41,40,11,2,146,1817,
20221012,107,528,안성,기흥동탄,1035,12,20,4,3,106,1180,1161,24,23,9,11,110,1338,
20221012,107,742,안성,남사진위,1177,42,54,23,12,112,1420,1469,35,61,24,10,122,1721,
20221012,108,101,천안,서울,3495,63,355,53,27,150,4143,3736,71,322,47,11,171,4358,
20221012,108,103,천안,수원신갈,1116,12,48,15,1,53,1245,1004,7,52,12,4,42,1121,
20221012,108,106,천안,오산,1069,22,29,23,14,79,1236,1051,29,25,14,13,65,1197,
20221012,108,107,천안,안성,1577,41,40,11,2,146,1817,1576,27,36,11,9,139,1798,
20221012,108,111,천안,청주,1070,34,60,22,41,71,1298,1072,33,53,32,33,72,1295,
20221012,108,229,천안,북천안,3547,65,131,85,30,214,4072,4007,92,155,73,67,241,4635,
20221012,108,528,천안,기흥동탄,1087,15,102,8,12,60,1284,1170,22,118,1,11,69,1391,
20221012,108,742,천안,남사진위,1077,23,30,21,3,77,1231,1123,36,30,35,9,73,1306,
20221012,111,101,청주,서울,709,15,212,22,28,28,1014,890,22,179,29,29,43,1192,
20221012,111,108,청주,천안,1072,33,53,32,33,72,1295,1070,34,60,22,41,71,1298,
20221012,112,115,남청주,대전,1620,80,61,5,10,118,1894,1672,99,59,9,4,129,1972,
20221012,113,115,신탄진,대전,979,23,16,5,8,131,1162,1166,35,16,5,6,129,1357,
20221012,114,153,남대전,서대전,1952,43,82,67,19,137,2300,1547,36,98,66,25,104,1876,
20221012,115,112,대전,남청주,1672,99,59,9,4,129,1972,1620,80,61,5,10,118,1894,
20221012,115,113,대전,신탄진,1166,35,16,5,6,129,1357,979,23,16,5,8,131,1162,
20221012,115,116,대전,옥천,2316,105,42,26,22,192,2703,2065,70,44,31,24,162,2396,
20221012,115,151,대전,북대전,1147,17,24,4,10,121,1323,969,13,21,2,5,103,1113,
20221012,115,152,대전,유성,983,14,10,4,2,75,1088,948,11,13,5,4,74,1055,
20221012,115,153,대전,서대전,949,24,11,3,3,74,1064,957,21,12,4,5,66,1065,
20221012,115,579,대전,남세종,1064,13,14,5,31,99,1226,1114,8,17,3,25,89,1256,
20221012,116,115,옥천,대전,2065,70,44,31,24,162,2396,2316,105,42,26,22,192,2703,
20221012,119,153,판암,서대전,1759,21,25,18,108,146,2077,1892,28,21,24,93,158,2216,
20221012,123,127,구미,서대구,1591,37,22,18,5,99,1772,1662,33,34,20,10,95,1854,
20221012,123,129,구미,북대구,1806,16,58,6,6,93,1985,1876,17,64,10,0,100,2067,
20221012,123,130,구미,동김천,1157,20,40,35,45,83,1380,1158,25,38,21,42,70,1354,
20221012,125,127,남구미,서대구,1861,59,104,38,29,116,2207,2027,68,132,39,20,147,2433,
20221012,125,129,남구미,북대구,1811,29,75,6,11,100,2032,2030,29,85,12,11,115,2282,
20221012,126,127,왜관,서대구,2524,115,75,44,144,135,3037,2905,136,76,42,112,151,3422,
20221012,126,129,왜관,북대구,3102,100,61,24,111,144,3542,3526,106,71,36,109,176,4024,
20221012,127,123,서대구,구미,1662,33,34,20,10,95,1854,1591,37,22,18,5,99,1772,
20221012,127,125,서대구,남구미,2027,68,132,39,20,147,2433,1861,59,104,38,29,116,2207,
20221012,127,126,서대구,왜관,2905,136,76,42,112,151,3422,2524,115,75,44,144,135,3037,
20221012,127,131,서대구,경산,2528,200,146,118,67,167,3226,1805,174,99,79,54,117,2328,
20221012,127,201,서대구,칠곡,1730,43,33,12,5,113,1936,895,22,17,3,9,67,1013,
20221012,127,203,서대구,가산,2178,61,85,46,149,97,2616,2072,58,65,42,151,98,2486,
20221012,127,230,서대구,팔공산,1487,52,35,25,5,84,1688,1025,31,29,18,6,65,1174,
20221012,127,518,서대구,칠곡물류,920,113,79,111,36,41,1300,751,97,68,82,23,43,1064,
20221012,127,621,서대구,동대구,1821,61,73,41,22,130,2148,1270,50,31,31,17,95,1494,
20221012,129,123,북대구,구미,1876,17,64,10,0,100,2067,1806,16,58,6,6,93,1985,
20221012,129,125,북대구,남구미,2030,29,85,12,11,115,2282,1811,29,75,6,11,100,2032,
20221012,129,126,북대구,왜관,3526,106,71,36,109,176,4024,3102,100,61,24,111,144,3542,
20221012,129,131,북대구,경산,2397,145,94,50,36,140,2862,2931,193,124,72,52,157,3529,
20221012,129,524,북대구,청통와촌,952,46,27,11,16,47,1099,1134,77,39,15,25,57,1347,
20221012,129,527,북대구,포항,1578,31,28,28,49,93,1807,2015,44,36,28,65,99,2287,
20221012,130,123,동김천,구미,1158,25,38,21,42,70,1354,1157,20,40,35,45,83,1380,
20221012,131,127,경산,서대구,1805,174,99,79,54,117,2328,2528,200,146,118,67,167,3226,
20221012,131,129,경산,북대구,2931,193,124,72,52,157,3529,2397,145,94,50,36,140,2862,
20221012,131,132,경산,영천,889,46,43,41,66,53,1138,878,40,64,37,39,49,1107,
20221012,131,230,경산,팔공산,1294,90,47,26,16,92,1565,1514,73,71,29,34,97,1818,
20221012,131,621,경산,동대구,2298,69,37,160,84,108,2756,2385,74,40,160,36,114,2809,
20221012,132,131,영천,경산,878,40,64,37,39,49,1107,889,46,43,41,66,53,1138,
20221012,132,621,영천,동대구,1144,10,30,3,34,49,1270,1133,15,25,3,30,47,1253,
20221012,135,140,경주,부산,1142,11,36,17,48,49,1303,1170,11,36,14,29,60,1320,
20221012,135,252,경주,대동,862,38,89,71,185,36,1281,1107,47,86,48,115,41,1444,
20221012,138,140,양산,부산,5119,255,178,257,278,265,6352,5337,302,218,258,279,268,6662,
20221012,138,252,양산,대동,2746,361,217,170,330,122,3946,3044,326,232,161,316,138,4217,
20221012,139,140,서울산,부산,1354,47,20,16,17,81,1535,1291,51,21,11,21,65,1460,
20221012,139,252,서울산,대동,851,47,40,32,41,51,1062,842,39,27,33,25,51,1017,
20221012,139,641,서울산,울산,1210,37,67,36,43,98,1491,1070,20,59,19,38,83,1289,
20221012,140,135,부산,경주,1170,11,36,14,29,60,1320,1142,11,36,17,48,49,1303,
20221012,140,138,부산,양산,5337,302,218,258,279,268,6662,5119,255,178,257,278,265,6352,
20221012,140,139,부산,서울산,1291,51,21,11,21,65,1460,1354,47,20,16,17,81,1535,
20221012,140,250,부산,남양산,7979,155,231,55,44,641,9105,7835,145,213,40,50,639,8922,
20221012,140,251,부산,물금,1070,127,30,37,66,71,1401,1046,106,31,39,74,86,1382,
20221012,140,252,부산,대동,1750,46,50,46,75,103,2070,1590,48,39,40,118,107,1942,
20221012,140,755,부산,광재,1083,19,15,11,45,64,1237,944,10,15,6,47,61,1083,
20221012,142,145,군북,산인,3872,53,113,42,77,279,4436,3800,54,105,46,49,284,4338,
20221012,143,145,장지,산인,1194,18,24,27,95,85,1443,1191,18,22,24,114,83,1452,
20221012,144,145,함안,산인,2016,44,37,30,53,139,2319,2057,49,36,25,46,145,2358,
20221012,145,142,산인,군북,3800,54,105,46,49,284,4338,3872,53,113,42,77,279,4436,
20221012,145,143,산인,장지,1191,18,22,24,114,83,1452,1194,18,24,27,95,85,1443,
20221012,145,144,산인,함안,2057,49,36,25,46,145,2358,2016,44,37,30,53,139,2319,
20221012,145,291,산인,사천,1069,36,55,12,16,47,1235,1150,50,51,18,18,50,1337,
20221012,145,292,산인,진주,1300,31,153,14,14,88,1600,1514,28,125,17,17,93,1794,
20221012,145,293,산인,문산,1117,25,20,10,2,66,1240,1045,27,33,10,6,64,1185,
20221012,146,244,동창원,서부산,1186,28,43,22,36,69,1384,1211,31,38,25,47,85,1437,
20221012,146,245,동창원,장유,998,15,9,20,26,96,1164,999,20,15,21,25,86,1166,
20221012,146,289,동창원,마산,2670,85,71,39,87,228,3180,2404,89,74,38,76,193,2874,
20221012,147,150,진례,북부산,1402,51,25,25,48,83,1634,1634,56,31,24,34,94,1873,
20221012,147,244,진례,서부산,1679,99,78,66,117,104,2143,1781,116,69,59,129,117,2271,
20221012,147,245,진례,장유,1122,79,94,66,18,104,1483,1408,68,97,57,25,147,1802,
20221012,147,289,진례,마산,1301,93,75,60,73,71,1673,1301,102,79,55,75,71,1683,
20221012,148,150,서김해,북부산,6485,129,89,110,131,538,7482,6436,121,75,97,103,500,7332,
20221012,148,251,서김해,물금,896,38,19,30,15,93,1091,908,43,16,30,12,102,1111,
20221012,148,289,서김해,마산,1369,34,58,12,14,112,1599,1363,33,55,11,13,102,1577,
20221012,149,150,동김해,북부산,10709,209,184,54,94,846,12096,9227,179,149,41,47,756,10399,
20221012,149,245,동김해,장유,842,43,78,59,10,67,1099,749,51,72,52,8,68,1000,
20221012,149,250,동김해,남양산,1076,30,51,9,3,91,1260,964,16,47,12,6,75,1120,
20221012,149,251,동김해,물금,1144,42,10,10,4,105,1315,1043,40,11,13,2,114,1223,
20221012,149,289,동김해,마산,838,34,31,24,29,64,1020,889,35,35,16,20,58,1053,
20221012,150,147,북부산,진례,1634,56,31,24,34,94,1873,1402,51,25,25,48,83,1634,
20221012,150,148,북부산,서김해,6436,121,75,97,103,500,7332,6485,129,89,110,131,538,7482,
20221012,150,149,북부산,동김해,9227,179,149,41,47,756,10399,10709,209,184,54,94,846,12096,
20221012,150,245,북부산,장유,3705,50,99,14,29,252,4149,3147,39,73,10,28,205,3502,
20221012,150,289,북부산,마산,2233,31,85,5,15,111,2480,2447,31,59,16,27,122,2702,
20221012,151,115,북대전,대전,969,13,21,2,5,103,1113,1147,17,24,4,10,121,1323,
20221012,151,153,북대전,서대전,1123,7,16,11,11,103,1271,1308,17,23,27,16,107,1498,
20221012,152,115,유성,대전,948,11,13,5,4,74,1055,983,14,10,4,2,75,1088,
20221012,152,154,유성,안영,1063,16,19,15,16,73,1202,1119,23,25,11,11,72,1261,
20221012,153,114,서대전,남대전,1547,36,98,66,25,104,1876,1952,43,82,67,19,137,2300,
20221012,153,115,서대전,대전,957,21,12,4,5,66,1065,949,24,11,3,3,74,1064,
20221012,153,119,서대전,판암,1892,28,21,24,93,158,2216,1759,21,25,18,108,146,2077,
20221012,153,151,서대전,북대전,1308,17,23,27,16,107,1498,1123,7,16,11,11,103,1271,
20221012,153,154,서대전,안영,1117,27,34,116,58,66,1418,1099,33,39,122,47,61,1401,
20221012,153,579,서대전,남세종,1186,26,16,10,12,108,1358,968,22,22,9,17,70,1108,
20221012,154,152,안영,유성,1119,23,25,11,11,72,1261,1063,16,19,15,16,73,1202,
20221012,154,153,안영,서대전,1099,33,39,122,47,61,1401,1117,27,34,116,58,66,1418,
20221012,159,167,서전주,광주,1331,70,75,64,52,60,1652,1336,65,63,44,41,58,1607,
20221012,166,167,장성,광주,2366,81,61,36,76,112,2732,3004,116,82,41,51,116,3410,
20221012,167,159,광주,서전주,1336,65,63,44,41,58,1607,1331,70,75,64,52,60,1652,
20221012,167,166,광주,장성,3004,116,82,41,51,116,3410,2366,81,61,36,76,112,2732,
20221012,167,567,광주,남고창,1350,39,57,13,33,51,1543,1339,35,50,14,37,49,1524,
20221012,171,101,마성,서울,2448,37,310,54,4,127,2980,2040,31,264,49,4,96,2484,
20221012,172,101,용인,서울,3788,140,123,42,28,250,4371,3340,117,106,35,31,213,3842,
20221012,172,102,용인,동수원,1010,30,19,2,7,92,1160,1095,23,15,2,13,93,1241,
20221012,172,173,용인,양지,1954,238,128,155,130,132,2737,1764,178,146,138,127,141,2494,
20221012,172,212,용인,북수원,918,41,16,20,15,51,1061,1159,60,20,15,27,72,1353,
20221012,172,253,용인,서서울,1120,66,19,27,15,72,1319,1036,57,19,26,18,68,1224,
20221012,173,101,양지,서울,4097,384,153,173,113,166,5086,3394,219,142,115,78,137,4085,
20221012,173,102,양지,동수원,1368,45,49,5,23,74,1564,1204,44,38,10,19,81,1396,
20221012,173,172,양지,용인,1764,178,146,138,127,141,2494,1954,238,128,155,130,132,2737,
20221012,173,212,양지,북수원,1156,95,49,60,40,69,1469,1290,114,63,47,86,65,1665,
20221012,173,253,양지,서서울,1149,156,88,152,63,57,1665,950,122,69,97,50,41,1329,
20221012,173,254,양지,군자,738,131,82,202,254,34,1441,678,114,95,175,219,30,1311,
20221012,174,179,춘천,홍천,3273,76,101,56,27,315,3848,3021,70,89,64,32,291,3567,
20221012,174,216,춘천,횡성,1008,54,34,21,19,64,1200,1063,46,28,14,26,80,1257,
20221012,174,218,춘천,남원주,1053,24,75,14,7,64,1237,1012,26,60,16,12,65,1191,
20221012,174,554,춘천,동홍천,1116,24,24,6,7,93,1270,1156,25,11,2,6,89,1289,
20221012,176,190,이천,동서울,1463,75,215,172,118,75,2118,1437,69,221,152,84,84,2047,
20221012,179,174,홍천,춘천,3021,70,89,64,32,291,3567,3273,76,101,56,27,315,3848,
20221012,184,189,대관령,강릉,1235,42,57,6,9,78,1427,1259,30,62,8,12,85,1456,
20221012,189,184,강릉,대관령,1259,30,62,8,12,85,1456,1235,42,57,6,9,78,1427,
20221012,190,176,동서울,이천,1437,69,221,152,84,84,2047,1463,75,215,172,118,75,2118,
20221012,190,191,동서울,경기광주,10874,736,513,410,275,675,13483,10406,693,473,383,370,712,13037,
20221012,190,192,동서울,곤지암,5854,554,255,201,97,371,7332,5360,478,211,182,75,348,6654,
20221012,190,193,동서울,일죽,2491,155,207,198,126,69,3246,2465,170,184,264,111,88,3282,
20221012,190,194,동서울,서이천,4221,594,321,301,155,235,5827,3202,456,250,240,120,182,4450,
20221012,190,198,동서울,서청주,893,27,58,30,31,38,1077,977,32,45,33,17,33,1137,
20221012,190,560,동서울,감곡,1001,24,50,38,113,29,1255,895,35,38,43,100,29,1140,
20221012,190,705,동서울,남이천,1443,104,67,174,109,47,1944,1635,110,58,133,88,64,2088,
20221012,191,190,경기광주,동서울,10406,693,473,383,370,712,13037,10874,736,513,410,275,675,13483,
20221012,192,190,곤지암,동서울,5360,478,211,182,75,348,6654,5854,554,255,201,97,371,7332,
20221012,192,194,곤지암,서이천,1363,299,125,161,95,96,2139,1145,182,107,117,114,98,1763,
20221012,193,190,일죽,동서울,2465,170,184,264,111,88,3282,2491,155,207,198,126,69,3246,
20221012,194,190,서이천,동서울,3202,456,250,240,120,182,4450,4221,594,321,301,155,235,5827,
20221012,194,192,서이천,곤지암,1145,182,107,117,114,98,1763,1363,299,125,161,95,96,2139,
20221012,196,198,진천,서청주,1277,36,84,40,28,69,1534,1380,43,69,34,26,86,1638,
20221012,198,190,서청주,동서울,977,32,45,33,17,33,1137,893,27,58,30,31,38,1077,
20221012,198,196,서청주,진천,1380,43,69,34,26,86,1638,1277,36,84,40,28,69,1534,
20221012,201,127,칠곡,서대구,895,22,17,3,9,67,1013,1730,43,33,12,5,113,1936,
20221012,201,203,칠곡,가산,902,38,37,48,120,45,1190,852,47,48,48,148,39,1182,
20221012,203,127,가산,서대구,2072,58,65,42,151,98,2486,2178,61,85,46,149,97,2616,
20221012,203,201,가산,칠곡,852,47,48,48,148,39,1182,902,38,37,48,120,45,1190,
20221012,203,775,가산,동명동호,1674,55,54,38,242,77,2140,1657,74,50,44,210,86,2121,
20221012,212,102,북수원,동수원,5140,52,246,62,36,310,5846,4337,25,227,48,42,243,4922,
20221012,212,172,북수원,용인,1159,60,20,15,27,72,1353,918,41,16,20,15,51,1061,
20221012,212,173,북수원,양지,1290,114,63,47,86,65,1665,1156,95,49,60,40,69,1469,
20221012,212,253,북수원,서서울,2886,54,24,13,13,174,3164,1023,27,13,11,7,58,1139,
20221012,212,254,북수원,군자,1739,30,31,21,27,101,1949,1052,26,27,16,25,71,1217,
20221012,213,102,부곡,동수원,1028,17,16,5,21,86,1173,1060,16,12,6,29,77,1200,
20221012,213,253,부곡,서서울,1474,73,33,28,160,107,1875,1046,50,27,38,133,67,1361,
20221012,213,254,부곡,군자,996,35,26,35,485,66,1643,877,36,30,43,396,53,1435,
20221012,214,102,동군포,동수원,1570,31,16,13,8,105,1743,1502,31,21,14,7,108,1683,
20221012,215,102,군포,동수원,2353,26,45,7,20,161,2612,1589,31,22,6,25,101,1774,
20221012,215,253,군포,서서울,3242,108,57,42,67,222,3738,3827,180,138,201,152,262,4760,
20221012,215,254,군포,군자,2034,64,77,31,110,155,2471,2866,146,104,152,201,184,3653,
20221012,215,255,군포,서안산,1389,49,36,18,14,106,1612,1535,66,74,89,84,124,1972,
20221012,216,174,횡성,춘천,1063,46,28,14,26,80,1257,1008,54,34,21,19,64,1200,
20221012,218,174,남원주,춘천,1012,26,60,16,12,65,1191,1053,24,75,14,7,64,1237,
20221012,218,240,남원주,제천,2088,57,59,39,49,134,2426,2104,68,55,35,29,144,2435,
20221012,225,291,서진주,사천,976,24,24,21,32,69,1146,960,14,27,21,25,65,1112,
20221012,229,101,북천안,서울,822,52,53,55,25,43,1050,878,44,54,43,24,28,1071,
20221012,229,108,북천안,천안,4007,92,155,73,67,241,4635,3547,65,131,85,30,214,4072,
20221012,230,127,팔공산,서대구,1025,31,29,18,6,65,1174,1487,52,35,25,5,84,1688,
20221012,230,131,팔공산,경산,1514,73,71,29,34,97,1818,1294,90,47,26,16,92,1565,
20221012,230,524,팔공산,청통와촌,1174,53,36,17,10,60,1350,1019,44,24,16,20,61,1184,
20221012,230,527,팔공산,포항,1537,26,14,13,13,56,1659,1362,39,14,7,23,49,1494,
20221012,231,519,화원옥포,남대구,6490,157,115,200,110,485,7557,6291,137,111,167,92,472,7270,
20221012,232,519,달성,남대구,2880,107,139,57,26,193,3402,2981,123,141,56,30,195,3526,
20221012,233,519,현풍,남대구,4976,254,226,75,209,361,6101,4439,210,210,106,188,303,5456,
20221012,237,239,남지,칠원,838,26,47,11,86,67,1075,783,20,50,22,82,56,1013,
20221012,238,239,칠서,칠원,1644,87,112,124,385,114,2466,1721,108,106,104,318,102,2459,
20221012,239,237,칠원,남지,783,20,50,22,82,56,1013,838,26,47,11,86,67,1075,
20221012,239,238,칠원,칠서,1721,108,106,104,318,102,2459,1644,87,112,124,385,114,2466,
20221012,239,519,칠원,남대구,1055,53,93,38,95,46,1380,1106,51,95,55,68,44,1419,
20221012,240,218,제천,남원주,2104,68,55,35,29,144,2435,2088,57,59,39,49,134,2426,
20221012,241,519,동고령,남대구,3050,99,82,344,77,156,3808,2925,101,87,329,78,139,3659,
20221012,242,519,고령,남대구,1611,46,48,28,145,79,1957,1639,35,53,16,141,74,1958,
20221012,244,146,서부산,동창원,1211,31,38,25,47,85,1437,1186,28,43,22,36,69,1384,
20221012,244,147,서부산,진례,1781,116,69,59,129,117,2271,1679,99,78,66,117,104,2143,
20221012,244,245,서부산,장유,12688,264,370,156,359,948,14785,12436,256,379,140,416,922,14549,
20221012,244,289,서부산,마산,2665,59,243,42,50,138,3197,2516,56,229,39,61,134,3035,
20221012,245,146,장유,동창원,999,20,15,21,25,86,1166,998,15,9,20,26,96,1164,
20221012,245,147,장유,진례,1408,68,97,57,25,147,1802,1122,79,94,66,18,104,1483,
20221012,245,149,장유,동김해,749,51,72,52,8,68,1000,842,43,78,59,10,67,1099,
20221012,245,150,장유,북부산,3147,39,73,10,28,205,3502,3705,50,99,14,29,252,4149,
20221012,245,244,장유,서부산,12436,256,379,140,416,922,14549,12688,264,370,156,359,948,14785,
20221012,245,289,장유,마산,1376,41,31,20,20,111,1599,1320,35,31,28,9,113,1536,
20221012,248,261,순창,동광주,1322,24,36,8,17,61,1468,1213,23,35,14,18,61,1364,
20221012,249,261,담양,동광주,2361,42,121,29,66,114,2733,1795,38,114,30,63,88,2128,
20221012,250,140,남양산,부산,7835,145,213,40,50,639,8922,7979,155,231,55,44,641,9105,
20221012,250,149,남양산,동김해,964,16,47,12,6,75,1120,1076,30,51,9,3,91,1260,
20221012,250,252,남양산,대동,3471,148,99,134,89,244,4185,4150,176,122,115,98,281,4942,
20221012,251,140,물금,부산,1046,106,31,39,74,86,1382,1070,127,30,37,66,71,1401,
20221012,251,148,물금,서김해,908,43,16,30,12,102,1111,896,38,19,30,15,93,1091,
20221012,251,149,물금,동김해,1043,40,11,13,2,114,1223,1144,42,10,10,4,105,1315,
20221012,251,252,물금,대동,3195,214,108,158,527,237,4439,3824,223,102,157,627,305,5238,
20221012,252,135,대동,경주,1107,47,86,48,115,41,1444,862,38,89,71,185,36,1281,
20221012,252,138,대동,양산,3044,326,232,161,316,138,4217,2746,361,217,170,330,122,3946,
20221012,252,139,대동,서울산,842,39,27,33,25,51,1017,851,47,40,32,41,51,1062,
20221012,252,140,대동,부산,1590,48,39,40,118,107,1942,1750,46,50,46,75,103,2070,
20221012,252,250,대동,남양산,4150,176,122,115,98,281,4942,3471,148,99,134,89,244,4185,
20221012,252,251,대동,물금,3824,223,102,157,627,305,5238,3195,214,108,158,527,237,4439,
20221012,252,641,대동,울산,1644,64,94,35,53,91,1981,1384,64,92,41,57,76,1714,
20221012,252,752,대동,기장철마,1945,75,60,41,137,131,2389,1857,70,66,41,57,143,2234,
20221012,252,753,대동,금정,1827,110,92,92,189,125,2435,1092,71,68,55,101,73,1460,
20221012,252,755,대동,광재,2418,106,86,97,317,147,3171,2418,91,76,78,441,140,3244,
20221012,252,756,대동,한림,845,50,46,33,109,49,1132,982,72,44,29,147,51,1325,
20221012,253,102,서서울,동수원,5159,77,63,15,15,348,5677,5720,79,63,17,20,377,6276,
20221012,253,103,서서울,수원신갈,2059,134,79,97,30,140,2539,1931,129,79,64,25,124,2352,
20221012,253,105,서서울,기흥,944,23,18,9,8,50,1052,900,25,5,13,12,49,1004,
20221012,253,172,서서울,용인,1036,57,19,26,18,68,1224,1120,66,19,27,15,72,1319,
20221012,253,173,서서울,양지,950,122,69,97,50,41,1329,1149,156,88,152,63,57,1665,
20221012,253,212,서서울,북수원,1023,27,13,11,7,58,1139,2886,54,24,13,13,174,3164,
20221012,253,213,서서울,부곡,1046,50,27,38,133,67,1361,1474,73,33,28,160,107,1875,
20221012,253,215,서서울,군포,3827,180,138,201,152,262,4760,3242,108,57,42,67,222,3738,
20221012,253,255,서서울,서안산,15488,540,734,627,312,984,18685,14825,516,626,558,277,954,17756,
20221012,253,256,서서울,안산,8860,167,102,46,23,622,9820,5831,118,67,37,53,449,6555,
20221012,253,281,서서울,매송,3585,69,37,27,24,231,3973,3620,61,39,34,90,225,4069,
20221012,253,282,서서울,비봉,5508,247,227,144,323,327,6776,5485,308,277,162,406,367,7005,
20221012,253,283,서서울,발안,3630,167,175,168,164,212,4516,3553,199,167,200,153,226,4498,
20221012,253,285,서서울,서평택,1548,71,113,262,393,79,2466,1468,94,125,365,516,78,2646,
20221012,253,287,서서울,송악,1692,35,54,79,242,61,2163,1794,53,55,113,452,81,2548,
20221012,253,288,서서울,당진,1281,26,38,34,33,68,1480,1222,29,50,52,53,53,1459,
20221012,253,298,서서울,서산,2086,37,56,52,18,79,2328,2114,38,63,50,53,81,2399,
20221012,253,520,서서울,평택,1645,109,114,158,124,72,2222,2004,123,142,240,151,90,2750,
20221012,253,540,서서울,청북,719,40,67,100,58,39,1023,841,69,44,135,90,47,1226,
20221012,254,102,군자,동수원,3963,59,72,26,36,225,4381,3780,49,76,25,37,187,4154,
20221012,254,103,군자,수원신갈,1659,132,101,144,138,122,2296,1432,102,69,76,105,92,1876,
20221012,254,173,군자,양지,678,114,95,175,219,30,1311,738,131,82,202,254,34,1441,
20221012,254,212,군자,북수원,1052,26,27,16,25,71,1217,1739,30,31,21,27,101,1949,
20221012,254,213,군자,부곡,877,36,30,43,396,53,1435,996,35,26,35,485,66,1643,
20221012,254,215,군자,군포,2866,146,104,152,201,184,3653,2034,64,77,31,110,155,2471,
20221012,254,255,군자,서안산,9592,425,216,227,285,647,11392,9756,427,196,217,279,643,11518,
20221012,254,256,군자,안산,4703,123,125,53,61,384,5449,4901,125,122,51,69,407,5675,
20221012,254,282,군자,비봉,1290,117,75,81,186,87,1836,1054,107,57,73,165,72,1528,
20221012,254,283,군자,발안,1339,106,65,78,163,77,1828,976,78,61,55,107,52,1329,
20221012,255,102,서안산,동수원,1870,39,19,11,8,126,2073,1761,41,13,14,9,88,1926,
20221012,255,215,서안산,군포,1535,66,74,89,84,124,1972,1389,49,36,18,14,106,1612,
20221012,255,253,서안산,서서울,14825,516,626,558,277,954,17756,15488,540,734,627,312,984,18685,
20221012,255,254,서안산,군자,9756,427,196,217,279,643,11518,9592,425,216,227,285,647,11392,
20221012,256,253,안산,서서울,5831,118,67,37,53,449,6555,8860,167,102,46,23,622,9820,
20221012,256,254,안산,군자,4901,125,122,51,69,407,5675,4703,123,125,53,61,384,5449,
20221012,261,248,동광주,순창,1213,23,35,14,18,61,1364,1322,24,36,8,17,61,1468,
20221012,261,249,동광주,담양,1795,38,114,30,63,88,2128,2361,42,121,29,66,114,2733,
20221012,261,262,동광주,창평,1577,94,39,28,28,61,1827,1777,74,42,33,35,63,2024,
20221012,261,263,동광주,옥과,2831,31,128,23,92,128,3233,2571,20,121,19,98,135,2964,
20221012,261,265,동광주,곡성,1339,28,37,19,48,51,1522,1402,18,28,22,39,49,1558,
20221012,261,271,동광주,순천,2745,93,91,43,108,90,3170,2766,107,70,31,128,98,3200,
20221012,262,261,창평,동광주,1777,74,42,33,35,63,2024,1577,94,39,28,28,61,1827,
20221012,263,261,옥과,동광주,2571,20,121,19,98,135,2964,2831,31,128,23,92,128,3233,
20221012,265,261,곡성,동광주,1402,18,28,22,39,49,1558,1339,28,37,19,48,51,1522,
20221012,271,261,순천,동광주,2766,107,70,31,128,98,3200,2745,93,91,43,108,90,3170,
20221012,271,569,순천,북광주,737,70,39,35,128,32,1041,792,65,32,29,97,30,1045,
20221012,280,519,거창,남대구,921,21,37,5,16,51,1051,932,25,49,3,12,44,1065,
20221012,281,253,매송,서서울,3620,61,39,34,90,225,4069,3585,69,37,27,24,231,3973,
20221012,282,253,비봉,서서울,5485,308,277,162,406,367,7005,5508,247,227,144,323,327,6776,
20221012,282,254,비봉,군자,1054,107,57,73,165,72,1528,1290,117,75,81,186,87,1836,
20221012,283,253,발안,서서울,3553,199,167,200,153,226,4498,3630,167,175,168,164,212,4516,
20221012,283,254,발안,군자,976,78,61,55,107,52,1329,1339,106,65,78,163,77,1828,
20221012,285,253,서평택,서서울,1468,94,125,365,516,78,2646,1548,71,113,262,393,79,2466,
20221012,285,287,서평택,송악,683,32,88,69,622,44,1538,662,35,92,71,498,52,1410,
20221012,287,253,송악,서서울,1794,53,55,113,452,81,2548,1692,35,54,79,242,61,2163,
20221012,287,285,송악,서평택,662,35,92,71,498,52,1410,683,32,88,69,622,44,1538,
20221012,287,288,송악,당진,775,12,14,6,153,73,1033,913,11,20,8,26,98,1076,
20221012,288,253,당진,서서울,1222,29,50,52,53,53,1459,1281,26,38,34,33,68,1480,
20221012,288,287,당진,송악,913,11,20,8,26,98,1076,775,12,14,6,153,73,1033,
20221012,289,146,마산,동창원,2404,89,74,38,76,193,2874,2670,85,71,39,87,228,3180,
20221012,289,147,마산,진례,1301,102,79,55,75,71,1683,1301,93,75,60,73,71,1673,
20221012,289,148,마산,서김해,1363,33,55,11,13,102,1577,1369,34,58,12,14,112,1599,
20221012,289,149,마산,동김해,889,35,35,16,20,58,1053,838,34,31,24,29,64,1020,
20221012,289,150,마산,북부산,2447,31,59,16,27,122,2702,2233,31,85,5,15,111,2480,
20221012,289,244,마산,서부산,2516,56,229,39,61,134,3035,2665,59,243,42,50,138,3197,
20221012,289,245,마산,장유,1320,35,31,28,9,113,1536,1376,41,31,20,20,111,1599,
20221012,291,145,사천,산인,1150,50,51,18,18,50,1337,1069,36,55,12,16,47,1235,
20221012,291,225,사천,서진주,960,14,27,21,25,65,1112,976,24,24,21,32,69,1146,
20221012,291,292,사천,진주,2721,68,89,41,32,233,3184,3413,96,109,57,45,270,3990,
20221012,292,145,진주,산인,1514,28,125,17,17,93,1794,1300,31,153,14,14,88,1600,
20221012,292,291,진주,사천,3413,96,109,57,45,270,3990,2721,68,89,41,32,233,3184,
20221012,293,145,문산,산인,1045,27,33,10,6,64,1185,1117,25,20,10,2,66,1240,
20221012,298,253,서산,서서울,2114,38,63,50,53,81,2399,2086,37,56,52,18,79,2328,
20221012,508,509,무안,목포,1312,42,40,31,62,76,1563,1641,38,44,32,66,90,1911,
20221012,508,553,무안,동광산,1471,24,40,24,33,53,1645,1519,25,45,26,39,54,1708,
20221012,509,508,목포,무안,1641,38,44,32,66,90,1911,1312,42,40,31,62,76,1563,
20221012,509,553,목포,동광산,6526,190,208,135,363,238,7660,6734,169,223,186,414,227,7953,
20221012,513,515,고성,북통영,1337,39,84,17,21,84,1582,1633,34,75,16,25,114,1897,
20221012,513,516,고성,통영,2873,88,123,86,153,197,3520,2866,92,134,81,147,190,3510,
20221012,514,516,동고성,통영,1162,23,56,38,106,164,1549,1136,16,58,44,119,162,1535,
20221012,515,513,북통영,고성,1633,34,75,16,25,114,1897,1337,39,84,17,21,84,1582,
20221012,516,513,통영,고성,2866,92,134,81,147,190,3510,2873,88,123,86,153,197,3520,
20221012,516,514,통영,동고성,1136,16,58,44,119,162,1535,1162,23,56,38,106,164,1549,
20221012,518,127,칠곡물류,서대구,751,97,68,82,23,43,1064,920,113,79,111,36,41,1300,
20221012,519,231,남대구,화원옥포,6291,137,111,167,92,472,7270,6490,157,115,200,110,485,7557,
20221012,519,232,남대구,달성,2981,123,141,56,30,195,3526,2880,107,139,57,26,193,3402,
20221012,519,233,남대구,현풍,4439,210,210,106,188,303,5456,4976,254,226,75,209,361,6101,
20221012,519,239,남대구,칠원,1106,51,95,55,68,44,1419,1055,53,93,38,95,46,1380,
20221012,519,241,남대구,동고령,2925,101,87,329,78,139,3659,3050,99,82,344,77,156,3808,
20221012,519,242,남대구,고령,1639,35,53,16,141,74,1958,1611,46,48,28,145,79,1957,
20221012,519,280,남대구,거창,932,25,49,3,12,44,1065,921,21,37,5,16,51,1051,
20221012,519,730,남대구,유천,2493,59,14,0,4,160,2730,2859,55,11,1,1,205,3132,
20221012,519,731,남대구,북현풍,1969,35,34,0,1,134,2173,1558,29,9,0,0,126,1722,
20221012,520,253,평택,서서울,2004,123,142,240,151,90,2750,1645,109,114,158,124,72,2222,
20221012,520,540,평택,청북,1157,102,162,149,95,66,1731,778,76,140,132,96,45,1267,
20221012,520,741,평택,평택고덕,1062,20,207,12,14,82,1397,758,17,161,16,13,56,1021,
20221012,524,129,청통와촌,북대구,1134,77,39,15,25,57,1347,952,46,27,11,16,47,1099,
20221012,524,230,청통와촌,팔공산,1019,44,24,16,20,61,1184,1174,53,36,17,10,60,1350,
20221012,527,129,포항,북대구,2015,44,36,28,65,99,2287,1578,31,28,28,49,93,1807,
20221012,527,230,포항,팔공산,1362,39,14,7,23,49,1494,1537,26,14,13,13,56,1659,
20221012,528,101,기흥동탄,서울,7473,72,1318,118,13,334,9328,7441,87,1198,129,11,368,9234,
20221012,528,103,기흥동탄,수원신갈,2146,30,168,5,8,134,2491,1451,13,190,1,5,102,1762,
20221012,528,106,기흥동탄,오산,1002,37,52,16,11,98,1216,866,29,44,18,9,77,1043,
20221012,528,107,기흥동탄,안성,1161,24,23,9,11,110,1338,1035,12,20,4,3,106,1180,
20221012,528,108,기흥동탄,천안,1170,22,118,1,11,69,1391,1087,15,102,8,12,60,1284,
20221012,540,253,청북,서서울,841,69,44,135,90,47,1226,719,40,67,100,58,39,1023,
20221012,540,520,청북,평택,778,76,140,132,96,45,1267,1157,102,162,149,95,66,1731,
20221012,540,741,청북,평택고덕,892,28,45,55,149,90,1259,893,36,68,68,167,79,1311,
20221012,542,101,서안성,서울,1810,60,71,164,56,101,2262,1345,32,72,127,33,70,1679,
20221012,542,543,서안성,남안성,1104,37,87,167,90,98,1583,1176,47,87,155,67,109,1641,
20221012,543,101,남안성,서울,1264,90,88,110,111,57,1720,1068,71,82,68,69,54,1412,
20221012,543,542,남안성,서안성,1176,47,87,155,67,109,1641,1104,37,87,167,90,98,1583,
20221012,543,555,남안성,북진천,829,111,151,170,171,35,1467,794,126,140,172,193,35,1460,
20221012,548,553,북무안,동광산,1290,24,34,32,161,42,1583,1549,25,40,22,193,41,1870,
20221012,549,553,동함평,동광산,3201,42,63,33,50,103,3492,3161,52,88,37,59,106,3503,
20221012,551,553,나주,동광산,1230,34,35,80,49,63,1491,1236,26,33,71,42,59,1467,
20221012,552,553,서광산,동광산,4497,194,187,208,248,179,5513,5928,213,227,231,210,236,7045,
20221012,553,508,동광산,무안,1519,25,45,26,39,54,1708,1471,24,40,24,33,53,1645,
20221012,553,509,동광산,목포,6734,169,223,186,414,227,7953,6526,190,208,135,363,238,7660,
20221012,553,548,동광산,북무안,1549,25,40,22,193,41,1870,1290,24,34,32,161,42,1583,
20221012,553,549,동광산,동함평,3161,52,88,37,59,106,3503,3201,42,63,33,50,103,3492,
20221012,553,551,동광산,나주,1236,26,33,71,42,59,1467,1230,34,35,80,49,63,1491,
20221012,553,552,동광산,서광산,5928,213,227,231,210,236,7045,4497,194,187,208,248,179,5513,
20221012,554,174,동홍천,춘천,1156,25,11,2,6,89,1289,1116,24,24,6,7,93,1270,
20221012,555,543,북진천,남안성,794,126,140,172,193,35,1460,829,111,151,170,171,35,1467,
20221012,560,190,감곡,동서울,895,35,38,43,100,29,1140,1001,24,50,38,113,29,1255,
20221012,567,167,남고창,광주,1339,35,50,14,37,49,1524,1350,39,57,13,33,51,1543,
20221012,569,271,북광주,순천,792,65,32,29,97,30,1045,737,70,39,35,128,32,1041,
20221012,579,115,남세종,대전,1114,8,17,3,25,89,1256,1064,13,14,5,31,99,1226,
20221012,579,153,남세종,서대전,968,22,22,9,17,70,1108,1186,26,16,10,12,108,1358,
20221012,587,589,오수,상관,1044,20,48,28,40,38,1218,1149,23,71,22,135,46,1446,
20221012,589,587,상관,오수,1149,23,71,22,135,46,1446,1044,20,48,28,40,38,1218,
20221012,597,598,서여주,북여주,1022,44,114,44,73,44,1341,1075,28,98,30,81,47,1359,
20221012,598,597,북여주,서여주,1075,28,98,30,81,47,1359,1022,44,114,44,73,44,1341,
20221012,621,127,동대구,서대구,1270,50,31,31,17,95,1494,1821,61,73,41,22,130,2148,
20221012,621,131,동대구,경산,2385,74,40,160,36,114,2809,2298,69,37,160,84,108,2756,
20221012,621,132,동대구,영천,1133,15,25,3,30,47,1253,1144,10,30,3,34,49,1270,
20221012,625,626,밀양,남밀양,1189,72,53,67,62,58,1501,1175,60,60,55,72,57,1479,
20221012,626,625,남밀양,밀양,1175,60,60,55,72,57,1479,1189,72,53,67,62,58,1501,
20221012,626,627,남밀양,삼랑진,990,29,48,18,51,107,1243,1052,29,30,23,64,92,1290,
20221012,627,626,삼랑진,남밀양,1052,29,30,23,64,92,1290,990,29,48,18,51,107,1243,
20221012,641,139,울산,서울산,1070,20,59,19,38,83,1289,1210,37,67,36,43,98,1491,
20221012,641,252,울산,대동,1384,64,92,41,57,76,1714,1644,64,94,35,53,91,1981,
20221012,641,643,울산,청량,1188,13,12,15,54,112,1394,1350,9,11,9,26,144,1549,
20221012,641,706,울산,남경주,1103,8,20,9,21,47,1208,1115,6,20,18,19,43,1221,
20221012,641,707,울산,남포항,987,13,19,16,117,46,1198,1020,20,23,28,113,59,1263,
20221012,643,641,청량,울산,1350,9,11,9,26,144,1549,1188,13,12,15,54,112,1394,
20221012,643,648,청량,해운대,2937,15,30,34,39,182,3237,3235,34,86,55,395,203,4008,
20221012,645,648,장안,해운대,1605,21,10,5,6,93,1740,2955,46,22,167,101,184,3475,
20221012,646,648,기장일광,해운대,4710,27,29,35,19,274,5094,5420,48,38,22,212,322,6062,
20221012,648,643,해운대,청량,3235,34,86,55,395,203,4008,2937,15,30,34,39,182,3237,
20221012,648,645,해운대,장안,2955,46,22,167,101,184,3475,1605,21,10,5,6,93,1740,
20221012,648,646,해운대,기장일광,5420,48,38,22,212,322,6062,4710,27,29,35,19,274,5094,
20221012,651,652,남양주,화도,14286,553,537,499,299,1076,17250,15475,588,622,565,229,1205,18684,
20221012,651,653,남양주,서종,1812,15,7,7,12,74,1927,1896,15,10,7,16,78,2022,
20221012,651,654,남양주,설악,3702,41,73,14,9,149,3988,3415,16,62,15,8,118,3634,
20221012,651,655,남양주,강촌,2408,27,123,32,28,91,2709,2455,41,125,23,44,94,2782,
20221012,651,656,남양주,남춘천,2652,44,56,32,42,74,2900,2208,22,36,14,39,48,2367,
20221012,652,651,화도,남양주,15475,588,622,565,229,1205,18684,14286,553,537,499,299,1076,17250,
20221012,652,653,화도,서종,1368,31,22,18,12,99,1550,1482,37,30,14,8,109,1680,
20221012,652,654,화도,설악,1203,11,13,6,22,88,1343,1168,20,10,4,39,83,1324,
20221012,653,651,서종,남양주,1896,15,10,7,16,78,2022,1812,15,7,7,12,74,1927,
20221012,653,652,서종,화도,1482,37,30,14,8,109,1680,1368,31,22,18,12,99,1550,
20221012,654,651,설악,남양주,3415,16,62,15,8,118,3634,3702,41,73,14,9,149,3988,
20221012,654,652,설악,화도,1168,20,10,4,39,83,1324,1203,11,13,6,22,88,1343,
20221012,655,651,강촌,남양주,2455,41,125,23,44,94,2782,2408,27,123,32,28,91,2709,
20221012,656,651,남춘천,남양주,2208,22,36,14,39,48,2367,2652,44,56,32,42,74,2900,
20221012,671,672,봉담,정남,3370,194,101,50,180,219,4114,4002,166,93,66,225,286,4838,
20221012,671,673,봉담,북오산,1917,59,41,23,23,158,2221,2037,48,51,20,20,157,2333,
20221012,671,675,봉담,서오산,913,23,12,7,6,61,1022,955,30,20,11,19,82,1117,
20221012,671,676,봉담,향남,1422,112,53,32,31,95,1745,1324,98,41,33,20,110,1626,
20221012,671,677,봉담,북평택,7623,213,253,159,309,453,9010,7445,208,205,140,210,405,8613,
20221012,672,671,정남,봉담,4002,166,93,66,225,286,4838,3370,194,101,50,180,219,4114,
20221012,673,101,북오산,서울,1547,43,124,19,21,96,1850,1659,48,135,17,13,106,1978,
20221012,673,671,북오산,봉담,2037,48,51,20,20,157,2333,1917,59,41,23,23,158,2221,
20221012,673,677,북오산,북평택,1947,34,92,36,32,139,2280,1937,37,56,27,14,129,2200,
20221012,675,671,서오산,봉담,955,30,20,11,19,82,1117,913,23,12,7,6,61,1022,
20221012,675,676,서오산,향남,3611,126,90,61,58,244,4190,3267,105,62,50,32,202,3718,
20221012,675,677,서오산,북평택,11558,263,404,170,207,746,13348,11083,252,374,173,167,721,12770,
20221012,675,876,서오산,양감,1852,64,47,39,348,121,2471,2250,72,33,33,314,180,2882,
20221012,676,671,향남,봉담,1324,98,41,33,20,110,1626,1422,112,53,32,31,95,1745,
20221012,676,675,향남,서오산,3267,105,62,50,32,202,3718,3611,126,90,61,58,244,4190,
20221012,676,677,향남,북평택,1747,186,156,222,151,103,2565,1478,156,137,170,115,76,2132,
20221012,677,101,북평택,서울,1385,65,268,89,140,60,2007,2079,81,270,90,142,103,2765,
20221012,677,671,북평택,봉담,7445,208,205,140,210,405,8613,7623,213,253,159,309,453,9010,
20221012,677,673,북평택,북오산,1937,37,56,27,14,129,2200,1947,34,92,36,32,139,2280,
20221012,677,675,북평택,서오산,11083,252,374,173,167,721,12770,11558,263,404,170,207,746,13348,
20221012,677,676,북평택,향남,1478,156,137,170,115,76,2132,1747,186,156,222,151,103,2565,
20221012,677,876,북평택,양감,2196,151,183,163,160,139,2992,2351,166,202,182,154,145,3200,
20221012,682,683,조암,송산마도,808,100,109,62,62,49,1190,995,109,109,74,69,49,1405,
20221012,682,684,조암,남안산,1100,176,198,136,107,48,1765,1101,167,192,142,95,49,1746,
20221012,682,685,조암,서시흥,1754,208,157,169,294,98,2680,1862,176,164,177,331,107,2817,
20221012,683,682,송산마도,조암,995,109,109,74,69,49,1405,808,100,109,62,62,49,1190,
20221012,683,684,송산마도,남안산,2715,205,165,112,185,153,3535,2315,175,126,102,137,131,2986,
20221012,683,685,송산마도,서시흥,5103,314,241,210,838,271,6977,4686,284,273,204,857,262,6566,
20221012,684,682,남안산,조암,1101,167,192,142,95,49,1746,1100,176,198,136,107,48,1765,
20221012,684,683,남안산,송산마도,2315,175,126,102,137,131,2986,2715,205,165,112,185,153,3535,
20221012,684,685,남안산,서시흥,5087,567,314,464,647,335,7414,4929,427,322,371,518,361,6928,
20221012,685,682,서시흥,조암,1862,176,164,177,331,107,2817,1754,208,157,169,294,98,2680,
20221012,685,683,서시흥,송산마도,4686,284,273,204,857,262,6566,5103,314,241,210,838,271,6977,
20221012,685,684,서시흥,남안산,4929,427,322,371,518,361,6928,5087,567,314,464,647,335,7414,
20221012,705,190,남이천,동서울,1635,110,58,133,88,64,2088,1443,104,67,174,109,47,1944,
20221012,706,641,남경주,울산,1115,6,20,18,19,43,1221,1103,8,20,9,21,47,1208,
20221012,706,707,남경주,남포항,919,26,75,30,221,58,1329,1022,35,60,41,181,59,1398,
20221012,707,641,남포항,울산,1020,20,23,28,113,59,1263,987,13,19,16,117,46,1198,
20221012,707,706,남포항,남경주,1022,35,60,41,181,59,1398,919,26,75,30,221,58,1329,
20221012,707,708,남포항,동경주,1207,25,32,25,323,78,1690,1282,31,31,24,360,80,1808,
20221012,708,707,동경주,남포항,1282,31,31,24,360,80,1808,1207,25,32,25,323,78,1690,
20221012,715,716,동안동,청송,1048,21,18,12,21,41,1161,1075,28,19,6,33,41,1202,
20221012,716,715,청송,동안동,1075,28,19,6,33,41,1202,1048,21,18,12,21,41,1161,
20221012,730,519,유천,남대구,2859,55,11,1,1,205,3132,2493,59,14,0,4,160,2730,
20221012,731,519,북현풍,남대구,1558,29,9,0,0,126,1722,1969,35,34,0,1,134,2173,
20221012,741,520,평택고덕,평택,758,17,161,16,13,56,1021,1062,20,207,12,14,82,1397,
20221012,741,540,평택고덕,청북,893,36,68,68,167,79,1311,892,28,45,55,149,90,1259,
20221012,742,107,남사진위,안성,1469,35,61,24,10,122,1721,1177,42,54,23,12,112,1420,
20221012,742,108,남사진위,천안,1123,36,30,35,9,73,1306,1077,23,30,21,3,77,1231,
20221012,752,252,기장철마,대동,1857,70,66,41,57,143,2234,1945,75,60,41,137,131,2389,
20221012,753,252,금정,대동,1092,71,68,55,101,73,1460,1827,110,92,92,189,125,2435,
20221012,755,140,광재,부산,944,10,15,6,47,61,1083,1083,19,15,11,45,64,1237,
20221012,755,252,광재,대동,2418,91,76,78,441,140,3244,2418,106,86,97,317,147,3171,
20221012,756,252,한림,대동,982,72,44,29,147,51,1325,845,50,46,33,109,49,1132,
20221012,772,774,북달성,남칠곡,2445,59,50,36,44,158,2792,2481,54,61,50,34,135,2815,
20221012,773,774,북다사,남칠곡,1327,29,13,11,26,97,1503,1245,24,22,11,18,90,1410,
20221012,774,772,남칠곡,북달성,2481,54,61,50,34,135,2815,2445,59,50,36,44,158,2792,
20221012,774,773,남칠곡,북다사,1245,24,22,11,18,90,1410,1327,29,13,11,26,97,1503,
20221012,775,203,동명동호,가산,1657,74,50,44,210,86,2121,1674,55,54,38,242,77,2140,
20221012,776,777,연경,파군재,3303,43,37,19,28,242,3672,2418,32,36,17,28,157,2688,
20221012,776,779,연경,율암,5857,88,84,79,120,417,6645,6003,135,89,76,126,448,6877,
20221012,777,776,파군재,연경,2418,32,36,17,28,157,2688,3303,43,37,19,28,242,3672,
20221012,777,779,파군재,율암,2454,25,15,6,6,218,2724,2452,16,14,7,6,213,2708,
20221012,779,776,율암,연경,6003,135,89,76,126,448,6877,5857,88,84,79,120,417,6645,
20221012,779,777,율암,파군재,2452,16,14,7,6,213,2708,2454,25,15,6,6,218,2724,
20221012,876,675,양감,서오산,2250,72,33,33,314,180,2882,1852,64,47,39,348,121,2471,
20221012,876,677,양감,북평택,2351,166,202,182,154,145,3200,2196,151,183,163,160,139,2992,
20221012,981,982,서영암,강진무위사,1747,35,77,57,53,67,2036,1742,30,81,79,53,79,2064,
20221012,981,987,서영암,남순천,1492,32,87,79,325,45,2060,1549,48,98,110,354,48,2207,
20221012,982,981,강진무위사,서영암,1742,30,81,79,53,79,2064,1747,35,77,57,53,67,2036,
20221012,984,985,보성,벌교,1370,54,66,54,69,50,1663,1230,51,59,31,48,41,1460,
20221012,984,987,보성,남순천,1690,40,96,85,315,66,2292,1682,57,73,75,279,67,2233,
20221012,985,984,벌교,보성,1230,51,59,31,48,41,1460,1370,54,66,54,69,50,1663,
20221012,986,987,고흥,남순천,3372,72,123,155,245,126,4093,3762,79,115,150,272,148,4526,
20221012,987,981,남순천,서영암,1549,48,98,110,354,48,2207,1492,32,87,79,325,45,2060,
20221012,987,984,남순천,보성,1682,57,73,75,279,67,2233,1690,40,96,85,315,66,2292,
20221012,987,986,남순천,고흥,3762,79,115,150,272,148,4526,3372,72,123,155,245,126,4093,
20221013,101,102,서울,동수원,3663,49,265,10,13,220,4220,5039,65,390,23,20,306,5843,
20221013,101,103,서울,수원신갈,15450,641,1754,437,109,723,19114,14877,692,1745,401,99,709,18523,
20221013,101,105,서울,기흥,7322,119,402,79,25,359,8306,6140,103,357,99,52,282,7033,
20221013,101,106,서울,오산,4377,393,439,171,75,285,5740,4454,478,494,222,94,272,6014,
20221013,101,107,서울,안성,3301,79,327,36,15,176,3934,2941,77,298,62,25,136,3539,
20221013,101,108,서울,천안,3786,69,347,38,12,152,4404,3629,59,352,49,21,145,4255,
20221013,101,111,서울,청주,928,16,175,26,34,40,1219,799,12,209,22,26,22,1090,
20221013,101,171,서울,마성,2307,36,330,57,1,115,2846,2655,27,350,57,3,146,3238,
20221013,101,172,서울,용인,3437,155,123,46,29,228,4018,3898,167,130,58,25,239,4517,
20221013,101,173,서울,양지,3602,226,125,110,79,136,4278,4382,405,145,155,100,158,5345,
20221013,101,175,서울,덕평,786,71,92,54,8,45,1056,782,113,91,44,30,45,1105,
20221013,101,229,서울,북천안,841,47,49,55,24,36,1052,889,62,47,59,22,36,1115,
20221013,101,528,서울,기흥동탄,7177,75,1185,129,12,352,8930,7441,73,1315,132,14,352,9327,
20221013,101,542,서울,서안성,1337,42,90,109,34,69,1681,1767,44,77,183,53,98,2222,
20221013,101,543,서울,남안성,1228,72,65,69,72,44,1550,1330,94,81,94,93,56,1748,
20221013,101,673,서울,북오산,1695,47,128,30,16,109,2025,1610,47,126,22,20,87,1912,
20221013,101,677,서울,북평택,1799,66,272,101,108,81,2427,1451,67,243,81,141,63,2046,
20221013,102,101,동수원,서울,5039,65,390,23,20,306,5843,3663,49,265,10,13,220,4220,
20221013,102,172,동수원,용인,1144,28,14,3,5,83,1277,1080,37,20,1,1,84,1223,
20221013,102,173,동수원,양지,1204,41,35,3,23,74,1380,1348,39,37,9,14,82,1529,
20221013,102,212,동수원,북수원,4439,23,234,46,27,237,5006,4818,43,223,58,18,288,5448,
20221013,102,213,동수원,부곡,1070,21,15,5,25,70,1206,1074,11,21,4,19,84,1213,
20221013,102,214,동수원,동군포,1480,36,20,10,8,112,1666,1717,22,20,9,5,106,1879,
20221013,102,215,동수원,군포,1602,20,36,7,13,90,1768,2333,21,47,5,5,154,2565,
20221013,102,253,동수원,서서울,5942,70,63,12,21,378,6486,5190,63,70,21,12,320,5676,
20221013,102,254,동수원,군자,3874,51,83,16,27,218,4269,4255,57,85,30,37,273,4737,
20221013,102,255,동수원,서안산,1788,46,19,8,6,94,1961,1892,39,22,11,6,112,2082,
20221013,103,101,수원신갈,서울,14877,692,1745,401,99,709,18523,15450,641,1754,437,109,723,19114,
20221013,103,105,수원신갈,기흥,1696,23,45,75,17,105,1961,2166,29,45,69,22,128,2459,
20221013,103,106,수원신갈,오산,1146,75,60,39,17,86,1423,1385,70,64,49,9,96,1673,
20221013,103,107,수원신갈,안성,868,19,42,9,3,68,1009,1068,21,48,4,2,81,1224,
20221013,103,108,수원신갈,천안,963,11,59,8,3,36,1080,1193,8,52,16,2,61,1332,
20221013,103,212,수원신갈,북수원,848,48,34,18,16,57,1021,1283,66,42,40,11,73,1515,
20221013,103,253,수원신갈,서서울,1956,146,74,70,34,123,2403,2066,152,93,79,37,119,2546,
20221013,103,254,수원신갈,군자,1388,103,73,61,96,86,1807,1797,128,87,119,144,106,2381,
20221013,103,528,수원신갈,기흥동탄,1477,7,191,6,8,98,1787,2180,18,176,5,9,136,2524,
20221013,105,101,기흥,서울,6140,103,357,99,52,282,7033,7322,119,402,79,25,359,8306,
20221013,105,103,기흥,수원신갈,2166,29,45,69,22,128,2459,1696,23,45,75,17,105,1961,
20221013,105,253,기흥,서서울,956,29,8,14,8,62,1077,989,27,15,16,9,57,1113,
20221013,106,101,오산,서울,4454,478,494,222,94,272,6014,4377,393,439,171,75,285,5740,
20221013,106,103,오산,수원신갈,1385,70,64,49,9,96,1673,1146,75,60,39,17,86,1423,
20221013,106,107,오산,안성,1700,59,33,27,11,151,1981,1444,50,19,27,11,134,1685,
20221013,106,108,오산,천안,1080,26,28,22,5,67,1228,998,28,34,16,7,66,1149,
20221013,106,528,오산,기흥동탄,895,34,45,12,7,70,1063,971,43,56,21,7,80,1178,
20221013,107,101,안성,서울,2941,77,298,62,25,136,3539,3301,79,327,36,15,176,3934,
20221013,107,103,안성,수원신갈,1068,21,48,4,2,81,1224,868,19,42,9,3,68,1009,
20221013,107,106,안성,오산,1444,50,19,27,11,134,1685,1700,59,33,27,11,151,1981,
20221013,107,108,안성,천안,1602,23,47,13,9,138,1832,1509,24,48,12,4,128,1725,
20221013,107,528,안성,기흥동탄,1033,17,24,2,6,87,1169,1182,20,29,3,7,100,1341,
20221013,107,742,안성,남사진위,1286,46,58,23,7,111,1531,1446,50,65,24,7,137,1729,
20221013,108,101,천안,서울,3629,59,352,49,21,145,4255,3786,69,347,38,12,152,4404,
20221013,108,103,천안,수원신갈,1193,8,52,16,2,61,1332,963,11,59,8,3,36,1080,
20221013,108,106,천안,오산,998,28,34,16,7,66,1149,1080,26,28,22,5,67,1228,
20221013,108,107,천안,안성,1509,24,48,12,4,128,1725,1602,23,47,13,9,138,1832,
20221013,108,111,천안,청주,1066,34,67,15,39,78,1299,1122,34,52,31,29,79,1347,
20221013,108,229,천안,북천안,3701,82,136,52,49,209,4229,4067,104,140,64,79,231,4685,
20221013,108,528,천안,기흥동탄,1114,11,109,4,15,58,1311,1137,25,128,1,13,67,1371,
20221013,108,742,천안,남사진위,1070,18,41,20,4,68,1221,1118,33,36,35,13,60,1295,
20221013,111,101,청주,서울,799,12,209,22,26,22,1090,928,16,175,26,34,40,1219,
20221013,111,108,청주,천안,1122,34,52,31,29,79,1347,1066,34,67,15,39,78,1299,
20221013,112,115,남청주,대전,1578,77,70,9,8,117,1859,1626,92,70,13,9,119,1929,
20221013,113,115,신탄진,대전,1010,28,10,5,6,116,1175,1191,26,13,8,5,122,1365,
20221013,113,198,신탄진,서청주,776,34,45,56,36,55,1002,877,40,29,30,12,74,1062,
20221013,114,153,남대전,서대전,1946,44,73,60,17,123,2263,1759,53,98,76,22,120,2128,
20221013,115,112,대전,남청주,1626,92,70,13,9,119,1929,1578,77,70,9,8,117,1859,
20221013,115,113,대전,신탄진,1191,26,13,8,5,122,1365,1010,28,10,5,6,116,1175,
20221013,115,116,대전,옥천,2300,115,44,24,20,172,2675,2055,70,47,36,26,171,2405,
20221013,115,151,대전,북대전,1146,13,25,3,6,116,1309,933,13,18,2,6,106,1078,
20221013,115,152,대전,유성,957,13,14,3,0,83,1070,955,13,9,8,3,75,1063,
20221013,115,153,대전,서대전,957,26,9,3,1,71,1067,924,19,12,4,0,81,1040,
20221013,115,198,대전,서청주,943,34,9,5,3,76,1070,908,20,10,8,1,78,1025,
20221013,115,579,대전,남세종,1088,8,14,2,98,99,1309,1175,8,14,4,73,93,1367,
20221013,116,115,옥천,대전,2055,70,47,36,26,171,2405,2300,115,44,24,20,172,2675,
20221013,119,153,판암,서대전,1754,20,25,71,83,150,2103,1848,26,30,72,69,147,2192,
20221013,123,127,구미,서대구,1760,29,34,21,3,109,1956,1777,32,38,16,12,108,1983,
20221013,123,129,구미,북대구,1880,19,65,8,7,97,2076,1899,10,72,10,2,108,2101,
20221013,123,130,구미,동김천,1216,26,36,32,40,70,1420,1117,22,37,29,38,79,1322,
20221013,125,127,남구미,서대구,1883,66,98,41,24,132,2244,2128,65,126,38,16,139,2512,
20221013,125,129,남구미,북대구,1867,28,75,12,4,103,2089,2141,27,85,17,7,104,2381,
20221013,126,127,왜관,서대구,2531,129,69,45,150,130,3054,2860,132,82,44,101,154,3373,
20221013,126,129,왜관,북대구,3119,102,60,23,92,133,3529,3410,94,72,31,92,177,3876,
20221013,127,123,서대구,구미,1777,32,38,16,12,108,1983,1760,29,34,21,3,109,1956,
20221013,127,125,서대구,남구미,2128,65,126,38,16,139,2512,1883,66,98,41,24,132,2244,
20221013,127,126,서대구,왜관,2860,132,82,44,101,154,3373,2531,129,69,45,150,130,3054,
20221013,127,131,서대구,경산,2526,216,144,108,59,146,3199,1912,153,105,90,57,121,2438,
20221013,127,201,서대구,칠곡,1405,26,31,16,11,91,1580,905,19,23,4,9,68,1028,
20221013,127,203,서대구,가산,2209,66,87,59,135,112,2668,2045,58,69,37,141,113,2463,
20221013,127,230,서대구,팔공산,1499,35,39,17,7,101,1698,1069,33,37,16,3,66,1224,
20221013,127,518,서대구,칠곡물류,922,135,87,100,35,51,1330,774,97,74,81,29,39,1094,
20221013,127,527,서대구,포항,1086,38,50,19,79,53,1325,820,38,45,18,53,41,1015,
20221013,127,621,서대구,동대구,1773,78,70,38,26,114,2099,1305,56,34,34,11,95,1535,
20221013,129,123,북대구,구미,1899,10,72,10,2,108,2101,1880,19,65,8,7,97,2076,
20221013,129,125,북대구,남구미,2141,27,85,17,7,104,2381,1867,28,75,12,4,103,2089,
20221013,129,126,북대구,왜관,3410,94,72,31,92,177,3876,3119,102,60,23,92,133,3529,
20221013,129,131,북대구,경산,2404,176,87,51,42,132,2892,2996,218,107,81,45,168,3615,
20221013,129,524,북대구,청통와촌,955,43,19,8,32,38,1095,1153,76,29,17,42,50,1367,
20221013,129,527,북대구,포항,1526,32,24,27,71,59,1739,1998,47,26,28,103,92,2294,
20221013,130,123,동김천,구미,1117,22,37,29,38,79,1322,1216,26,36,32,40,70,1420,
20221013,131,127,경산,서대구,1912,153,105,90,57,121,2438,2526,216,144,108,59,146,3199,
20221013,131,129,경산,북대구,2996,218,107,81,45,168,3615,2404,176,87,51,42,132,2892,
20221013,131,132,경산,영천,884,44,47,49,58,59,1141,837,50,56,55,37,52,1087,
20221013,131,230,경산,팔공산,1348,87,44,14,11,95,1599,1547,84,49,31,24,110,1845,
20221013,131,621,경산,동대구,2280,65,42,193,74,131,2785,2598,82,46,199,41,131,3097,
20221013,132,131,영천,경산,837,50,56,55,37,52,1087,884,44,47,49,58,59,1141,
20221013,132,621,영천,동대구,1115,12,24,5,37,54,1247,1183,16,27,1,34,53,1314,
20221013,135,140,경주,부산,1082,18,40,7,65,55,1267,1140,23,35,17,45,55,1315,
20221013,135,252,경주,대동,906,32,93,65,183,36,1315,1098,46,91,57,108,52,1452,
20221013,137,140,통도사,부산,807,39,26,17,84,41,1014,775,23,39,22,102,42,1003,
20221013,138,140,양산,부산,5135,273,195,282,319,284,6488,5360,298,222,290,317,297,6784,
20221013,138,252,양산,대동,2594,317,199,164,306,121,3701,3146,320,215,157,311,136,4285,
20221013,139,140,서울산,부산,1318,39,23,11,16,69,1476,1244,39,22,11,15,64,1395,
20221013,139,641,서울산,울산,1148,38,48,31,55,105,1425,1065,24,46,21,38,76,1270,
20221013,140,135,부산,경주,1140,23,35,17,45,55,1315,1082,18,40,7,65,55,1267,
20221013,140,137,부산,통도사,775,23,39,22,102,42,1003,807,39,26,17,84,41,1014,
20221013,140,138,부산,양산,5360,298,222,290,317,297,6784,5135,273,195,282,319,284,6488,
20221013,140,139,부산,서울산,1244,39,22,11,15,64,1395,1318,39,23,11,16,69,1476,
20221013,140,250,부산,남양산,8008,148,233,48,61,619,9117,7799,139,230,45,53,641,8907,
20221013,140,251,부산,물금,1060,140,29,39,56,75,1399,1051,97,19,37,56,76,1336,
20221013,140,252,부산,대동,1652,50,45,55,61,95,1958,1670,45,34,42,94,96,1981,
20221013,140,755,부산,광재,1162,14,18,3,21,74,1292,998,17,14,5,12,72,1118,
20221013,142,145,군북,산인,4121,79,121,60,94,279,4754,4066,86,123,55,86,278,4694,
20221013,143,145,장지,산인,1249,24,34,26,118,91,1542,1254,27,42,26,130,88,1567,
20221013,144,145,함안,산인,2114,55,52,26,74,162,2483,2127,53,48,31,75,154,2488,
20221013,145,142,산인,군북,4066,86,123,55,86,278,4694,4121,79,121,60,94,279,4754,
20221013,145,143,산인,장지,1254,27,42,26,130,88,1567,1249,24,34,26,118,91,1542,
20221013,145,144,산인,함안,2127,53,48,31,75,154,2488,2114,55,52,26,74,162,2483,
20221013,145,291,산인,사천,1315,42,60,14,23,75,1529,1334,66,59,19,24,67,1569,
20221013,145,292,산인,진주,1514,31,142,19,21,90,1817,1692,40,153,25,26,92,2028,
20221013,145,293,산인,문산,1257,29,30,12,9,61,1398,1165,29,22,15,15,67,1313,
20221013,146,150,동창원,북부산,1065,22,14,4,11,71,1187,967,22,19,4,6,73,1091,
20221013,146,244,동창원,서부산,1239,29,38,23,23,82,1434,1224,30,45,29,34,86,1448,
20221013,146,245,동창원,장유,954,13,10,5,16,86,1084,957,16,14,6,28,76,1097,
20221013,146,289,동창원,마산,2785,86,67,50,90,218,3296,2516,88,70,38,68,230,3010,
20221013,147,150,진례,북부산,1401,43,32,15,51,87,1629,1638,55,36,15,29,85,1858,
20221013,147,244,진례,서부산,1728,84,70,65,105,102,2154,1883,89,72,56,106,101,2307,
20221013,147,245,진례,장유,1125,67,84,182,25,111,1594,1457,60,89,174,27,143,1950,
20221013,147,289,진례,마산,1355,106,98,67,72,79,1777,1401,109,99,66,96,88,1859,
20221013,148,150,서김해,북부산,6701,140,77,61,99,526,7604,6517,134,70,39,74,503,7337,
20221013,148,251,서김해,물금,926,40,18,29,7,94,1114,890,40,12,27,19,90,1078,
20221013,148,289,서김해,마산,1515,40,65,13,4,102,1739,1492,34,65,17,10,101,1719,
20221013,149,150,동김해,북부산,10621,210,205,49,82,872,12039,9322,180,156,44,60,734,10496,
20221013,149,250,동김해,남양산,1098,26,55,10,4,84,1277,943,24,48,10,3,77,1105,
20221013,149,251,동김해,물금,1138,41,15,11,2,117,1324,1099,39,21,9,2,93,1263,
20221013,149,289,동김해,마산,889,32,53,22,34,61,1091,899,39,42,27,27,71,1105,
20221013,150,146,북부산,동창원,967,22,19,4,6,73,1091,1065,22,14,4,11,71,1187,
20221013,150,147,북부산,진례,1638,55,36,15,29,85,1858,1401,43,32,15,51,87,1629,
20221013,150,148,북부산,서김해,6517,134,70,39,74,503,7337,6701,140,77,61,99,526,7604,
20221013,150,149,북부산,동김해,9322,180,156,44,60,734,10496,10621,210,205,49,82,872,12039,
20221013,150,245,북부산,장유,3766,39,82,14,49,266,4216,3168,45,68,7,43,204,3535,
20221013,150,289,북부산,마산,2686,30,87,11,40,161,3015,2838,36,82,21,44,162,3183,
20221013,151,115,북대전,대전,933,13,18,2,6,106,1078,1146,13,25,3,6,116,1309,
20221013,151,153,북대전,서대전,1102,14,20,16,11,98,1261,1271,20,26,23,9,99,1448,
20221013,152,115,유성,대전,955,13,9,8,3,75,1063,957,13,14,3,0,83,1070,
20221013,152,154,유성,안영,930,15,43,7,18,63,1076,1077,26,34,8,19,58,1222,
20221013,153,114,서대전,남대전,1759,53,98,76,22,120,2128,1946,44,73,60,17,123,2263,
20221013,153,115,서대전,대전,924,19,12,4,0,81,1040,957,26,9,3,1,71,1067,
20221013,153,119,서대전,판암,1848,26,30,72,69,147,2192,1754,20,25,71,83,150,2103,
20221013,153,151,서대전,북대전,1271,20,26,23,9,99,1448,1102,14,20,16,11,98,1261,
20221013,153,154,서대전,안영,1078,33,27,30,87,53,1308,1085,34,41,44,63,61,1328,
20221013,153,579,서대전,남세종,1193,18,16,7,13,96,1343,1016,15,19,7,19,72,1148,
20221013,154,152,안영,유성,1077,26,34,8,19,58,1222,930,15,43,7,18,63,1076,
20221013,154,153,안영,서대전,1085,34,41,44,63,61,1328,1078,33,27,30,87,53,1308,
20221013,159,167,서전주,광주,1422,67,75,63,34,38,1699,1293,68,62,45,30,54,1552,
20221013,166,167,장성,광주,2450,80,63,32,60,119,2804,3081,124,74,40,43,122,3484,
20221013,167,159,광주,서전주,1293,68,62,45,30,54,1552,1422,67,75,63,34,38,1699,
20221013,167,166,광주,장성,3081,124,74,40,43,122,3484,2450,80,63,32,60,119,2804,
20221013,167,567,광주,남고창,1340,38,55,14,32,52,1531,1370,32,49,15,27,42,1535,
20221013,171,101,마성,서울,2655,27,350,57,3,146,3238,2307,36,330,57,1,115,2846,
20221013,172,101,용인,서울,3898,167,130,58,25,239,4517,3437,155,123,46,29,228,4018,
20221013,172,102,용인,동수원,1080,37,20,1,1,84,1223,1144,28,14,3,5,83,1277,
20221013,172,173,용인,양지,1954,253,151,145,83,143,2729,1750,194,134,136,89,153,2456,
20221013,172,212,용인,북수원,938,38,16,19,12,72,1095,1170,63,27,16,25,76,1377,
20221013,172,253,용인,서서울,1100,55,24,34,25,66,1304,1011,56,21,23,19,50,1180,
20221013,173,101,양지,서울,4382,405,145,155,100,158,5345,3602,226,125,110,79,136,4278,
20221013,173,102,양지,동수원,1348,39,37,9,14,82,1529,1204,41,35,3,23,74,1380,
20221013,173,172,양지,용인,1750,194,134,136,89,153,2456,1954,253,151,145,83,143,2729,
20221013,173,212,양지,북수원,1141,87,47,65,47,77,1464,1196,88,45,50,97,69,1545,
20221013,173,253,양지,서서울,1319,140,65,130,54,55,1763,879,140,54,107,54,43,1277,
20221013,173,254,양지,군자,726,129,79,188,264,41,1427,711,120,104,190,243,38,1406,
20221013,174,179,춘천,홍천,3184,85,111,46,32,301,3759,2971,94,84,43,30,304,3526,
20221013,174,216,춘천,횡성,978,51,28,20,27,56,1160,1015,49,23,12,28,53,1180,
20221013,174,218,춘천,남원주,1103,42,75,9,20,66,1315,1114,24,76,19,22,65,1320,
20221013,174,554,춘천,동홍천,1096,25,26,8,5,73,1233,1133,19,26,4,5,85,1272,
20221013,175,101,덕평,서울,782,113,91,44,30,45,1105,786,71,92,54,8,45,1056,
20221013,176,190,이천,동서울,1526,72,189,164,136,67,2154,1550,62,211,154,99,74,2150,
20221013,179,174,홍천,춘천,2971,94,84,43,30,304,3526,3184,85,111,46,32,301,3759,
20221013,184,189,대관령,강릉,1266,48,63,13,15,80,1485,1173,44,60,12,19,87,1395,
20221013,189,184,강릉,대관령,1173,44,60,12,19,87,1395,1266,48,63,13,15,80,1485,
20221013,190,176,동서울,이천,1550,62,211,154,99,74,2150,1526,72,189,164,136,67,2154,
20221013,190,191,동서울,경기광주,10676,731,483,391,247,716,13244,10109,659,436,394,315,707,12620,
20221013,190,192,동서울,곤지암,5950,505,262,219,95,370,7401,5239,452,181,197,87,331,6487,
20221013,190,193,동서울,일죽,2447,163,190,188,126,78,3192,2661,196,191,235,119,85,3487,
20221013,190,194,동서울,서이천,4312,606,337,295,165,230,5945,3356,445,276,232,143,174,4626,
20221013,190,560,동서울,감곡,1056,28,46,35,88,32,1285,1121,61,44,40,79,27,1372,
20221013,190,705,동서울,남이천,1465,92,67,133,145,64,1966,1820,130,61,118,98,63,2290,
20221013,191,190,경기광주,동서울,10109,659,436,394,315,707,12620,10676,731,483,391,247,716,13244,
20221013,192,190,곤지암,동서울,5239,452,181,197,87,331,6487,5950,505,262,219,95,370,7401,
20221013,192,194,곤지암,서이천,1368,264,125,162,99,108,2126,1183,181,106,144,112,96,1822,
20221013,193,190,일죽,동서울,2661,196,191,235,119,85,3487,2447,163,190,188,126,78,3192,
20221013,194,190,서이천,동서울,3356,445,276,232,143,174,4626,4312,606,337,295,165,230,5945,
20221013,194,192,서이천,곤지암,1183,181,106,144,112,96,1822,1368,264,125,162,99,108,2126,
20221013,196,198,진천,서청주,1188,36,81,44,26,80,1455,1045,36,69,24,25,83,1282,
20221013,198,113,서청주,신탄진,877,40,29,30,12,74,1062,776,34,45,56,36,55,1002,
20221013,198,115,서청주,대전,908,20,10,8,1,78,1025,943,34,9,5,3,76,1070,
20221013,198,196,서청주,진천,1045,36,69,24,25,83,1282,1188,36,81,44,26,80,1455,
20221013,201,127,칠곡,서대구,905,19,23,4,9,68,1028,1405,26,31,16,11,91,1580,
20221013,201,203,칠곡,가산,939,42,33,82,113,58,1267,905,47,53,73,132,43,1253,
20221013,203,127,가산,서대구,2045,58,69,37,141,113,2463,2209,66,87,59,135,112,2668,
20221013,203,201,가산,칠곡,905,47,53,73,132,43,1253,939,42,33,82,113,58,1267,
20221013,203,775,가산,동명동호,1829,63,44,64,271,84,2355,1831,92,49,58,227,70,2327,
20221013,212,102,북수원,동수원,4818,43,223,58,18,288,5448,4439,23,234,46,27,237,5006,
20221013,212,103,북수원,수원신갈,1283,66,42,40,11,73,1515,848,48,34,18,16,57,1021,
20221013,212,172,북수원,용인,1170,63,27,16,25,76,1377,938,38,16,19,12,72,1095,
20221013,212,173,북수원,양지,1196,88,45,50,97,69,1545,1141,87,47,65,47,77,1464,
20221013,212,253,북수원,서서울,2813,54,33,16,11,187,3114,1024,24,16,8,11,71,1154,
20221013,212,254,북수원,군자,1710,31,34,16,20,107,1918,1225,31,26,10,19,66,1377,
20221013,213,102,부곡,동수원,1074,11,21,4,19,84,1213,1070,21,15,5,25,70,1206,
20221013,213,253,부곡,서서울,1468,75,42,29,181,96,1891,1057,57,36,39,161,69,1419,
20221013,213,254,부곡,군자,927,29,25,40,444,67,1532,881,30,23,38,365,42,1379,
20221013,214,102,동군포,동수원,1717,22,20,9,5,106,1879,1480,36,20,10,8,112,1666,
20221013,215,102,군포,동수원,2333,21,47,5,5,154,2565,1602,20,36,7,13,90,1768,
20221013,215,253,군포,서서울,3175,90,66,38,65,199,3633,3708,129,141,187,117,255,4537,
20221013,215,254,군포,군자,1987,70,53,43,93,150,2396,2906,134,107,140,167,214,3668,
20221013,215,255,군포,서안산,1296,44,37,19,17,89,1502,1463,69,76,79,82,121,1890,
20221013,216,174,횡성,춘천,1015,49,23,12,28,53,1180,978,51,28,20,27,56,1160,
20221013,218,174,남원주,춘천,1114,24,76,19,22,65,1320,1103,42,75,9,20,66,1315,
20221013,218,240,남원주,제천,2036,55,40,25,58,149,2363,2139,54,44,26,31,145,2439,
20221013,225,291,서진주,사천,998,27,22,6,27,78,1158,1047,25,29,10,42,69,1222,
20221013,229,101,북천안,서울,889,62,47,59,22,36,1115,841,47,49,55,24,36,1052,
20221013,229,108,북천안,천안,4067,104,140,64,79,231,4685,3701,82,136,52,49,209,4229,
20221013,230,127,팔공산,서대구,1069,33,37,16,3,66,1224,1499,35,39,17,7,101,1698,
20221013,230,131,팔공산,경산,1547,84,49,31,24,110,1845,1348,87,44,14,11,95,1599,
20221013,230,524,팔공산,청통와촌,1195,49,24,32,17,63,1380,1008,40,25,28,25,54,1180,
20221013,230,527,팔공산,포항,1591,34,28,12,21,69,1755,1431,26,13,6,25,47,1548,
20221013,231,519,화원옥포,남대구,6625,219,127,193,173,530,7867,6339,178,107,171,78,497,7370,
20221013,232,519,달성,남대구,2802,134,131,49,40,191,3347,3045,145,144,45,29,196,3604,
20221013,233,519,현풍,남대구,4974,228,204,84,117,324,5931,4336,190,225,126,140,293,5310,
20221013,238,239,칠서,칠원,1676,100,116,153,477,95,2617,1780,114,119,140,406,110,2669,
20221013,239,238,칠원,칠서,1780,114,119,140,406,110,2669,1676,100,116,153,477,95,2617,
20221013,239,519,칠원,남대구,1140,48,95,38,100,44,1465,1109,48,88,34,62,44,1385,
20221013,240,218,제천,남원주,2139,54,44,26,31,145,2439,2036,55,40,25,58,149,2363,
20221013,241,519,동고령,남대구,3042,115,81,247,118,148,3751,3071,117,92,224,137,151,3792,
20221013,242,519,고령,남대구,1637,47,58,21,223,93,2079,1750,36,60,25,235,100,2206,
20221013,244,146,서부산,동창원,1224,30,45,29,34,86,1448,1239,29,38,23,23,82,1434,
20221013,244,147,서부산,진례,1883,89,72,56,106,101,2307,1728,84,70,65,105,102,2154,
20221013,244,245,서부산,장유,12920,257,396,155,358,933,15019,12535,230,399,144,422,929,14659,
20221013,244,289,서부산,마산,3216,72,247,62,113,166,3876,2928,69,247,48,102,145,3539,
20221013,245,146,장유,동창원,957,16,14,6,28,76,1097,954,13,10,5,16,86,1084,
20221013,245,147,장유,진례,1457,60,89,174,27,143,1950,1125,67,84,182,25,111,1594,
20221013,245,150,장유,북부산,3168,45,68,7,43,204,3535,3766,39,82,14,49,266,4216,
20221013,245,244,장유,서부산,12535,230,399,144,422,929,14659,12920,257,396,155,358,933,15019,
20221013,245,289,장유,마산,1517,39,45,45,28,134,1808,1418,33,57,43,24,109,1684,
20221013,248,261,순창,동광주,1223,23,33,5,21,54,1359,1202,18,41,16,23,57,1357,
20221013,249,261,담양,동광주,2374,42,116,63,89,123,2807,1866,28,114,60,82,98,2248,
20221013,250,140,남양산,부산,7799,139,230,45,53,641,8907,8008,148,233,48,61,619,9117,
20221013,250,149,남양산,동김해,943,24,48,10,3,77,1105,1098,26,55,10,4,84,1277,
20221013,250,252,남양산,대동,3229,149,138,101,119,247,3983,4199,172,149,113,124,301,5058,
20221013,251,140,물금,부산,1051,97,19,37,56,76,1336,1060,140,29,39,56,75,1399,
20221013,251,148,물금,서김해,890,40,12,27,19,90,1078,926,40,18,29,7,94,1114,
20221013,251,149,물금,동김해,1099,39,21,9,2,93,1263,1138,41,15,11,2,117,1324,
20221013,251,252,물금,대동,3082,218,119,159,487,245,4310,3760,212,102,165,591,298,5128,
20221013,252,135,대동,경주,1098,46,91,57,108,52,1452,906,32,93,65,183,36,1315,
20221013,252,138,대동,양산,3146,320,215,157,311,136,4285,2594,317,199,164,306,121,3701,
20221013,252,140,대동,부산,1670,45,34,42,94,96,1981,1652,50,45,55,61,95,1958,
20221013,252,250,대동,남양산,4199,172,149,113,124,301,5058,3229,149,138,101,119,247,3983,
20221013,252,251,대동,물금,3760,212,102,165,591,298,5128,3082,218,119,159,487,245,4310,
20221013,252,641,대동,울산,1598,67,94,34,59,88,1940,1294,77,86,33,61,68,1619,
20221013,252,752,대동,기장철마,1835,76,49,34,123,158,2275,1778,66,55,33,50,145,2127,
20221013,252,753,대동,금정,1905,103,94,99,182,113,2496,1028,62,62,62,89,68,1371,
20221013,252,755,대동,광재,2364,98,72,79,332,163,3108,2218,89,86,79,463,139,3074,
20221013,252,756,대동,한림,856,51,36,23,109,44,1119,874,66,44,19,98,35,1136,
20221013,253,102,서서울,동수원,5190,63,70,21,12,320,5676,5942,70,63,12,21,378,6486,
20221013,253,103,서서울,수원신갈,2066,152,93,79,37,119,2546,1956,146,74,70,34,123,2403,
20221013,253,105,서서울,기흥,989,27,15,16,9,57,1113,956,29,8,14,8,62,1077,
20221013,253,172,서서울,용인,1011,56,21,23,19,50,1180,1100,55,24,34,25,66,1304,
20221013,253,173,서서울,양지,879,140,54,107,54,43,1277,1319,140,65,130,54,55,1763,
20221013,253,212,서서울,북수원,1024,24,16,8,11,71,1154,2813,54,33,16,11,187,3114,
20221013,253,213,서서울,부곡,1057,57,36,39,161,69,1419,1468,75,42,29,181,96,1891,
20221013,253,215,서서울,군포,3708,129,141,187,117,255,4537,3175,90,66,38,65,199,3633,
20221013,253,255,서서울,서안산,15320,524,694,613,274,952,18377,14718,510,624,570,255,913,17590,
20221013,253,256,서서울,안산,8755,179,87,50,42,669,9782,5913,117,67,39,67,424,6627,
20221013,253,281,서서울,매송,3569,59,36,19,30,249,3962,3802,48,37,26,89,240,4242,
20221013,253,282,서서울,비봉,5596,258,266,170,433,331,7054,6046,305,274,178,490,377,7670,
20221013,253,283,서서울,발안,3253,165,158,136,222,205,4139,3847,226,171,178,226,230,4878,
20221013,253,285,서서울,서평택,1408,47,119,257,387,91,2309,1570,105,132,350,560,82,2799,
20221013,253,287,서서울,송악,1859,35,61,67,247,90,2359,2024,49,83,102,469,74,2801,
20221013,253,288,서서울,당진,1243,24,48,31,29,57,1432,1315,31,53,51,64,51,1565,
20221013,253,298,서서울,서산,2331,36,67,46,23,110,2613,2194,43,65,57,63,90,2512,
20221013,253,520,서서울,평택,1913,124,118,192,135,96,2578,1856,99,128,229,147,71,2530,
20221013,253,540,서서울,청북,799,52,44,113,64,47,1119,837,67,58,118,85,47,1212,
20221013,253,741,서서울,평택고덕,943,33,22,25,12,68,1103,923,28,21,25,16,78,1091,
20221013,254,102,군자,동수원,4255,57,85,30,37,273,4737,3874,51,83,16,27,218,4269,
20221013,254,103,군자,수원신갈,1797,128,87,119,144,106,2381,1388,103,73,61,96,86,1807,
20221013,254,173,군자,양지,711,120,104,190,243,38,1406,726,129,79,188,264,41,1427,
20221013,254,212,군자,북수원,1225,31,26,10,19,66,1377,1710,31,34,16,20,107,1918,
20221013,254,213,군자,부곡,881,30,23,38,365,42,1379,927,29,25,40,444,67,1532,
20221013,254,215,군자,군포,2906,134,107,140,167,214,3668,1987,70,53,43,93,150,2396,
20221013,254,255,군자,서안산,9660,446,208,227,332,646,11519,9321,421,182,215,334,634,11107,
20221013,254,256,군자,안산,4721,132,131,43,57,388,5472,4949,135,117,47,56,383,5687,
20221013,254,281,군자,매송,1041,43,18,23,71,67,1263,846,24,15,14,63,56,1018,
20221013,254,282,군자,비봉,1469,133,103,82,208,84,2079,1119,92,65,55,187,76,1594,
20221013,254,283,군자,발안,1126,80,63,71,165,72,1577,1001,77,63,51,117,57,1366,
20221013,255,102,서안산,동수원,1892,39,22,11,6,112,2082,1788,46,19,8,6,94,1961,
20221013,255,215,서안산,군포,1463,69,76,79,82,121,1890,1296,44,37,19,17,89,1502,
20221013,255,253,서안산,서서울,14718,510,624,570,255,913,17590,15320,524,694,613,274,952,18377,
20221013,255,254,서안산,군자,9321,421,182,215,334,634,11107,9660,446,208,227,332,646,11519,
20221013,256,253,안산,서서울,5913,117,67,39,67,424,6627,8755,179,87,50,42,669,9782,
20221013,256,254,안산,군자,4949,135,117,47,56,383,5687,4721,132,131,43,57,388,5472,
20221013,261,248,동광주,순창,1202,18,41,16,23,57,1357,1223,23,33,5,21,54,1359,
20221013,261,249,동광주,담양,1866,28,114,60,82,98,2248,2374,42,116,63,89,123,2807,
20221013,261,262,동광주,창평,1772,83,26,32,119,81,2113,1871,65,53,34,147,87,2257,
20221013,261,263,동광주,옥과,2861,30,134,30,99,135,3289,2602,29,124,17,102,133,3007,
20221013,261,265,동광주,곡성,1405,31,46,11,60,56,1609,1474,19,40,13,54,60,1660,
20221013,261,271,동광주,순천,2737,83,101,38,112,95,3166,2868,96,111,24,122,112,3333,
20221013,262,261,창평,동광주,1871,65,53,34,147,87,2257,1772,83,26,32,119,81,2113,
20221013,263,261,옥과,동광주,2602,29,124,17,102,133,3007,2861,30,134,30,99,135,3289,
20221013,265,261,곡성,동광주,1474,19,40,13,54,60,1660,1405,31,46,11,60,56,1609,
20221013,271,261,순천,동광주,2868,96,111,24,122,112,3333,2737,83,101,38,112,95,3166,
20221013,271,569,순천,북광주,823,68,46,19,138,27,1121,792,49,54,22,104,24,1045,
20221013,280,519,거창,남대구,938,27,38,5,17,46,1071,935,28,50,8,10,50,1081,
20221013,281,253,매송,서서울,3802,48,37,26,89,240,4242,3569,59,36,19,30,249,3962,
20221013,281,254,매송,군자,846,24,15,14,63,56,1018,1041,43,18,23,71,67,1263,
20221013,282,253,비봉,서서울,6046,305,274,178,490,377,7670,5596,258,266,170,433,331,7054,
20221013,282,254,비봉,군자,1119,92,65,55,187,76,1594,1469,133,103,82,208,84,2079,
20221013,283,253,발안,서서울,3847,226,171,178,226,230,4878,3253,165,158,136,222,205,4139,
20221013,283,254,발안,군자,1001,77,63,51,117,57,1366,1126,80,63,71,165,72,1577,
20221013,285,253,서평택,서서울,1570,105,132,350,560,82,2799,1408,47,119,257,387,91,2309,
20221013,285,287,서평택,송악,708,43,101,75,662,38,1627,723,48,96,83,514,38,1502,
20221013,287,253,송악,서서울,2024,49,83,102,469,74,2801,1859,35,61,67,247,90,2359,
20221013,287,285,송악,서평택,723,48,96,83,514,38,1502,708,43,101,75,662,38,1627,
20221013,288,253,당진,서서울,1315,31,53,51,64,51,1565,1243,24,48,31,29,57,1432,
20221013,289,146,마산,동창원,2516,88,70,38,68,230,3010,2785,86,67,50,90,218,3296,
20221013,289,147,마산,진례,1401,109,99,66,96,88,1859,1355,106,98,67,72,79,1777,
20221013,289,148,마산,서김해,1492,34,65,17,10,101,1719,1515,40,65,13,4,102,1739,
20221013,289,149,마산,동김해,899,39,42,27,27,71,1105,889,32,53,22,34,61,1091,
20221013,289,150,마산,북부산,2838,36,82,21,44,162,3183,2686,30,87,11,40,161,3015,
20221013,289,244,마산,서부산,2928,69,247,48,102,145,3539,3216,72,247,62,113,166,3876,
20221013,289,245,마산,장유,1418,33,57,43,24,109,1684,1517,39,45,45,28,134,1808,
20221013,289,757,마산,진영,736,35,73,45,131,52,1072,847,46,77,64,121,52,1207,
20221013,291,145,사천,산인,1334,66,59,19,24,67,1569,1315,42,60,14,23,75,1529,
20221013,291,225,사천,서진주,1047,25,29,10,42,69,1222,998,27,22,6,27,78,1158,
20221013,291,292,사천,진주,2774,83,84,41,36,255,3273,3474,92,103,47,49,263,4028,
20221013,292,145,진주,산인,1692,40,153,25,26,92,2028,1514,31,142,19,21,90,1817,
20221013,292,291,진주,사천,3474,92,103,47,49,263,4028,2774,83,84,41,36,255,3273,
20221013,293,145,문산,산인,1165,29,22,15,15,67,1313,1257,29,30,12,9,61,1398,
20221013,298,253,서산,서서울,2194,43,65,57,63,90,2512,2331,36,67,46,23,110,2613,
20221013,508,509,무안,목포,1530,51,42,34,74,80,1811,1746,49,40,38,74,84,2031,
20221013,508,553,무안,동광산,1544,21,30,28,22,52,1697,1441,33,28,33,25,48,1608,
20221013,509,508,목포,무안,1746,49,40,38,74,84,2031,1530,51,42,34,74,80,1811,
20221013,509,553,목포,동광산,6838,179,238,151,381,251,8038,6662,158,255,202,433,241,7951,
20221013,513,515,고성,북통영,1230,27,82,11,18,95,1463,1471,39,93,10,12,107,1732,
20221013,513,516,고성,통영,2785,95,139,89,167,214,3489,2759,90,140,73,149,210,3421,
20221013,514,516,동고성,통영,1206,21,56,93,123,154,1653,1205,17,66,103,116,145,1652,
20221013,515,513,북통영,고성,1471,39,93,10,12,107,1732,1230,27,82,11,18,95,1463,
20221013,516,513,통영,고성,2759,90,140,73,149,210,3421,2785,95,139,89,167,214,3489,
20221013,516,514,통영,동고성,1205,17,66,103,116,145,1652,1206,21,56,93,123,154,1653,
20221013,518,127,칠곡물류,서대구,774,97,74,81,29,39,1094,922,135,87,100,35,51,1330,
20221013,519,231,남대구,화원옥포,6339,178,107,171,78,497,7370,6625,219,127,193,173,530,7867,
20221013,519,232,남대구,달성,3045,145,144,45,29,196,3604,2802,134,131,49,40,191,3347,
20221013,519,233,남대구,현풍,4336,190,225,126,140,293,5310,4974,228,204,84,117,324,5931,
20221013,519,239,남대구,칠원,1109,48,88,34,62,44,1385,1140,48,95,38,100,44,1465,
20221013,519,241,남대구,동고령,3071,117,92,224,137,151,3792,3042,115,81,247,118,148,3751,
20221013,519,242,남대구,고령,1750,36,60,25,235,100,2206,1637,47,58,21,223,93,2079,
20221013,519,280,남대구,거창,935,28,50,8,10,50,1081,938,27,38,5,17,46,1071,
20221013,519,730,남대구,유천,2492,67,20,2,7,182,2770,2867,60,20,1,0,212,3160,
20221013,519,731,남대구,북현풍,1921,34,28,0,2,117,2102,1527,23,7,0,0,108,1665,
20221013,520,253,평택,서서울,1856,99,128,229,147,71,2530,1913,124,118,192,135,96,2578,
20221013,520,540,평택,청북,1131,93,159,150,88,72,1693,807,103,158,137,104,39,1348,
20221013,520,741,평택,평택고덕,936,16,212,21,17,70,1272,920,25,181,16,15,67,1224,
20221013,524,129,청통와촌,북대구,1153,76,29,17,42,50,1367,955,43,19,8,32,38,1095,
20221013,524,230,청통와촌,팔공산,1008,40,25,28,25,54,1180,1195,49,24,32,17,63,1380,
20221013,527,127,포항,서대구,820,38,45,18,53,41,1015,1086,38,50,19,79,53,1325,
20221013,527,129,포항,북대구,1998,47,26,28,103,92,2294,1526,32,24,27,71,59,1739,
20221013,527,230,포항,팔공산,1431,26,13,6,25,47,1548,1591,34,28,12,21,69,1755,
20221013,528,101,기흥동탄,서울,7441,73,1315,132,14,352,9327,7177,75,1185,129,12,352,8930,
20221013,528,103,기흥동탄,수원신갈,2180,18,176,5,9,136,2524,1477,7,191,6,8,98,1787,
20221013,528,106,기흥동탄,오산,971,43,56,21,7,80,1178,895,34,45,12,7,70,1063,
20221013,528,107,기흥동탄,안성,1182,20,29,3,7,100,1341,1033,17,24,2,6,87,1169,
20221013,528,108,기흥동탄,천안,1137,25,128,1,13,67,1371,1114,11,109,4,15,58,1311,
20221013,540,253,청북,서서울,837,67,58,118,85,47,1212,799,52,44,113,64,47,1119,
20221013,540,520,청북,평택,807,103,158,137,104,39,1348,1131,93,159,150,88,72,1693,
20221013,540,741,청북,평택고덕,929,25,60,50,129,91,1284,944,35,67,63,143,110,1362,
20221013,542,101,서안성,서울,1767,44,77,183,53,98,2222,1337,42,90,109,34,69,1681,
20221013,542,543,서안성,남안성,1141,48,92,122,102,88,1593,1276,49,90,142,84,111,1752,
20221013,543,101,남안성,서울,1330,94,81,94,93,56,1748,1228,72,65,69,72,44,1550,
20221013,543,542,남안성,서안성,1276,49,90,142,84,111,1752,1141,48,92,122,102,88,1593,
20221013,543,555,남안성,북진천,851,103,149,184,143,42,1472,849,108,147,174,169,46,1493,
20221013,548,553,북무안,동광산,1307,22,19,39,60,40,1487,1392,22,23,35,70,45,1587,
20221013,549,553,동함평,동광산,3144,47,61,49,59,112,3472,2920,53,74,41,59,120,3267,
20221013,551,553,나주,동광산,1297,25,26,51,40,57,1496,1187,27,26,52,31,57,1380,
20221013,552,553,서광산,동광산,4517,199,186,211,276,180,5569,5308,201,192,239,221,203,6364,
20221013,553,508,동광산,무안,1441,33,28,33,25,48,1608,1544,21,30,28,22,52,1697,
20221013,553,509,동광산,목포,6662,158,255,202,433,241,7951,6838,179,238,151,381,251,8038,
20221013,553,548,동광산,북무안,1392,22,23,35,70,45,1587,1307,22,19,39,60,40,1487,
20221013,553,549,동광산,동함평,2920,53,74,41,59,120,3267,3144,47,61,49,59,112,3472,
20221013,553,551,동광산,나주,1187,27,26,52,31,57,1380,1297,25,26,51,40,57,1496,
20221013,553,552,동광산,서광산,5308,201,192,239,221,203,6364,4517,199,186,211,276,180,5569,
20221013,554,174,동홍천,춘천,1133,19,26,4,5,85,1272,1096,25,26,8,5,73,1233,
20221013,555,543,북진천,남안성,849,108,147,174,169,46,1493,851,103,149,184,143,42,1472,
20221013,560,190,감곡,동서울,1121,61,44,40,79,27,1372,1056,28,46,35,88,32,1285,
20221013,567,167,남고창,광주,1370,32,49,15,27,42,1535,1340,38,55,14,32,52,1531,
20221013,569,271,북광주,순천,792,49,54,22,104,24,1045,823,68,46,19,138,27,1121,
20221013,579,115,남세종,대전,1175,8,14,4,73,93,1367,1088,8,14,2,98,99,1309,
20221013,579,153,남세종,서대전,1016,15,19,7,19,72,1148,1193,18,16,7,13,96,1343,
20221013,583,584,동해,남강릉,931,34,21,14,23,66,1089,872,30,22,17,32,70,1043,
20221013,584,583,남강릉,동해,872,30,22,17,32,70,1043,931,34,21,14,23,66,1089,
20221013,587,589,오수,상관,1147,16,54,27,37,44,1325,1318,26,73,40,125,50,1632,
20221013,589,587,상관,오수,1318,26,73,40,125,50,1632,1147,16,54,27,37,44,1325,
20221013,597,598,서여주,북여주,1066,46,129,51,63,48,1403,1144,50,104,40,60,64,1462,
20221013,598,597,북여주,서여주,1144,50,104,40,60,64,1462,1066,46,129,51,63,48,1403,
20221013,621,127,동대구,서대구,1305,56,34,34,11,95,1535,1773,78,70,38,26,114,2099,
20221013,621,131,동대구,경산,2598,82,46,199,41,131,3097,2280,65,42,193,74,131,2785,
20221013,621,132,동대구,영천,1183,16,27,1,34,53,1314,1115,12,24,5,37,54,1247,
20221013,625,626,밀양,남밀양,1062,55,56,59,45,63,1340,1157,50,60,54,58,60,1439,
20221013,626,625,남밀양,밀양,1157,50,60,54,58,60,1439,1062,55,56,59,45,63,1340,
20221013,626,627,남밀양,삼랑진,1037,22,44,27,25,105,1260,1028,32,34,17,43,84,1238,
20221013,627,626,삼랑진,남밀양,1028,32,34,17,43,84,1238,1037,22,44,27,25,105,1260,
20221013,641,139,울산,서울산,1065,24,46,21,38,76,1270,1148,38,48,31,55,105,1425,
20221013,641,252,울산,대동,1294,77,86,33,61,68,1619,1598,67,94,34,59,88,1940,
20221013,641,643,울산,청량,1186,9,20,93,65,109,1482,1346,9,14,97,29,138,1633,
20221013,641,706,울산,남경주,1182,9,27,11,33,64,1326,1119,7,29,14,28,61,1258,
20221013,641,707,울산,남포항,1056,12,25,22,114,63,1292,1133,16,21,32,112,71,1385,
20221013,643,641,청량,울산,1346,9,14,97,29,138,1633,1186,9,20,93,65,109,1482,
20221013,643,648,청량,해운대,2937,18,33,31,41,186,3246,3211,31,76,59,446,207,4030,
20221013,645,648,장안,해운대,1659,13,18,10,10,104,1814,2931,41,37,115,135,204,3463,
20221013,646,648,기장일광,해운대,4769,29,36,55,10,293,5192,5483,38,40,32,196,332,6121,
20221013,648,643,해운대,청량,3211,31,76,59,446,207,4030,2937,18,33,31,41,186,3246,
20221013,648,645,해운대,장안,2931,41,37,115,135,204,3463,1659,13,18,10,10,104,1814,
20221013,648,646,해운대,기장일광,5483,38,40,32,196,332,6121,4769,29,36,55,10,293,5192,
20221013,651,652,남양주,화도,14889,583,505,521,315,1104,17917,15825,604,596,537,243,1232,19037,
20221013,651,653,남양주,서종,1917,22,17,9,31,82,2078,1904,19,20,9,31,89,2072,
20221013,651,654,남양주,설악,3839,43,85,21,21,159,4168,3515,29,74,22,12,144,3796,
20221013,651,655,남양주,강촌,2482,46,116,28,40,88,2800,2549,47,119,24,50,84,2873,
20221013,651,656,남양주,남춘천,2839,35,50,34,52,90,3100,2088,18,35,9,46,35,2231,
20221013,652,651,화도,남양주,15825,604,596,537,243,1232,19037,14889,583,505,521,315,1104,17917,
20221013,652,653,화도,서종,1419,36,28,22,30,124,1659,1547,39,26,19,22,118,1771,
20221013,652,654,화도,설악,1222,23,24,10,10,101,1390,1198,26,25,5,18,106,1378,
20221013,653,651,서종,남양주,1904,19,20,9,31,89,2072,1917,22,17,9,31,82,2078,
20221013,653,652,서종,화도,1547,39,26,19,22,118,1771,1419,36,28,22,30,124,1659,
20221013,654,651,설악,남양주,3515,29,74,22,12,144,3796,3839,43,85,21,21,159,4168,
20221013,654,652,설악,화도,1198,26,25,5,18,106,1378,1222,23,24,10,10,101,1390,
20221013,655,651,강촌,남양주,2549,47,119,24,50,84,2873,2482,46,116,28,40,88,2800,
20221013,656,651,남춘천,남양주,2088,18,35,9,46,35,2231,2839,35,50,34,52,90,3100,
20221013,671,672,봉담,정남,3186,179,101,95,135,237,3933,3943,166,103,97,143,292,4744,
20221013,671,673,봉담,북오산,2018,76,52,22,13,134,2315,2087,52,58,21,15,154,2387,
20221013,671,675,봉담,서오산,948,26,31,7,13,61,1086,956,31,21,8,7,69,1092,
20221013,671,676,봉담,향남,1450,124,51,47,34,94,1800,1407,120,51,33,24,112,1747,
20221013,671,677,봉담,북평택,7687,201,287,148,287,405,9015,7781,195,248,130,240,424,9018,
20221013,672,671,정남,봉담,3943,166,103,97,143,292,4744,3186,179,101,95,135,237,3933,
20221013,673,101,북오산,서울,1610,47,126,22,20,87,1912,1695,47,128,30,16,109,2025,
20221013,673,671,북오산,봉담,2087,52,58,21,15,154,2387,2018,76,52,22,13,134,2315,
20221013,673,677,북오산,북평택,1955,40,79,28,21,128,2251,1853,50,63,26,20,132,2144,
20221013,675,671,서오산,봉담,956,31,21,8,7,69,1092,948,26,31,7,13,61,1086,
20221013,675,676,서오산,향남,3729,135,87,40,43,235,4269,3396,93,72,30,26,228,3845,
20221013,675,677,서오산,북평택,11421,244,425,190,210,717,13207,11337,272,384,191,208,661,13053,
20221013,675,876,서오산,양감,1844,68,43,44,295,137,2431,2255,82,44,35,230,165,2811,
20221013,676,671,향남,봉담,1407,120,51,33,24,112,1747,1450,124,51,47,34,94,1800,
20221013,676,675,향남,서오산,3396,93,72,30,26,228,3845,3729,135,87,40,43,235,4269,
20221013,676,677,향남,북평택,1746,185,194,186,150,94,2555,1488,168,171,176,159,80,2242,
20221013,677,101,북평택,서울,1451,67,243,81,141,63,2046,1799,66,272,101,108,81,2427,
20221013,677,671,북평택,봉담,7781,195,248,130,240,424,9018,7687,201,287,148,287,405,9015,
20221013,677,673,북평택,북오산,1853,50,63,26,20,132,2144,1955,40,79,28,21,128,2251,
20221013,677,675,북평택,서오산,11337,272,384,191,208,661,13053,11421,244,425,190,210,717,13207,
20221013,677,676,북평택,향남,1488,168,171,176,159,80,2242,1746,185,194,186,150,94,2555,
20221013,677,876,북평택,양감,2456,169,206,311,167,150,3459,2263,179,233,308,172,137,3292,
20221013,682,683,조암,송산마도,801,91,105,77,54,37,1165,947,106,126,73,75,55,1382,
20221013,682,684,조암,남안산,1075,176,192,123,115,41,1722,1064,150,168,127,92,50,1651,
20221013,682,685,조암,서시흥,1806,212,156,178,303,103,2758,1916,181,183,164,322,98,2864,
20221013,683,682,송산마도,조암,947,106,126,73,75,55,1382,801,91,105,77,54,37,1165,
20221013,683,684,송산마도,남안산,2567,232,166,128,194,143,3430,2254,187,128,99,112,140,2920,
20221013,683,685,송산마도,서시흥,5252,317,246,223,833,282,7153,4673,291,243,216,825,258,6506,
20221013,684,682,남안산,조암,1064,150,168,127,92,50,1651,1075,176,192,123,115,41,1722,
20221013,684,683,남안산,송산마도,2254,187,128,99,112,140,2920,2567,232,166,128,194,143,3430,
20221013,684,685,남안산,서시흥,5250,550,336,446,647,371,7600,5005,391,378,379,515,345,7013,
20221013,685,682,서시흥,조암,1916,181,183,164,322,98,2864,1806,212,156,178,303,103,2758,
20221013,685,683,서시흥,송산마도,4673,291,243,216,825,258,6506,5252,317,246,223,833,282,7153,
20221013,685,684,서시흥,남안산,5005,391,378,379,515,345,7013,5250,550,336,446,647,371,7600,
20221013,705,190,남이천,동서울,1820,130,61,118,98,63,2290,1465,92,67,133,145,64,1966,
20221013,706,641,남경주,울산,1119,7,29,14,28,61,1258,1182,9,27,11,33,64,1326,
20221013,706,707,남경주,남포항,978,35,76,37,236,60,1422,1073,39,75,39,189,51,1466,
20221013,707,641,남포항,울산,1133,16,21,32,112,71,1385,1056,12,25,22,114,63,1292,
20221013,707,706,남포항,남경주,1073,39,75,39,189,51,1466,978,35,76,37,236,60,1422,
20221013,707,708,남포항,동경주,1320,23,31,23,258,68,1723,1357,21,28,27,295,75,1803,
20221013,708,707,동경주,남포항,1357,21,28,27,295,75,1803,1320,23,31,23,258,68,1723,
20221013,715,716,동안동,청송,1031,13,15,12,11,54,1136,1058,21,17,11,13,52,1172,
20221013,716,715,청송,동안동,1058,21,17,11,13,52,1172,1031,13,15,12,11,54,1136,
20221013,730,519,유천,남대구,2867,60,20,1,0,212,3160,2492,67,20,2,7,182,2770,
20221013,731,519,북현풍,남대구,1527,23,7,0,0,108,1665,1921,34,28,0,2,117,2102,
20221013,741,253,평택고덕,서서울,923,28,21,25,16,78,1091,943,33,22,25,12,68,1103,
20221013,741,520,평택고덕,평택,920,25,181,16,15,67,1224,936,16,212,21,17,70,1272,
20221013,741,540,평택고덕,청북,944,35,67,63,143,110,1362,929,25,60,50,129,91,1284,
20221013,742,107,남사진위,안성,1446,50,65,24,7,137,1729,1286,46,58,23,7,111,1531,
20221013,742,108,남사진위,천안,1118,33,36,35,13,60,1295,1070,18,41,20,4,68,1221,
20221013,752,252,기장철마,대동,1778,66,55,33,50,145,2127,1835,76,49,34,123,158,2275,
20221013,753,252,금정,대동,1028,62,62,62,89,68,1371,1905,103,94,99,182,113,2496,
20221013,755,140,광재,부산,998,17,14,5,12,72,1118,1162,14,18,3,21,74,1292,
20221013,755,252,광재,대동,2218,89,86,79,463,139,3074,2364,98,72,79,332,163,3108,
20221013,756,252,한림,대동,874,66,44,19,98,35,1136,856,51,36,23,109,44,1119,
20221013,757,289,진영,마산,847,46,77,64,121,52,1207,736,35,73,45,131,52,1072,
20221013,772,774,북달성,남칠곡,2401,47,53,47,38,138,2724,2546,51,52,48,27,172,2896,
20221013,773,774,북다사,남칠곡,1320,15,20,13,16,92,1476,1270,21,13,16,15,96,1431,
20221013,774,772,남칠곡,북달성,2546,51,52,48,27,172,2896,2401,47,53,47,38,138,2724,
20221013,774,773,남칠곡,북다사,1270,21,13,16,15,96,1431,1320,15,20,13,16,92,1476,
20221013,775,203,동명동호,가산,1831,92,49,58,227,70,2327,1829,63,44,64,271,84,2355,
20221013,776,777,연경,파군재,3468,56,36,17,39,237,3853,2517,43,36,18,37,171,2822,
20221013,776,779,연경,율암,5934,99,70,69,152,435,6759,6066,114,85,74,124,441,6904,
20221013,777,776,파군재,연경,2517,43,36,18,37,171,2822,3468,56,36,17,39,237,3853,
20221013,777,779,파군재,율암,2421,29,21,7,3,225,2706,2388,28,24,6,7,222,2675,
20221013,779,776,율암,연경,6066,114,85,74,124,441,6904,5934,99,70,69,152,435,6759,
20221013,779,777,율암,파군재,2388,28,24,6,7,222,2675,2421,29,21,7,3,225,2706,
20221013,876,675,양감,서오산,2255,82,44,35,230,165,2811,1844,68,43,44,295,137,2431,
20221013,876,677,양감,북평택,2263,179,233,308,172,137,3292,2456,169,206,311,167,150,3459,
20221013,981,982,서영암,강진무위사,1778,33,113,82,50,65,2121,1724,42,110,88,48,79,2091,
20221013,981,987,서영암,남순천,1605,35,89,77,349,48,2203,1616,39,78,105,327,35,2200,
20221013,982,981,강진무위사,서영암,1724,42,110,88,48,79,2091,1778,33,113,82,50,65,2121,
20221013,984,985,보성,벌교,1454,57,52,50,50,57,1720,1399,59,50,33,48,44,1633,
20221013,984,987,보성,남순천,1757,53,87,66,304,60,2327,1759,60,88,61,264,61,2293,
20221013,985,984,벌교,보성,1399,59,50,33,48,44,1633,1454,57,52,50,50,57,1720,
20221013,986,987,고흥,남순천,3338,68,115,177,283,129,4110,3756,71,126,171,292,152,4568,
20221013,987,981,남순천,서영암,1616,39,78,105,327,35,2200,1605,35,89,77,349,48,2203,
20221013,987,984,남순천,보성,1759,60,88,61,264,61,2293,1757,53,87,66,304,60,2327,
20221013,987,986,남순천,고흥,3756,71,126,171,292,152,4568,3338,68,115,177,283,129,4110,
20221014,101,102,서울,동수원,2943,43,266,13,3,165,3433,5000,60,401,25,7,294,5787,
20221014,101,103,서울,수원신갈,13755,611,1755,407,132,654,17314,14847,685,1745,396,128,695,18496,
20221014,101,105,서울,기흥,6485,102,391,72,21,300,7371,6220,107,377,102,29,306,7141,
20221014,101,106,서울,오산,4049,354,427,169,91,230,5320,4790,464,483,193,99,337,6366,
20221014,101,107,서울,안성,3177,75,315,34,8,188,3797,3248,72,313,57,35,184,3909,
20221014,101,108,서울,천안,3797,83,354,42,17,176,4469,4217,59,339,58,17,200,4890,
20221014,101,111,서울,청주,1098,15,226,29,34,32,1434,947,19,258,20,30,48,1322,
20221014,101,171,서울,마성,2221,16,252,49,6,106,2650,2678,24,315,54,5,130,3206,
20221014,101,172,서울,용인,3329,149,114,39,25,183,3839,4188,178,127,60,23,271,4847,
20221014,101,173,서울,양지,3479,197,139,111,71,145,4142,4868,404,165,167,108,225,5937,
20221014,101,528,서울,기흥동탄,6860,67,1191,136,11,298,8563,7513,75,1355,129,20,356,9448,
20221014,101,542,서울,서안성,1256,46,97,102,30,59,1590,1834,44,81,164,62,82,2267,
20221014,101,543,서울,남안성,1124,68,85,70,79,41,1467,1132,83,78,110,85,53,1541,
20221014,101,673,서울,북오산,1407,37,117,25,10,92,1688,1565,50,122,25,9,99,1870,
20221014,101,677,서울,북평택,1554,53,264,75,96,82,2124,1587,75,275,93,136,93,2259,
20221014,102,101,동수원,서울,5000,60,401,25,7,294,5787,2943,43,266,13,3,165,3433,
20221014,102,172,동수원,용인,1103,27,14,4,1,88,1237,1051,34,17,3,1,89,1195,
20221014,102,173,동수원,양지,1339,50,39,10,18,64,1520,1415,52,33,10,3,78,1591,
20221014,102,212,동수원,북수원,4218,31,230,96,32,233,4840,4775,42,234,133,25,288,5497,
20221014,102,213,동수원,부곡,1140,21,14,8,26,97,1306,1049,14,18,4,26,95,1206,
20221014,102,214,동수원,동군포,1646,30,24,11,7,119,1837,1899,26,22,10,4,132,2093,
20221014,102,215,동수원,군포,1639,19,27,10,5,113,1813,2338,20,39,6,5,165,2573,
20221014,102,253,동수원,서서울,5507,63,61,19,21,340,6011,4925,71,71,16,19,303,5405,
20221014,102,254,동수원,군자,3574,49,64,20,38,180,3925,4194,77,79,31,40,235,4656,
20221014,102,255,동수원,서안산,1641,43,23,12,5,96,1820,1871,39,23,14,5,124,2076,
20221014,103,101,수원신갈,서울,14847,685,1745,396,128,695,18496,13755,611,1755,407,132,654,17314,
20221014,103,105,수원신갈,기흥,1794,23,47,104,37,103,2108,2334,26,35,91,34,135,2655,
20221014,103,106,수원신갈,오산,1036,75,62,41,15,71,1300,1423,81,62,54,7,95,1722,
20221014,103,107,수원신갈,안성,894,20,46,6,1,69,1036,972,24,45,3,1,80,1125,
20221014,103,108,수원신갈,천안,1024,9,50,9,2,46,1140,1264,9,48,15,3,54,1393,
20221014,103,253,수원신갈,서서울,1552,107,72,58,20,121,1930,2109,131,94,80,37,133,2584,
20221014,103,254,수원신갈,군자,1192,84,54,75,65,55,1525,1659,122,77,133,109,107,2207,
20221014,103,528,수원신갈,기흥동탄,1585,10,186,2,2,88,1873,2161,27,168,3,4,109,2472,
20221014,105,101,기흥,서울,6220,107,377,102,29,306,7141,6485,102,391,72,21,300,7371,
20221014,105,103,기흥,수원신갈,2334,26,35,91,34,135,2655,1794,23,47,104,37,103,2108,
20221014,106,101,오산,서울,4790,464,483,193,99,337,6366,4049,354,427,169,91,230,5320,
20221014,106,103,오산,수원신갈,1423,81,62,54,7,95,1722,1036,75,62,41,15,71,1300,
20221014,106,107,오산,안성,1759,56,37,21,14,158,2045,1447,60,17,20,6,119,1669,
20221014,106,108,오산,천안,1157,21,30,18,9,62,1297,1096,22,30,21,7,68,1244,
20221014,106,528,오산,기흥동탄,1046,39,46,18,8,79,1236,1020,43,48,13,9,82,1215,
20221014,107,101,안성,서울,3248,72,313,57,35,184,3909,3177,75,315,34,8,188,3797,
20221014,107,103,안성,수원신갈,972,24,45,3,1,80,1125,894,20,46,6,1,69,1036,
20221014,107,106,안성,오산,1447,60,17,20,6,119,1669,1759,56,37,21,14,158,2045,
20221014,107,108,안성,천안,1585,29,54,5,8,141,1822,1579,33,51,16,7,128,1814,
20221014,107,528,안성,기흥동탄,1000,9,22,4,5,105,1145,1203,23,31,6,7,100,1370,
20221014,107,742,안성,남사진위,1292,43,61,35,8,106,1545,1351,34,58,32,10,119,1604,
20221014,108,101,천안,서울,4217,59,339,58,17,200,4890,3797,83,354,42,17,176,4469,
20221014,108,103,천안,수원신갈,1264,9,48,15,3,54,1393,1024,9,50,9,2,46,1140,
20221014,108,106,천안,오산,1096,22,30,21,7,68,1244,1157,21,30,18,9,62,1297,
20221014,108,107,천안,안성,1579,33,51,16,7,128,1814,1585,29,54,5,8,141,1822,
20221014,108,111,천안,청주,1176,40,65,14,37,82,1414,1175,29,57,30,32,69,1392,
20221014,108,229,천안,북천안,3810,73,137,83,56,212,4371,3831,95,138,104,70,249,4487,
20221014,108,528,천안,기흥동탄,1097,16,108,5,14,67,1307,1209,17,131,6,11,64,1438,
20221014,108,742,천안,남사진위,1210,37,44,20,2,76,1389,1036,32,43,42,4,77,1234,
20221014,111,101,청주,서울,947,19,258,20,30,48,1322,1098,15,226,29,34,32,1434,
20221014,111,108,청주,천안,1175,29,57,30,32,69,1392,1176,40,65,14,37,82,1414,
20221014,112,115,남청주,대전,1617,79,61,7,15,104,1883,1660,91,63,13,8,129,1964,
20221014,113,115,신탄진,대전,930,25,15,6,6,108,1090,1194,16,17,5,3,122,1357,
20221014,114,153,남대전,서대전,1988,37,59,58,18,135,2295,1745,40,82,64,18,116,2065,
20221014,115,112,대전,남청주,1660,91,63,13,8,129,1964,1617,79,61,7,15,104,1883,
20221014,115,113,대전,신탄진,1194,16,17,5,3,122,1357,930,25,15,6,6,108,1090,
20221014,115,116,대전,옥천,2606,111,43,23,77,180,3040,2216,60,40,30,74,154,2574,
20221014,115,153,대전,서대전,1097,22,5,4,0,86,1214,1008,18,9,3,10,89,1137,
20221014,115,198,대전,서청주,919,13,9,1,1,58,1001,987,14,7,5,3,74,1090,
20221014,115,579,대전,남세종,1013,14,18,4,121,85,1255,1001,9,17,2,99,73,1201,
20221014,116,115,옥천,대전,2216,60,40,30,74,154,2574,2606,111,43,23,77,180,3040,
20221014,119,153,판암,서대전,1889,20,12,11,83,177,2192,2071,29,21,9,78,155,2363,
20221014,123,127,구미,서대구,1812,31,29,10,4,116,2002,1799,26,48,12,6,110,2001,
20221014,123,129,구미,북대구,1913,13,68,6,8,96,2104,1985,19,64,6,3,107,2184,
20221014,123,130,구미,동김천,1300,21,45,47,28,82,1523,1212,29,54,42,21,92,1450,
20221014,125,127,남구미,서대구,2067,57,101,40,22,136,2423,2121,71,116,29,32,128,2497,
20221014,125,129,남구미,북대구,2072,30,75,12,9,100,2298,2154,32,88,13,7,105,2399,
20221014,126,127,왜관,서대구,2549,121,83,39,131,135,3058,2955,143,94,55,88,140,3475,
20221014,126,129,왜관,북대구,3126,96,64,20,89,138,3533,3703,110,69,16,85,183,4166,
20221014,127,123,서대구,구미,1799,26,48,12,6,110,2001,1812,31,29,10,4,116,2002,
20221014,127,125,서대구,남구미,2121,71,116,29,32,128,2497,2067,57,101,40,22,136,2423,
20221014,127,126,서대구,왜관,2955,143,94,55,88,140,3475,2549,121,83,39,131,135,3058,
20221014,127,131,서대구,경산,2557,210,158,124,82,157,3288,1812,159,110,72,68,128,2349,
20221014,127,201,서대구,칠곡,1475,22,26,10,54,97,1684,932,18,22,3,8,76,1059,
20221014,127,203,서대구,가산,2275,60,76,48,110,113,2682,2063,53,81,35,140,117,2489,
20221014,127,230,서대구,팔공산,1546,52,50,21,9,85,1763,1054,30,30,10,11,84,1219,
20221014,127,518,서대구,칠곡물류,872,116,86,101,32,47,1254,769,103,64,89,32,49,1106,
20221014,127,527,서대구,포항,1188,30,43,25,70,61,1417,919,34,35,11,55,46,1100,
20221014,127,621,서대구,동대구,1857,70,84,27,30,123,2191,1263,44,24,34,24,76,1465,
20221014,129,123,북대구,구미,1985,19,64,6,3,107,2184,1913,13,68,6,8,96,2104,
20221014,129,125,북대구,남구미,2154,32,88,13,7,105,2399,2072,30,75,12,9,100,2298,
20221014,129,126,북대구,왜관,3703,110,69,16,85,183,4166,3126,96,64,20,89,138,3533,
20221014,129,131,북대구,경산,2418,148,72,48,35,142,2863,3054,204,122,77,50,187,3694,
20221014,129,524,북대구,청통와촌,973,50,19,12,14,51,1119,1198,79,40,21,25,57,1420,
20221014,129,527,북대구,포항,1683,34,24,26,64,70,1901,2309,50,31,21,89,115,2615,
20221014,130,123,동김천,구미,1212,29,54,42,21,92,1450,1300,21,45,47,28,82,1523,
20221014,131,127,경산,서대구,1812,159,110,72,68,128,2349,2557,210,158,124,82,157,3288,
20221014,131,129,경산,북대구,3054,204,122,77,50,187,3694,2418,148,72,48,35,142,2863,
20221014,131,132,경산,영천,916,41,54,42,60,50,1163,943,51,61,55,40,44,1194,
20221014,131,230,경산,팔공산,1324,88,46,21,13,88,1580,1519,90,50,26,16,91,1792,
20221014,131,621,경산,동대구,2332,62,44,171,82,127,2818,2426,74,56,184,28,128,2896,
20221014,132,131,영천,경산,943,51,61,55,40,44,1194,916,41,54,42,60,50,1163,
20221014,132,621,영천,동대구,1274,9,28,3,46,55,1415,1239,11,21,3,45,53,1372,
20221014,135,140,경주,부산,1234,14,57,8,48,54,1415,1470,12,49,14,49,66,1660,
20221014,135,252,경주,대동,1075,34,75,60,157,54,1455,1415,54,85,55,98,64,1771,
20221014,138,140,양산,부산,5159,278,208,279,301,276,6501,5461,318,207,319,298,287,6890,
20221014,138,252,양산,대동,2646,333,204,258,341,131,3913,3031,320,208,236,316,160,4271,
20221014,139,140,서울산,부산,1357,52,29,13,29,59,1539,1492,61,28,9,31,94,1715,
20221014,139,252,서울산,대동,891,49,45,38,57,54,1134,980,37,34,36,50,50,1187,
20221014,139,641,서울산,울산,1320,40,57,26,47,105,1595,1185,22,56,9,39,84,1395,
20221014,140,135,부산,경주,1470,12,49,14,49,66,1660,1234,14,57,8,48,54,1415,
20221014,140,138,부산,양산,5461,318,207,319,298,287,6890,5159,278,208,279,301,276,6501,
20221014,140,139,부산,서울산,1492,61,28,9,31,94,1715,1357,52,29,13,29,59,1539,
20221014,140,250,부산,남양산,8230,148,222,35,55,690,9380,8081,143,217,32,41,690,9204,
20221014,140,251,부산,물금,1054,128,31,35,89,82,1419,1082,98,31,37,50,83,1381,
20221014,140,252,부산,대동,1805,45,48,39,67,105,2109,1587,46,41,37,88,89,1888,
20221014,140,289,부산,마산,1032,16,10,12,9,39,1118,1008,16,7,5,6,38,1080,
20221014,140,755,부산,광재,1179,20,27,12,39,75,1352,1010,16,19,14,23,79,1161,
20221014,142,145,군북,산인,4530,86,121,65,99,301,5202,4241,76,108,57,87,276,4845,
20221014,143,145,장지,산인,1269,27,38,25,62,97,1518,1225,37,22,27,82,88,1481,
20221014,144,145,함안,산인,2223,54,50,32,86,176,2621,2247,59,35,22,46,157,2566,
20221014,145,142,산인,군북,4241,76,108,57,87,276,4845,4530,86,121,65,99,301,5202,
20221014,145,143,산인,장지,1225,37,22,27,82,88,1481,1269,27,38,25,62,97,1518,
20221014,145,144,산인,함안,2247,59,35,22,46,157,2566,2223,54,50,32,86,176,2621,
20221014,145,291,산인,사천,1481,40,58,12,18,68,1677,1785,73,67,25,39,86,2075,
20221014,145,292,산인,진주,1730,38,157,15,21,109,2070,1938,40,154,22,24,120,2298,
20221014,145,293,산인,문산,1380,27,22,10,8,80,1527,1478,36,23,17,9,79,1642,
20221014,145,295,산인,진성,912,21,20,5,10,49,1017,984,20,20,8,15,51,1098,
20221014,146,150,동창원,북부산,1140,28,17,3,17,63,1268,1028,27,18,3,18,81,1175,
20221014,146,244,동창원,서부산,1339,31,48,20,28,83,1549,1444,32,51,25,29,86,1667,
20221014,146,245,동창원,장유,1034,18,17,32,33,94,1228,1032,20,16,31,36,94,1229,
20221014,146,289,동창원,마산,2885,108,67,51,65,234,3410,2787,96,92,56,66,221,3318,
20221014,147,150,진례,북부산,1373,45,31,16,49,89,1603,1595,60,29,17,33,94,1828,
20221014,147,244,진례,서부산,1771,100,85,63,113,106,2238,1906,108,77,72,131,111,2405,
20221014,147,245,진례,장유,1109,63,88,49,19,95,1423,1474,60,90,41,21,141,1827,
20221014,147,289,진례,마산,1340,102,81,60,63,89,1735,1367,113,108,67,77,81,1813,
20221014,148,150,서김해,북부산,6683,137,95,56,117,516,7604,6693,123,92,61,82,490,7541,
20221014,148,251,서김해,물금,936,39,21,30,13,74,1113,948,36,22,33,19,85,1143,
20221014,148,289,서김해,마산,1531,34,61,9,8,117,1760,1734,35,68,24,12,121,1994,
20221014,149,150,동김해,북부산,10876,195,211,52,90,887,12311,9512,167,164,44,53,728,10668,
20221014,149,245,동김해,장유,839,42,92,130,10,66,1179,781,41,81,131,10,76,1120,
20221014,149,250,동김해,남양산,1189,29,65,10,2,101,1396,995,21,52,9,5,76,1158,
20221014,149,251,동김해,물금,1180,46,11,13,8,123,1381,1135,33,10,11,5,118,1312,
20221014,149,289,동김해,마산,910,35,54,24,36,59,1118,1053,41,63,15,31,66,1269,
20221014,150,146,북부산,동창원,1028,27,18,3,18,81,1175,1140,28,17,3,17,63,1268,
20221014,150,147,북부산,진례,1595,60,29,17,33,94,1828,1373,45,31,16,49,89,1603,
20221014,150,148,북부산,서김해,6693,123,92,61,82,490,7541,6683,137,95,56,117,516,7604,
20221014,150,149,북부산,동김해,9512,167,164,44,53,728,10668,10876,195,211,52,90,887,12311,
20221014,150,245,북부산,장유,3937,40,100,14,22,257,4370,3512,49,98,9,28,209,3905,
20221014,150,289,북부산,마산,2795,34,76,17,36,125,3083,3553,45,81,23,103,164,3969,
20221014,151,153,북대전,서대전,1124,14,29,14,12,110,1303,1295,18,21,26,9,109,1478,
20221014,152,154,유성,안영,1080,29,31,9,14,67,1230,1165,29,18,12,16,73,1313,
20221014,153,114,서대전,남대전,1745,40,82,64,18,116,2065,1988,37,59,58,18,135,2295,
20221014,153,115,서대전,대전,1008,18,9,3,10,89,1137,1097,22,5,4,0,86,1214,
20221014,153,119,서대전,판암,2071,29,21,9,78,155,2363,1889,20,12,11,83,177,2192,
20221014,153,151,서대전,북대전,1295,18,21,26,9,109,1478,1124,14,29,14,12,110,1303,
20221014,153,154,서대전,안영,1195,40,47,42,91,76,1491,1130,46,47,43,84,71,1421,
20221014,153,579,서대전,남세종,1250,13,25,2,17,107,1414,1068,14,21,9,10,94,1216,
20221014,154,152,안영,유성,1165,29,18,12,16,73,1313,1080,29,31,9,14,67,1230,
20221014,154,153,안영,서대전,1130,46,47,43,84,71,1421,1195,40,47,42,91,76,1491,
20221014,159,167,서전주,광주,1789,64,87,41,41,53,2075,1671,77,75,42,42,60,1967,
20221014,163,167,정읍,광주,898,28,53,35,21,35,1070,838,35,65,29,29,23,1019,
20221014,166,167,장성,광주,2617,74,72,28,68,119,2978,3078,119,75,27,37,153,3489,
20221014,167,159,광주,서전주,1671,77,75,42,42,60,1967,1789,64,87,41,41,53,2075,
20221014,167,163,광주,정읍,838,35,65,29,29,23,1019,898,28,53,35,21,35,1070,
20221014,167,166,광주,장성,3078,119,75,27,37,153,3489,2617,74,72,28,68,119,2978,
20221014,167,567,광주,남고창,1390,29,53,14,39,54,1579,1476,26,47,13,39,60,1661,
20221014,171,101,마성,서울,2678,24,315,54,5,130,3206,2221,16,252,49,6,106,2650,
20221014,172,101,용인,서울,4188,178,127,60,23,271,4847,3329,149,114,39,25,183,3839,
20221014,172,102,용인,동수원,1051,34,17,3,1,89,1195,1103,27,14,4,1,88,1237,
20221014,172,173,용인,양지,2012,240,119,156,144,136,2807,1844,212,170,124,143,149,2642,
20221014,172,253,용인,서서울,1008,65,29,32,21,71,1226,1054,63,22,29,25,73,1266,
20221014,173,101,양지,서울,4868,404,165,167,108,225,5937,3479,197,139,111,71,145,4142,
20221014,173,102,양지,동수원,1415,52,33,10,3,78,1591,1339,50,39,10,18,64,1520,
20221014,173,172,양지,용인,1844,212,170,124,143,149,2642,2012,240,119,156,144,136,2807,
20221014,173,212,양지,북수원,1187,102,42,59,29,77,1496,1393,102,52,51,66,74,1738,
20221014,173,253,양지,서서울,1226,128,72,132,73,59,1690,1032,119,69,112,60,50,1442,
20221014,173,254,양지,군자,867,112,81,181,270,44,1555,823,111,81,186,249,37,1487,
20221014,174,179,춘천,홍천,3428,102,95,56,34,299,4014,3332,83,93,58,26,298,3890,
20221014,174,216,춘천,횡성,1215,63,24,25,23,96,1446,1233,51,26,13,31,90,1444,
20221014,174,218,춘천,남원주,1329,31,77,7,18,82,1544,1279,28,77,11,14,84,1493,
20221014,174,554,춘천,동홍천,1161,25,28,9,7,84,1314,1399,22,25,9,4,96,1555,
20221014,176,190,이천,동서울,1879,71,192,163,119,93,2517,1460,69,203,133,72,74,2011,
20221014,179,174,홍천,춘천,3332,83,93,58,26,298,3890,3428,102,95,56,34,299,4014,
20221014,184,189,대관령,강릉,1308,39,58,12,7,92,1516,1402,39,55,14,13,91,1614,
20221014,189,184,강릉,대관령,1402,39,55,14,13,91,1614,1308,39,58,12,7,92,1516,
20221014,190,176,동서울,이천,1460,69,203,133,72,74,2011,1879,71,192,163,119,93,2517,
20221014,190,191,동서울,경기광주,10839,684,470,432,257,719,13401,10719,685,466,418,342,755,13385,
20221014,190,192,동서울,곤지암,6049,499,249,164,102,367,7430,5155,437,172,198,105,328,6395,
20221014,190,193,동서울,일죽,2831,168,184,168,112,107,3570,2506,180,170,257,124,103,3340,
20221014,190,194,동서울,서이천,4325,600,339,302,164,282,6012,3429,477,268,232,110,222,4738,
20221014,190,198,동서울,서청주,919,31,47,30,29,37,1093,1201,23,33,32,19,35,1343,
20221014,190,560,동서울,감곡,1162,23,19,34,70,29,1337,886,42,24,33,77,37,1099,
20221014,190,705,동서울,남이천,1686,87,71,136,98,47,2125,2408,101,62,131,81,93,2876,
20221014,191,190,경기광주,동서울,10719,685,466,418,342,755,13385,10839,684,470,432,257,719,13401,
20221014,192,190,곤지암,동서울,5155,437,172,198,105,328,6395,6049,499,249,164,102,367,7430,
20221014,192,194,곤지암,서이천,1445,271,141,188,129,101,2275,1230,185,105,170,137,97,1924,
20221014,193,190,일죽,동서울,2506,180,170,257,124,103,3340,2831,168,184,168,112,107,3570,
20221014,194,190,서이천,동서울,3429,477,268,232,110,222,4738,4325,600,339,302,164,282,6012,
20221014,194,192,서이천,곤지암,1230,185,105,170,137,97,1924,1445,271,141,188,129,101,2275,
20221014,196,198,진천,서청주,1229,39,80,37,31,74,1490,1359,46,81,40,30,80,1636,
20221014,198,115,서청주,대전,987,14,7,5,3,74,1090,919,13,9,1,1,58,1001,
20221014,198,190,서청주,동서울,1201,23,33,32,19,35,1343,919,31,47,30,29,37,1093,
20221014,198,196,서청주,진천,1359,46,81,40,30,80,1636,1229,39,80,37,31,74,1490,
20221014,201,127,칠곡,서대구,932,18,22,3,8,76,1059,1475,22,26,10,54,97,1684,
20221014,201,203,칠곡,가산,970,39,41,37,140,57,1284,909,50,55,25,168,47,1254,
20221014,201,730,칠곡,유천,1067,11,5,0,1,65,1149,935,11,3,0,0,68,1017,
20221014,203,127,가산,서대구,2063,53,81,35,140,117,2489,2275,60,76,48,110,113,2682,
20221014,203,201,가산,칠곡,909,50,55,25,168,47,1254,970,39,41,37,140,57,1284,
20221014,203,775,가산,동명동호,1762,73,67,41,262,90,2295,1902,80,50,48,223,100,2403,
20221014,212,102,북수원,동수원,4775,42,234,133,25,288,5497,4218,31,230,96,32,233,4840,
20221014,212,173,북수원,양지,1393,102,52,51,66,74,1738,1187,102,42,59,29,77,1496,
20221014,212,254,북수원,군자,1989,38,30,19,36,113,2225,1088,32,25,18,26,60,1249,
20221014,213,102,부곡,동수원,1049,14,18,4,26,95,1206,1140,21,14,8,26,97,1306,
20221014,213,253,부곡,서서울,1620,82,48,43,221,114,2128,936,56,29,45,166,74,1306,
20221014,213,254,부곡,군자,968,40,25,45,420,41,1539,768,42,29,45,369,55,1308,
20221014,214,102,동군포,동수원,1899,26,22,10,4,132,2093,1646,30,24,11,7,119,1837,
20221014,215,102,군포,동수원,2338,20,39,6,5,165,2573,1639,19,27,10,5,113,1813,
20221014,215,253,군포,서서울,3985,89,61,53,52,271,4511,3533,137,132,162,88,229,4281,
20221014,215,254,군포,군자,2313,76,55,35,94,158,2731,2733,143,105,139,153,180,3453,
20221014,215,255,군포,서안산,1318,51,30,23,20,101,1543,1531,53,63,85,87,118,1937,
20221014,216,174,횡성,춘천,1233,51,26,13,31,90,1444,1215,63,24,25,23,96,1446,
20221014,218,174,남원주,춘천,1279,28,77,11,14,84,1493,1329,31,77,7,18,82,1544,
20221014,218,240,남원주,제천,1998,55,60,26,48,122,2309,2406,69,49,25,25,144,2718,
20221014,225,291,서진주,사천,1055,29,27,13,38,86,1248,1140,25,36,21,43,91,1356,
20221014,229,108,북천안,천안,3831,95,138,104,70,249,4487,3810,73,137,83,56,212,4371,
20221014,230,127,팔공산,서대구,1054,30,30,10,11,84,1219,1546,52,50,21,9,85,1763,
20221014,230,131,팔공산,경산,1519,90,50,26,16,91,1792,1324,88,46,21,13,88,1580,
20221014,230,524,팔공산,청통와촌,1191,50,33,7,18,61,1360,1051,36,30,9,17,62,1205,
20221014,230,527,팔공산,포항,1682,29,15,8,30,63,1827,1619,26,15,11,28,62,1761,
20221014,231,519,화원옥포,남대구,6696,186,112,149,216,501,7860,6561,160,114,129,110,499,7573,
20221014,232,519,달성,남대구,2889,128,143,46,38,202,3446,3015,144,153,49,33,197,3591,
20221014,233,519,현풍,남대구,5201,215,229,71,128,363,6207,4582,193,195,99,131,300,5500,
20221014,237,239,남지,칠원,874,24,52,15,80,68,1113,857,28,46,12,74,68,1085,
20221014,238,239,칠서,칠원,1803,107,141,220,418,105,2794,1748,105,108,183,337,114,2595,
20221014,239,237,칠원,남지,857,28,46,12,74,68,1085,874,24,52,15,80,68,1113,
20221014,239,238,칠원,칠서,1748,105,108,183,337,114,2595,1803,107,141,220,418,105,2794,
20221014,239,519,칠원,남대구,1350,43,106,42,108,58,1707,1372,62,109,49,59,52,1703,
20221014,240,218,제천,남원주,2406,69,49,25,25,144,2718,1998,55,60,26,48,122,2309,
20221014,241,519,동고령,남대구,3246,97,91,314,95,167,4010,3253,103,86,321,86,170,4019,
20221014,242,519,고령,남대구,1807,37,56,27,243,93,2263,2016,37,58,19,254,100,2484,
20221014,244,146,서부산,동창원,1444,32,51,25,29,86,1667,1339,31,48,20,28,83,1549,
20221014,244,147,서부산,진례,1906,108,77,72,131,111,2405,1771,100,85,63,113,106,2238,
20221014,244,245,서부산,장유,13396,269,410,178,397,964,15614,13196,240,416,182,451,967,15452,
20221014,244,289,서부산,마산,3469,64,271,48,86,181,4119,3862,85,273,59,135,203,4617,
20221014,245,146,장유,동창원,1032,20,16,31,36,94,1229,1034,18,17,32,33,94,1228,
20221014,245,147,장유,진례,1474,60,90,41,21,141,1827,1109,63,88,49,19,95,1423,
20221014,245,149,장유,동김해,781,41,81,131,10,76,1120,839,42,92,130,10,66,1179,
20221014,245,150,장유,북부산,3512,49,98,9,28,209,3905,3937,40,100,14,22,257,4370,
20221014,245,244,장유,서부산,13196,240,416,182,451,967,15452,13396,269,410,178,397,964,15614,
20221014,245,289,장유,마산,1606,27,44,15,33,128,1853,1763,31,58,26,29,132,2039,
20221014,248,261,순창,동광주,1414,28,28,10,20,62,1562,1409,20,34,15,12,54,1544,
20221014,249,261,담양,동광주,2607,41,120,20,61,120,2969,2054,41,120,16,53,106,2390,
20221014,250,140,남양산,부산,8081,143,217,32,41,690,9204,8230,148,222,35,55,690,9380,
20221014,250,149,남양산,동김해,995,21,52,9,5,76,1158,1189,29,65,10,2,101,1396,
20221014,250,252,남양산,대동,3528,167,109,191,99,233,4327,4233,178,139,177,111,313,5151,
20221014,251,140,물금,부산,1082,98,31,37,50,83,1381,1054,128,31,35,89,82,1419,
20221014,251,148,물금,서김해,948,36,22,33,19,85,1143,936,39,21,30,13,74,1113,
20221014,251,149,물금,동김해,1135,33,10,11,5,118,1312,1180,46,11,13,8,123,1381,
20221014,251,252,물금,대동,3158,224,92,159,508,259,4400,3832,217,102,154,647,258,5210,
20221014,252,135,대동,경주,1415,54,85,55,98,64,1771,1075,34,75,60,157,54,1455,
20221014,252,138,대동,양산,3031,320,208,236,316,160,4271,2646,333,204,258,341,131,3913,
20221014,252,139,대동,서울산,980,37,34,36,50,50,1187,891,49,45,38,57,54,1134,
20221014,252,140,대동,부산,1587,46,41,37,88,89,1888,1805,45,48,39,67,105,2109,
20221014,252,250,대동,남양산,4233,178,139,177,111,313,5151,3528,167,109,191,99,233,4327,
20221014,252,251,대동,물금,3832,217,102,154,647,258,5210,3158,224,92,159,508,259,4400,
20221014,252,641,대동,울산,1839,73,85,39,57,116,2209,1486,72,82,36,59,83,1818,
20221014,252,752,대동,기장철마,1854,74,55,51,130,136,2300,1911,76,49,39,56,144,2275,
20221014,252,753,대동,금정,1846,94,109,97,156,125,2427,1119,56,68,59,78,79,1459,
20221014,252,755,대동,광재,2380,87,85,150,347,148,3197,2305,105,88,154,520,116,3288,
20221014,252,756,대동,한림,835,28,38,25,91,41,1058,906,51,45,30,135,35,1202,
20221014,253,102,서서울,동수원,4925,71,71,16,19,303,5405,5507,63,61,19,21,340,6011,
20221014,253,103,서서울,수원신갈,2109,131,94,80,37,133,2584,1552,107,72,58,20,121,1930,
20221014,253,172,서서울,용인,1054,63,22,29,25,73,1266,1008,65,29,32,21,71,1226,
20221014,253,173,서서울,양지,1032,119,69,112,60,50,1442,1226,128,72,132,73,59,1690,
20221014,253,213,서서울,부곡,936,56,29,45,166,74,1306,1620,82,48,43,221,114,2128,
20221014,253,215,서서울,군포,3533,137,132,162,88,229,4281,3985,89,61,53,52,271,4511,
20221014,253,255,서서울,서안산,14930,511,693,637,302,873,17946,15024,508,596,582,276,949,17935,
20221014,253,256,서서울,안산,9208,182,101,50,36,657,10234,6302,121,64,34,69,442,7032,
20221014,253,281,서서울,매송,3716,63,43,18,30,206,4076,5004,65,42,24,98,294,5527,
20221014,253,282,서서울,비봉,5733,262,262,172,392,328,7149,6013,303,270,189,475,372,7622,
20221014,253,283,서서울,발안,3409,166,166,167,169,218,4295,4284,226,200,195,169,246,5320,
20221014,253,285,서서울,서평택,1539,80,114,250,392,92,2467,1777,96,118,335,536,110,2972,
20221014,253,287,서서울,송악,2154,42,52,72,229,80,2629,2517,63,56,93,401,87,3217,
20221014,253,288,서서울,당진,1610,22,57,30,28,79,1826,1488,26,45,49,50,58,1716,
20221014,253,298,서서울,서산,3800,28,68,57,20,138,4111,2332,31,64,49,66,85,2627,
20221014,253,520,서서울,평택,2159,112,109,166,124,103,2773,2665,135,141,244,124,122,3431,
20221014,253,540,서서울,청북,787,39,48,101,59,40,1074,927,64,56,113,86,45,1291,
20221014,253,741,서서울,평택고덕,973,19,23,27,9,69,1120,1367,38,28,24,12,100,1569,
20221014,254,102,군자,동수원,4194,77,79,31,40,235,4656,3574,49,64,20,38,180,3925,
20221014,254,103,군자,수원신갈,1659,122,77,133,109,107,2207,1192,84,54,75,65,55,1525,
20221014,254,173,군자,양지,823,111,81,186,249,37,1487,867,112,81,181,270,44,1555,
20221014,254,212,군자,북수원,1088,32,25,18,26,60,1249,1989,38,30,19,36,113,2225,
20221014,254,213,군자,부곡,768,42,29,45,369,55,1308,968,40,25,45,420,41,1539,
20221014,254,215,군자,군포,2733,143,105,139,153,180,3453,2313,76,55,35,94,158,2731,
20221014,254,255,군자,서안산,9796,437,214,218,298,689,11652,10055,442,217,228,302,673,11917,
20221014,254,256,군자,안산,4538,125,115,40,60,348,5226,4857,131,124,56,65,413,5646,
20221014,254,281,군자,매송,970,33,13,17,75,84,1192,928,28,7,26,57,64,1110,
20221014,254,282,군자,비봉,1261,103,74,88,212,95,1833,1008,98,52,57,195,80,1490,
20221014,254,283,군자,발안,1124,77,70,64,153,66,1554,1085,84,74,66,124,64,1497,
20221014,255,102,서안산,동수원,1871,39,23,14,5,124,2076,1641,43,23,12,5,96,1820,
20221014,255,215,서안산,군포,1531,53,63,85,87,118,1937,1318,51,30,23,20,101,1543,
20221014,255,253,서안산,서서울,15024,508,596,582,276,949,17935,14930,511,693,637,302,873,17946,
20221014,255,254,서안산,군자,10055,442,217,228,302,673,11917,9796,437,214,218,298,689,11652,
20221014,256,253,안산,서서울,6302,121,64,34,69,442,7032,9208,182,101,50,36,657,10234,
20221014,256,254,안산,군자,4857,131,124,56,65,413,5646,4538,125,115,40,60,348,5226,
20221014,261,248,동광주,순창,1409,20,34,15,12,54,1544,1414,28,28,10,20,62,1562,
20221014,261,249,동광주,담양,2054,41,120,16,53,106,2390,2607,41,120,20,61,120,2969,
20221014,261,262,동광주,창평,1787,86,34,40,41,64,2052,1923,62,41,52,49,75,2202,
20221014,261,263,동광주,옥과,2906,27,124,20,58,138,3273,2735,23,115,9,66,130,3078,
20221014,261,265,동광주,곡성,1588,32,40,22,60,61,1803,1521,20,34,12,50,64,1701,
20221014,261,270,동광주,서순천,1169,36,71,12,28,36,1352,1020,23,49,7,4,32,1135,
20221014,261,271,동광주,순천,3093,66,102,30,81,90,3462,3491,88,104,28,109,96,3916,
20221014,262,261,창평,동광주,1923,62,41,52,49,75,2202,1787,86,34,40,41,64,2052,
20221014,263,261,옥과,동광주,2735,23,115,9,66,130,3078,2906,27,124,20,58,138,3273,
20221014,265,261,곡성,동광주,1521,20,34,12,50,64,1701,1588,32,40,22,60,61,1803,
20221014,270,261,서순천,동광주,1020,23,49,7,4,32,1135,1169,36,71,12,28,36,1352,
20221014,271,261,순천,동광주,3491,88,104,28,109,96,3916,3093,66,102,30,81,90,3462,
20221014,271,569,순천,북광주,1080,84,61,26,138,34,1423,936,61,41,24,113,24,1199,
20221014,280,519,거창,남대구,1012,22,51,10,8,69,1172,1066,30,57,7,10,63,1233,
20221014,281,253,매송,서서울,5004,65,42,24,98,294,5527,3716,63,43,18,30,206,4076,
20221014,281,254,매송,군자,928,28,7,26,57,64,1110,970,33,13,17,75,84,1192,
20221014,282,253,비봉,서서울,6013,303,270,189,475,372,7622,5733,262,262,172,392,328,7149,
20221014,282,254,비봉,군자,1008,98,52,57,195,80,1490,1261,103,74,88,212,95,1833,
20221014,283,253,발안,서서울,4284,226,200,195,169,246,5320,3409,166,166,167,169,218,4295,
20221014,283,254,발안,군자,1085,84,74,66,124,64,1497,1124,77,70,64,153,66,1554,
20221014,285,253,서평택,서서울,1777,96,118,335,536,110,2972,1539,80,114,250,392,92,2467,
20221014,285,287,서평택,송악,733,33,90,97,615,38,1606,899,41,84,106,541,57,1728,
20221014,285,520,서평택,평택,712,36,56,73,115,67,1059,826,42,54,72,136,88,1218,
20221014,287,253,송악,서서울,2517,63,56,93,401,87,3217,2154,42,52,72,229,80,2629,
20221014,287,285,송악,서평택,899,41,84,106,541,57,1728,733,33,90,97,615,38,1606,
20221014,287,288,송악,당진,793,15,12,4,106,79,1009,897,17,17,11,109,90,1141,
20221014,288,253,당진,서서울,1488,26,45,49,50,58,1716,1610,22,57,30,28,79,1826,
20221014,288,287,당진,송악,897,17,17,11,109,90,1141,793,15,12,4,106,79,1009,
20221014,289,140,마산,부산,1008,16,7,5,6,38,1080,1032,16,10,12,9,39,1118,
20221014,289,146,마산,동창원,2787,96,92,56,66,221,3318,2885,108,67,51,65,234,3410,
20221014,289,147,마산,진례,1367,113,108,67,77,81,1813,1340,102,81,60,63,89,1735,
20221014,289,148,마산,서김해,1734,35,68,24,12,121,1994,1531,34,61,9,8,117,1760,
20221014,289,149,마산,동김해,1053,41,63,15,31,66,1269,910,35,54,24,36,59,1118,
20221014,289,150,마산,북부산,3553,45,81,23,103,164,3969,2795,34,76,17,36,125,3083,
20221014,289,244,마산,서부산,3862,85,273,59,135,203,4617,3469,64,271,48,86,181,4119,
20221014,289,245,마산,장유,1763,31,58,26,29,132,2039,1606,27,44,15,33,128,1853,
20221014,289,757,마산,진영,756,45,79,35,86,52,1053,860,53,53,47,71,45,1129,
20221014,291,145,사천,산인,1785,73,67,25,39,86,2075,1481,40,58,12,18,68,1677,
20221014,291,225,사천,서진주,1140,25,36,21,43,91,1356,1055,29,27,13,38,86,1248,
20221014,291,292,사천,진주,2988,71,95,38,40,282,3514,3746,100,105,50,55,322,4378,
20221014,292,145,진주,산인,1938,40,154,22,24,120,2298,1730,38,157,15,21,109,2070,
20221014,292,291,진주,사천,3746,100,105,50,55,322,4378,2988,71,95,38,40,282,3514,
20221014,293,145,문산,산인,1478,36,23,17,9,79,1642,1380,27,22,10,8,80,1527,
20221014,295,145,진성,산인,984,20,20,8,15,51,1098,912,21,20,5,10,49,1017,
20221014,298,253,서산,서서울,2332,31,64,49,66,85,2627,3800,28,68,57,20,138,4111,
20221014,508,509,무안,목포,1326,52,42,36,47,51,1554,1687,55,50,39,59,72,1962,
20221014,508,553,무안,동광산,1598,29,32,24,32,49,1764,1600,28,48,37,35,58,1806,
20221014,509,508,목포,무안,1687,55,50,39,59,72,1962,1326,52,42,36,47,51,1554,
20221014,509,553,목포,동광산,7919,197,234,149,405,283,9187,7637,181,224,188,440,305,8975,
20221014,513,515,고성,북통영,1713,41,98,24,22,103,2001,1711,39,89,16,12,126,1993,
20221014,513,516,고성,통영,3646,88,152,83,151,242,4362,3394,98,150,76,154,242,4114,
20221014,514,516,동고성,통영,1272,30,55,51,131,165,1704,1252,19,65,48,131,156,1671,
20221014,515,513,북통영,고성,1711,39,89,16,12,126,1993,1713,41,98,24,22,103,2001,
20221014,516,513,통영,고성,3394,98,150,76,154,242,4114,3646,88,152,83,151,242,4362,
20221014,516,514,통영,동고성,1252,19,65,48,131,156,1671,1272,30,55,51,131,165,1704,
20221014,517,597,양평,서여주,771,32,71,57,45,37,1013,1054,29,45,49,48,45,1270,
20221014,517,598,양평,북여주,1260,34,29,24,59,66,1472,1313,26,25,18,39,46,1467,
20221014,518,127,칠곡물류,서대구,769,103,64,89,32,49,1106,872,116,86,101,32,47,1254,
20221014,519,231,남대구,화원옥포,6561,160,114,129,110,499,7573,6696,186,112,149,216,501,7860,
20221014,519,232,남대구,달성,3015,144,153,49,33,197,3591,2889,128,143,46,38,202,3446,
20221014,519,233,남대구,현풍,4582,193,195,99,131,300,5500,5201,215,229,71,128,363,6207,
20221014,519,239,남대구,칠원,1372,62,109,49,59,52,1703,1350,43,106,42,108,58,1707,
20221014,519,241,남대구,동고령,3253,103,86,321,86,170,4019,3246,97,91,314,95,167,4010,
20221014,519,242,남대구,고령,2016,37,58,19,254,100,2484,1807,37,56,27,243,93,2263,
20221014,519,280,남대구,거창,1066,30,57,7,10,63,1233,1012,22,51,10,8,69,1172,
20221014,519,730,남대구,유천,2566,61,22,0,2,183,2834,2911,58,16,0,0,193,3178,
20221014,519,731,남대구,북현풍,2159,35,34,0,2,138,2368,1685,24,7,0,0,113,1829,
20221014,520,253,평택,서서울,2665,135,141,244,124,122,3431,2159,112,109,166,124,103,2773,
20221014,520,285,평택,서평택,826,42,54,72,136,88,1218,712,36,56,73,115,67,1059,
20221014,520,540,평택,청북,1338,94,161,157,89,66,1905,821,82,161,147,100,55,1366,
20221014,520,741,평택,평택고덕,1127,15,220,23,26,93,1504,824,20,181,17,16,69,1127,
20221014,524,129,청통와촌,북대구,1198,79,40,21,25,57,1420,973,50,19,12,14,51,1119,
20221014,524,230,청통와촌,팔공산,1051,36,30,9,17,62,1205,1191,50,33,7,18,61,1360,
20221014,526,527,서포항,포항,925,16,19,9,28,67,1064,1202,17,16,8,19,89,1351,
20221014,527,127,포항,서대구,919,34,35,11,55,46,1100,1188,30,43,25,70,61,1417,
20221014,527,129,포항,북대구,2309,50,31,21,89,115,2615,1683,34,24,26,64,70,1901,
20221014,527,230,포항,팔공산,1619,26,15,11,28,62,1761,1682,29,15,8,30,63,1827,
20221014,527,526,포항,서포항,1202,17,16,8,19,89,1351,925,16,19,9,28,67,1064,
20221014,528,101,기흥동탄,서울,7513,75,1355,129,20,356,9448,6860,67,1191,136,11,298,8563,
20221014,528,103,기흥동탄,수원신갈,2161,27,168,3,4,109,2472,1585,10,186,2,2,88,1873,
20221014,528,106,기흥동탄,오산,1020,43,48,13,9,82,1215,1046,39,46,18,8,79,1236,
20221014,528,107,기흥동탄,안성,1203,23,31,6,7,100,1370,1000,9,22,4,5,105,1145,
20221014,528,108,기흥동탄,천안,1209,17,131,6,11,64,1438,1097,16,108,5,14,67,1307,
20221014,540,253,청북,서서울,927,64,56,113,86,45,1291,787,39,48,101,59,40,1074,
20221014,540,520,청북,평택,821,82,161,147,100,55,1366,1338,94,161,157,89,66,1905,
20221014,540,741,청북,평택고덕,958,25,55,88,120,98,1344,1092,34,67,100,140,91,1524,
20221014,542,101,서안성,서울,1834,44,81,164,62,82,2267,1256,46,97,102,30,59,1590,
20221014,542,543,서안성,남안성,1141,55,90,143,102,91,1622,1166,44,86,134,100,90,1620,
20221014,543,101,남안성,서울,1132,83,78,110,85,53,1541,1124,68,85,70,79,41,1467,
20221014,543,542,남안성,서안성,1166,44,86,134,100,90,1620,1141,55,90,143,102,91,1622,
20221014,543,555,남안성,북진천,956,113,154,154,173,54,1604,926,129,147,167,179,52,1600,
20221014,548,553,북무안,동광산,1574,21,28,21,45,47,1736,1873,22,29,16,50,57,2047,
20221014,549,553,동함평,동광산,3117,40,67,37,63,102,3426,3187,45,74,33,45,114,3498,
20221014,551,553,나주,동광산,1357,34,35,25,46,57,1554,1347,30,41,14,48,58,1538,
20221014,552,553,서광산,동광산,4816,199,192,228,266,181,5882,6137,195,217,203,208,241,7201,
20221014,553,508,동광산,무안,1600,28,48,37,35,58,1806,1598,29,32,24,32,49,1764,
20221014,553,509,동광산,목포,7637,181,224,188,440,305,8975,7919,197,234,149,405,283,9187,
20221014,553,548,동광산,북무안,1873,22,29,16,50,57,2047,1574,21,28,21,45,47,1736,
20221014,553,549,동광산,동함평,3187,45,74,33,45,114,3498,3117,40,67,37,63,102,3426,
20221014,553,551,동광산,나주,1347,30,41,14,48,58,1538,1357,34,35,25,46,57,1554,
20221014,553,552,동광산,서광산,6137,195,217,203,208,241,7201,4816,199,192,228,266,181,5882,
20221014,554,174,동홍천,춘천,1399,22,25,9,4,96,1555,1161,25,28,9,7,84,1314,
20221014,555,543,북진천,남안성,926,129,147,167,179,52,1600,956,113,154,154,173,54,1604,
20221014,560,190,감곡,동서울,886,42,24,33,77,37,1099,1162,23,19,34,70,29,1337,
20221014,567,167,남고창,광주,1476,26,47,13,39,60,1661,1390,29,53,14,39,54,1579,
20221014,569,271,북광주,순천,936,61,41,24,113,24,1199,1080,84,61,26,138,34,1423,
20221014,579,115,남세종,대전,1001,9,17,2,99,73,1201,1013,14,18,4,121,85,1255,
20221014,579,153,남세종,서대전,1068,14,21,9,10,94,1216,1250,13,25,2,17,107,1414,
20221014,583,704,동해,근덕,895,10,27,4,76,68,1080,910,17,28,6,50,63,1074,
20221014,587,589,오수,상관,1310,22,53,36,34,45,1500,1321,30,44,33,144,44,1616,
20221014,589,587,상관,오수,1321,30,44,33,144,44,1616,1310,22,53,36,34,45,1500,
20221014,597,517,서여주,양평,1054,29,45,49,48,45,1270,771,32,71,57,45,37,1013,
20221014,597,598,서여주,북여주,945,46,131,48,59,49,1278,1091,46,88,43,52,56,1376,
20221014,598,517,북여주,양평,1313,26,25,18,39,46,1467,1260,34,29,24,59,66,1472,
20221014,598,597,북여주,서여주,1091,46,88,43,52,56,1376,945,46,131,48,59,49,1278,
20221014,621,127,동대구,서대구,1263,44,24,34,24,76,1465,1857,70,84,27,30,123,2191,
20221014,621,131,동대구,경산,2426,74,56,184,28,128,2896,2332,62,44,171,82,127,2818,
20221014,621,132,동대구,영천,1239,11,21,3,45,53,1372,1274,9,28,3,46,55,1415,
20221014,625,626,밀양,남밀양,1279,74,57,56,54,61,1581,1450,53,51,56,55,68,1733,
20221014,626,625,남밀양,밀양,1450,53,51,56,55,68,1733,1279,74,57,56,54,61,1581,
20221014,626,627,남밀양,삼랑진,1062,25,30,21,45,127,1310,1101,28,22,19,38,130,1338,
20221014,627,626,삼랑진,남밀양,1101,28,22,19,38,130,1338,1062,25,30,21,45,127,1310,
20221014,641,139,울산,서울산,1185,22,56,9,39,84,1395,1320,40,57,26,47,105,1595,
20221014,641,252,울산,대동,1486,72,82,36,59,83,1818,1839,73,85,39,57,116,2209,
20221014,641,643,울산,청량,1126,8,12,32,70,107,1355,1251,5,10,31,27,121,1445,
20221014,641,648,울산,해운대,1017,9,14,1,4,62,1107,1145,13,22,1,3,71,1255,
20221014,641,706,울산,남경주,1280,17,27,9,26,67,1426,1276,12,34,18,31,54,1425,
20221014,641,707,울산,남포항,1250,19,31,22,137,65,1524,1276,19,26,39,111,72,1543,
20221014,643,641,청량,울산,1251,5,10,31,27,121,1445,1126,8,12,32,70,107,1355,
20221014,643,648,청량,해운대,3373,18,37,19,90,205,3742,3416,28,76,49,454,193,4216,
20221014,645,648,장안,해운대,1584,18,11,7,17,94,1731,2988,38,26,136,94,170,3452,
20221014,646,648,기장일광,해운대,4857,36,43,73,68,287,5364,5694,52,45,28,219,328,6366,
20221014,648,641,해운대,울산,1145,13,22,1,3,71,1255,1017,9,14,1,4,62,1107,
20221014,648,643,해운대,청량,3416,28,76,49,454,193,4216,3373,18,37,19,90,205,3742,
20221014,648,645,해운대,장안,2988,38,26,136,94,170,3452,1584,18,11,7,17,94,1731,
20221014,648,646,해운대,기장일광,5694,52,45,28,219,328,6366,4857,36,43,73,68,287,5364,
20221014,648,707,해운대,남포항,864,10,51,17,147,33,1122,951,6,31,7,43,49,1087,
20221014,651,652,남양주,화도,15621,572,520,489,282,1104,18588,16293,587,612,538,262,1265,19557,
20221014,651,653,남양주,서종,2222,17,7,14,52,88,2400,1849,27,8,10,48,74,2016,
20221014,651,654,남양주,설악,5278,45,113,19,20,199,5674,3476,29,87,18,21,123,3754,
20221014,651,655,남양주,강촌,3487,37,122,31,28,123,3828,2876,43,135,24,42,99,3219,
20221014,651,656,남양주,남춘천,3464,35,61,28,42,113,3743,2095,19,53,12,38,67,2284,
20221014,652,651,화도,남양주,16293,587,612,538,262,1265,19557,15621,572,520,489,282,1104,18588,
20221014,652,653,화도,서종,1475,30,20,26,32,111,1694,1547,35,19,27,39,113,1780,
20221014,652,654,화도,설악,1610,22,12,6,11,104,1765,1198,16,12,4,9,87,1326,
20221014,653,651,서종,남양주,1849,27,8,10,48,74,2016,2222,17,7,14,52,88,2400,
20221014,653,652,서종,화도,1547,35,19,27,39,113,1780,1475,30,20,26,32,111,1694,
20221014,654,651,설악,남양주,3476,29,87,18,21,123,3754,5278,45,113,19,20,199,5674,
20221014,654,652,설악,화도,1198,16,12,4,9,87,1326,1610,22,12,6,11,104,1765,
20221014,655,651,강촌,남양주,2876,43,135,24,42,99,3219,3487,37,122,31,28,123,3828,
20221014,656,651,남춘천,남양주,2095,19,53,12,38,67,2284,3464,35,61,28,42,113,3743,
20221014,671,672,봉담,정남,3325,182,104,93,173,240,4117,4359,185,118,109,178,311,5260,
20221014,671,673,봉담,북오산,2042,59,51,21,23,144,2340,2153,56,51,22,19,146,2447,
20221014,671,675,봉담,서오산,928,24,29,8,9,68,1066,983,25,21,6,18,75,1128,
20221014,671,676,봉담,향남,1430,111,58,41,32,101,1773,1338,117,59,39,24,111,1688,
20221014,671,677,봉담,북평택,9273,245,260,177,266,485,10706,8839,210,251,139,223,523,10185,
20221014,672,671,정남,봉담,4359,185,118,109,178,311,5260,3325,182,104,93,173,240,4117,
20221014,673,101,북오산,서울,1565,50,122,25,9,99,1870,1407,37,117,25,10,92,1688,
20221014,673,671,북오산,봉담,2153,56,51,22,19,146,2447,2042,59,51,21,23,144,2340,
20221014,673,677,북오산,북평택,2316,34,77,35,25,158,2645,1844,33,57,27,25,117,2103,
20221014,675,671,서오산,봉담,983,25,21,6,18,75,1128,928,24,29,8,9,68,1066,
20221014,675,676,서오산,향남,3695,129,79,53,43,246,4245,3436,100,60,32,35,229,3892,
20221014,675,677,서오산,북평택,13378,237,428,179,217,803,15242,12278,232,366,203,176,765,14020,
20221014,675,876,서오산,양감,1849,74,43,42,92,120,2220,2343,62,41,34,82,160,2722,
20221014,676,671,향남,봉담,1338,117,59,39,24,111,1688,1430,111,58,41,32,101,1773,
20221014,676,675,향남,서오산,3436,100,60,32,35,229,3892,3695,129,79,53,43,246,4245,
20221014,676,677,향남,북평택,1966,188,197,219,151,111,2832,1523,152,141,194,118,89,2217,
20221014,677,101,북평택,서울,1587,75,275,93,136,93,2259,1554,53,264,75,96,82,2124,
20221014,677,671,북평택,봉담,8839,210,251,139,223,523,10185,9273,245,260,177,266,485,10706,
20221014,677,673,북평택,북오산,1844,33,57,27,25,117,2103,2316,34,77,35,25,158,2645,
20221014,677,675,북평택,서오산,12278,232,366,203,176,765,14020,13378,237,428,179,217,803,15242,
20221014,677,676,북평택,향남,1523,152,141,194,118,89,2217,1966,188,197,219,151,111,2832,
20221014,677,876,북평택,양감,2855,144,193,229,155,166,3742,2323,155,203,251,151,125,3208,
20221014,682,683,조암,송산마도,777,89,97,62,49,31,1105,1017,99,117,74,81,49,1437,
20221014,682,684,조암,남안산,911,155,171,118,92,44,1491,1084,153,182,110,70,35,1634,
20221014,682,685,조암,서시흥,1772,190,142,157,316,90,2667,1859,175,155,160,339,109,2797,
20221014,683,682,송산마도,조암,1017,99,117,74,81,49,1437,777,89,97,62,49,31,1105,
20221014,683,684,송산마도,남안산,2697,200,173,114,163,142,3489,2332,196,122,107,107,129,2993,
20221014,683,685,송산마도,서시흥,5566,321,238,209,706,344,7384,4724,293,227,213,703,285,6445,
20221014,684,682,남안산,조암,1084,153,182,110,70,35,1634,911,155,171,118,92,44,1491,
20221014,684,683,남안산,송산마도,2332,196,122,107,107,129,2993,2697,200,173,114,163,142,3489,
20221014,684,685,남안산,서시흥,4901,515,306,443,604,322,7091,5109,430,337,414,499,368,7157,
20221014,685,682,서시흥,조암,1859,175,155,160,339,109,2797,1772,190,142,157,316,90,2667,
20221014,685,683,서시흥,송산마도,4724,293,227,213,703,285,6445,5566,321,238,209,706,344,7384,
20221014,685,684,서시흥,남안산,5109,430,337,414,499,368,7157,4901,515,306,443,604,322,7091,
20221014,704,583,근덕,동해,910,17,28,6,50,63,1074,895,10,27,4,76,68,1080,
20221014,705,190,남이천,동서울,2408,101,62,131,81,93,2876,1686,87,71,136,98,47,2125,
20221014,706,641,남경주,울산,1276,12,34,18,31,54,1425,1280,17,27,9,26,67,1426,
20221014,706,707,남경주,남포항,1143,28,86,38,225,66,1586,1208,29,70,35,193,73,1608,
20221014,707,641,남포항,울산,1276,19,26,39,111,72,1543,1250,19,31,22,137,65,1524,
20221014,707,648,남포항,해운대,951,6,31,7,43,49,1087,864,10,51,17,147,33,1122,
20221014,707,706,남포항,남경주,1208,29,70,35,193,73,1608,1143,28,86,38,225,66,1586,
20221014,707,708,남포항,동경주,1546,21,28,28,285,93,2001,1602,32,34,31,341,87,2127,
20221014,708,707,동경주,남포항,1602,32,34,31,341,87,2127,1546,21,28,28,285,93,2001,
20221014,715,716,동안동,청송,1151,14,16,30,16,77,1304,1193,19,15,23,22,67,1339,
20221014,716,715,청송,동안동,1193,19,15,23,22,67,1339,1151,14,16,30,16,77,1304,
20221014,730,201,유천,칠곡,935,11,3,0,0,68,1017,1067,11,5,0,1,65,1149,
20221014,730,519,유천,남대구,2911,58,16,0,0,193,3178,2566,61,22,0,2,183,2834,
20221014,731,519,북현풍,남대구,1685,24,7,0,0,113,1829,2159,35,34,0,2,138,2368,
20221014,741,253,평택고덕,서서울,1367,38,28,24,12,100,1569,973,19,23,27,9,69,1120,
20221014,741,520,평택고덕,평택,824,20,181,17,16,69,1127,1127,15,220,23,26,93,1504,
20221014,741,540,평택고덕,청북,1092,34,67,100,140,91,1524,958,25,55,88,120,98,1344,
20221014,742,107,남사진위,안성,1351,34,58,32,10,119,1604,1292,43,61,35,8,106,1545,
20221014,742,108,남사진위,천안,1036,32,43,42,4,77,1234,1210,37,44,20,2,76,1389,
20221014,752,252,기장철마,대동,1911,76,49,39,56,144,2275,1854,74,55,51,130,136,2300,
20221014,753,252,금정,대동,1119,56,68,59,78,79,1459,1846,94,109,97,156,125,2427,
20221014,755,140,광재,부산,1010,16,19,14,23,79,1161,1179,20,27,12,39,75,1352,
20221014,755,252,광재,대동,2305,105,88,154,520,116,3288,2380,87,85,150,347,148,3197,
20221014,756,252,한림,대동,906,51,45,30,135,35,1202,835,28,38,25,91,41,1058,
20221014,757,289,진영,마산,860,53,53,47,71,45,1129,756,45,79,35,86,52,1053,
20221014,772,774,북달성,남칠곡,2625,55,63,32,44,161,2980,2795,60,71,43,42,153,3164,
20221014,773,774,북다사,남칠곡,1431,21,19,11,20,90,1592,1374,24,29,15,23,87,1552,
20221014,774,772,남칠곡,북달성,2795,60,71,43,42,153,3164,2625,55,63,32,44,161,2980,
20221014,774,773,남칠곡,북다사,1374,24,29,15,23,87,1552,1431,21,19,11,20,90,1592,
20221014,775,203,동명동호,가산,1902,80,50,48,223,100,2403,1762,73,67,41,262,90,2295,
20221014,776,777,연경,파군재,3752,63,37,28,26,250,4156,2659,52,49,26,26,177,2989,
20221014,776,779,연경,율암,6403,109,75,70,162,451,7270,6472,117,116,67,156,434,7362,
20221014,777,776,파군재,연경,2659,52,49,26,26,177,2989,3752,63,37,28,26,250,4156,
20221014,777,779,파군재,율암,2656,27,27,5,10,236,2961,2556,25,24,3,6,253,2867,
20221014,779,776,율암,연경,6472,117,116,67,156,434,7362,6403,109,75,70,162,451,7270,
20221014,779,777,율암,파군재,2556,25,24,3,6,253,2867,2656,27,27,5,10,236,2961,
20221014,876,675,양감,서오산,2343,62,41,34,82,160,2722,1849,74,43,42,92,120,2220,
20221014,876,677,양감,북평택,2323,155,203,251,151,125,3208,2855,144,193,229,155,166,3742,
20221014,981,982,서영암,강진무위사,2070,38,90,70,58,78,2404,1934,38,105,96,46,92,2311,
20221014,981,987,서영암,남순천,2219,34,97,76,303,81,2810,1991,38,115,129,346,64,2683,
20221014,982,981,강진무위사,서영암,1934,38,105,96,46,92,2311,2070,38,90,70,58,78,2404,
20221014,984,985,보성,벌교,1767,47,49,55,43,47,2008,1752,43,61,32,34,61,1983,
20221014,984,987,보성,남순천,2119,50,91,70,305,61,2696,2091,59,75,56,262,62,2605,
20221014,985,984,벌교,보성,1752,43,61,32,34,61,1983,1767,47,49,55,43,47,2008,
20221014,986,987,고흥,남순천,4068,78,128,157,225,146,4802,4625,94,162,165,247,149,5442,
20221014,987,981,남순천,서영암,1991,38,115,129,346,64,2683,2219,34,97,76,303,81,2810,
20221014,987,984,남순천,보성,2091,59,75,56,262,62,2605,2119,50,91,70,305,61,2696,
20221014,987,986,남순천,고흥,4625,94,162,165,247,149,5442,4068,78,128,157,225,146,4802,
20221015,101,102,서울,동수원,3736,42,209,7,2,183,4179,4748,38,305,18,14,225,5348,
20221015,101,103,서울,수원신갈,14635,409,1042,273,105,604,17068,13578,455,1052,254,85,594,16018,
20221015,101,105,서울,기흥,6198,50,151,51,17,238,6705,5485,56,182,78,31,213,6045,
20221015,101,106,서울,오산,4871,236,317,107,54,299,5884,5326,302,343,130,73,321,6495,
20221015,101,107,서울,안성,4001,49,281,29,19,198,4577,3633,32,262,31,22,179,4159,
20221015,101,108,서울,천안,5592,56,352,32,13,231,6276,5245,39,350,31,12,207,5884,
20221015,101,111,서울,청주,938,12,313,17,9,32,1321,905,6,292,15,18,35,1271,
20221015,101,171,서울,마성,3426,52,115,37,6,132,3768,3172,10,127,35,1,127,3472,
20221015,101,172,서울,용인,2815,65,66,21,16,139,3122,3788,94,76,33,26,204,4221,
20221015,101,173,서울,양지,2657,117,98,52,34,74,3032,4450,267,113,121,58,132,5141,
20221015,101,528,서울,기흥동탄,6944,35,541,95,8,295,7918,6776,30,551,96,4,271,7728,
20221015,101,542,서울,서안성,1159,26,98,82,10,57,1432,2325,33,69,148,37,129,2741,
20221015,101,543,서울,남안성,1109,48,42,45,31,52,1327,1223,75,57,70,43,55,1523,
20221015,101,673,서울,북오산,1675,22,96,18,7,98,1916,1689,29,93,18,11,83,1923,
20221015,101,677,서울,북평택,3736,39,210,48,89,131,4253,2608,30,164,41,97,132,3072,
20221015,102,101,동수원,서울,4748,38,305,18,14,225,5348,3736,42,209,7,2,183,4179,
20221015,102,212,동수원,북수원,3217,21,148,3,14,146,3549,3311,26,148,10,17,176,3688,
20221015,102,214,동수원,동군포,1495,25,7,5,1,79,1612,1261,19,8,4,0,60,1352,
20221015,102,215,동수원,군포,1228,10,11,3,3,67,1322,1856,8,14,4,5,96,1983,
20221015,102,253,동수원,서서울,5917,45,45,12,32,289,6340,5781,45,48,14,17,305,6210,
20221015,102,254,동수원,군자,4743,28,45,8,19,212,5055,5446,41,56,21,25,291,5880,
20221015,102,255,동수원,서안산,1367,24,10,6,2,56,1465,1581,26,13,9,3,73,1705,
20221015,103,101,수원신갈,서울,13578,455,1052,254,85,594,16018,14635,409,1042,273,105,604,17068,
20221015,103,105,수원신갈,기흥,1764,17,17,3,21,75,1897,2463,17,11,5,14,104,2614,
20221015,103,106,수원신갈,오산,864,33,30,17,7,60,1011,1196,44,25,8,4,81,1358,
20221015,103,108,수원신갈,천안,1123,4,30,2,2,33,1194,1259,9,30,3,3,48,1352,
20221015,103,253,수원신갈,서서울,2182,97,56,47,19,127,2528,2789,91,51,37,24,148,3140,
20221015,103,254,수원신갈,군자,1933,77,42,54,39,104,2249,2626,75,42,82,55,119,2999,
20221015,103,528,수원신갈,기흥동탄,1197,7,18,5,5,59,1291,1716,9,7,2,2,84,1820,
20221015,105,101,기흥,서울,5485,56,182,78,31,213,6045,6198,50,151,51,17,238,6705,
20221015,105,103,기흥,수원신갈,2463,17,11,5,14,104,2614,1764,17,17,3,21,75,1897,
20221015,106,101,오산,서울,5326,302,343,130,73,321,6495,4871,236,317,107,54,299,5884,
20221015,106,103,오산,수원신갈,1196,44,25,8,4,81,1358,864,33,30,17,7,60,1011,
20221015,106,107,오산,안성,1484,26,12,9,7,101,1639,1075,29,11,5,4,71,1195,
20221015,107,101,안성,서울,3633,32,262,31,22,179,4159,4001,49,281,29,19,198,4577,
20221015,107,106,안성,오산,1075,29,11,5,4,71,1195,1484,26,12,9,7,101,1639,
20221015,107,108,안성,천안,1745,8,34,3,4,108,1902,1684,17,24,4,4,101,1834,
20221015,107,742,안성,남사진위,1196,26,44,17,4,74,1361,1824,28,45,19,7,92,2015,
20221015,108,101,천안,서울,5245,39,350,31,12,207,5884,5592,56,352,32,13,231,6276,
20221015,108,103,천안,수원신갈,1259,9,30,3,3,48,1352,1123,4,30,2,2,33,1194,
20221015,108,107,천안,안성,1684,17,24,4,4,101,1834,1745,8,34,3,4,108,1902,
20221015,108,229,천안,북천안,2170,39,83,21,12,99,2424,2101,47,86,30,35,107,2406,
20221015,108,742,천안,남사진위,1022,13,18,13,3,50,1119,1546,23,29,19,9,65,1691,
20221015,111,101,청주,서울,905,6,292,15,18,35,1271,938,12,313,17,9,32,1321,
20221015,112,115,남청주,대전,1419,63,63,3,22,81,1651,1257,71,53,6,6,86,1479,
20221015,114,153,남대전,서대전,1671,22,53,23,16,101,1886,1387,33,46,23,11,98,1598,
20221015,115,112,대전,남청주,1257,71,53,6,6,86,1479,1419,63,63,3,22,81,1651,
20221015,115,116,대전,옥천,2525,79,29,9,72,175,2889,2137,45,29,21,71,157,2460,
20221015,116,115,옥천,대전,2137,45,29,21,71,157,2460,2525,79,29,9,72,175,2889,
20221015,119,153,판암,서대전,2026,14,22,8,20,145,2235,2089,14,21,12,25,129,2290,
20221015,123,127,구미,서대구,2022,23,31,16,6,105,2203,2048,20,31,10,6,113,2228,
20221015,123,129,구미,북대구,2220,12,65,7,1,88,2393,2332,12,59,9,1,96,2509,
20221015,123,130,구미,동김천,1118,20,16,10,20,62,1246,954,15,11,12,7,56,1055,
20221015,125,127,남구미,서대구,1857,22,49,27,8,121,2084,1889,18,49,24,9,111,2100,
20221015,125,129,남구미,북대구,1638,12,23,4,1,95,1773,1842,8,22,7,10,89,1978,
20221015,126,127,왜관,서대구,2371,88,40,26,56,130,2711,2553,90,48,25,38,125,2879,
20221015,126,129,왜관,북대구,2911,64,34,14,83,128,3234,3364,62,43,14,75,132,3690,
20221015,127,123,서대구,구미,2048,20,31,10,6,113,2228,2022,23,31,16,6,105,2203,
20221015,127,125,서대구,남구미,1889,18,49,24,9,111,2100,1857,22,49,27,8,121,2084,
20221015,127,126,서대구,왜관,2553,90,48,25,38,125,2879,2371,88,40,26,56,130,2711,
20221015,127,131,서대구,경산,2170,95,76,44,34,118,2537,1471,65,45,34,39,84,1738,
20221015,127,203,서대구,가산,2468,36,39,21,24,94,2682,2229,47,42,26,60,95,2499,
20221015,127,230,서대구,팔공산,1538,26,33,8,4,81,1690,957,16,13,5,5,43,1039,
20221015,127,527,서대구,포항,2208,27,36,13,40,94,2418,1384,26,27,6,31,67,1541,
20221015,127,621,서대구,동대구,1687,36,59,26,23,100,1931,1087,21,10,25,23,52,1218,
20221015,129,123,북대구,구미,2332,12,59,9,1,96,2509,2220,12,65,7,1,88,2393,
20221015,129,125,북대구,남구미,1842,8,22,7,10,89,1978,1638,12,23,4,1,95,1773,
20221015,129,126,북대구,왜관,3364,62,43,14,75,132,3690,2911,64,34,14,83,128,3234,
20221015,129,131,북대구,경산,1800,83,50,33,25,85,2076,2401,93,81,30,42,143,2790,
20221015,129,524,북대구,청통와촌,905,30,12,6,25,32,1010,1051,53,17,12,38,35,1206,
20221015,129,527,북대구,포항,2625,15,20,20,39,91,2810,3218,30,35,15,62,128,3488,
20221015,130,123,동김천,구미,954,15,11,12,7,56,1055,1118,20,16,10,20,62,1246,
20221015,131,127,경산,서대구,1471,65,45,34,39,84,1738,2170,95,76,44,34,118,2537,
20221015,131,129,경산,북대구,2401,93,81,30,42,143,2790,1800,83,50,33,25,85,2076,
20221015,131,230,경산,팔공산,1076,42,20,2,13,75,1228,1179,45,30,6,14,75,1349,
20221015,131,621,경산,동대구,1825,39,32,13,44,105,2058,1884,46,29,12,28,93,2092,
20221015,132,621,영천,동대구,1169,11,28,3,40,47,1298,1255,16,23,3,30,44,1371,
20221015,135,140,경주,부산,2294,7,25,5,18,98,2447,2596,16,32,5,14,101,2764,
20221015,135,252,경주,대동,1720,21,70,15,48,81,1955,2328,23,85,13,35,105,2589,
20221015,135,621,경주,동대구,1153,7,53,0,1,43,1257,1380,3,48,3,1,49,1484,
20221015,138,140,양산,부산,3762,195,104,34,74,182,4351,3853,192,105,32,79,201,4462,
20221015,138,252,양산,대동,1721,177,81,57,121,72,2229,1852,185,68,57,142,87,2391,
20221015,139,140,서울산,부산,2073,26,24,2,3,83,2211,2233,34,16,3,7,77,2370,
20221015,139,252,서울산,대동,1176,21,17,13,22,45,1294,1414,21,20,17,9,60,1541,
20221015,139,641,서울산,울산,1365,23,50,14,17,103,1572,1292,14,39,7,16,80,1448,
20221015,140,135,부산,경주,2596,16,32,5,14,101,2764,2294,7,25,5,18,98,2447,
20221015,140,138,부산,양산,3853,192,105,32,79,201,4462,3762,195,104,34,74,182,4351,
20221015,140,139,부산,서울산,2233,34,16,3,7,77,2370,2073,26,24,2,3,83,2211,
20221015,140,250,부산,남양산,7887,129,185,13,29,545,8788,7692,115,168,9,25,560,8569,
20221015,140,251,부산,물금,889,110,23,15,22,42,1101,1127,90,18,24,19,61,1339,
20221015,140,252,부산,대동,1288,15,26,20,21,78,1448,1118,16,26,26,55,62,1303,
20221015,140,286,부산,통도사휴게소,1121,7,5,0,0,42,1175,1105,3,4,0,0,31,1143,
20221015,140,289,부산,마산,1533,1,8,0,3,56,1601,1074,12,10,1,1,39,1137,
20221015,140,755,부산,광재,1034,10,14,3,15,57,1133,925,6,10,2,24,56,1023,
20221015,142,145,군북,산인,4135,32,70,21,30,245,4533,5442,28,69,21,34,269,5863,
20221015,143,145,장지,산인,880,5,18,9,27,71,1010,958,12,13,8,35,75,1101,
20221015,144,145,함안,산인,2814,33,27,14,77,175,3140,3242,36,28,16,81,184,3587,
20221015,145,142,산인,군북,5442,28,69,21,34,269,5863,4135,32,70,21,30,245,4533,
20221015,145,143,산인,장지,958,12,13,8,35,75,1101,880,5,18,9,27,71,1010,
20221015,145,144,산인,함안,3242,36,28,16,81,184,3587,2814,33,27,14,77,175,3140,
20221015,145,291,산인,사천,2543,27,41,7,16,103,2737,1982,39,38,14,6,92,2171,
20221015,145,292,산인,진주,2910,16,141,7,16,130,3220,2593,16,134,5,8,138,2894,
20221015,145,293,산인,문산,2141,15,14,8,2,115,2295,1806,20,14,9,4,79,1932,
20221015,145,295,산인,진성,1239,10,10,3,7,57,1326,1030,13,18,1,9,45,1116,
20221015,146,150,동창원,북부산,1200,9,9,4,21,78,1321,1210,7,7,0,18,72,1314,
20221015,146,244,동창원,서부산,1310,15,27,4,18,87,1461,1549,21,31,15,15,89,1720,
20221015,146,245,동창원,장유,892,11,6,3,11,86,1009,904,2,8,2,13,72,1001,
20221015,146,289,동창원,마산,2662,41,38,25,71,202,3039,2434,39,40,22,59,173,2767,
20221015,147,244,진례,서부산,1083,32,27,29,49,95,1315,1106,45,29,23,42,78,1323,
20221015,148,150,서김해,북부산,6249,69,83,51,44,438,6934,6050,77,56,31,21,411,6646,
20221015,148,251,서김해,물금,945,30,8,16,7,76,1082,900,36,8,32,10,73,1059,
20221015,148,289,서김해,마산,2026,15,55,11,2,105,2214,1643,22,45,8,4,104,1826,
20221015,149,150,동김해,북부산,10638,166,136,35,56,703,11734,9124,119,125,20,23,608,10019,
20221015,149,250,동김해,남양산,1012,17,52,8,3,84,1176,861,13,54,5,4,72,1009,
20221015,149,251,동김해,물금,1158,45,12,8,1,108,1332,1027,36,7,11,2,104,1187,
20221015,149,289,동김해,마산,1093,21,34,22,6,70,1246,996,23,43,13,4,62,1141,
20221015,150,146,북부산,동창원,1210,7,7,0,18,72,1314,1200,9,9,4,21,78,1321,
20221015,150,148,북부산,서김해,6050,77,56,31,21,411,6646,6249,69,83,51,44,438,6934,
20221015,150,149,북부산,동김해,9124,119,125,20,23,608,10019,10638,166,136,35,56,703,11734,
20221015,150,245,북부산,장유,4127,25,78,14,12,232,4488,3280,26,70,7,11,236,3630,
20221015,150,289,북부산,마산,4853,25,93,2,14,196,5183,3975,23,98,5,9,198,4308,
20221015,152,154,유성,안영,1028,7,26,11,11,53,1136,994,12,19,15,29,50,1119,
20221015,153,114,서대전,남대전,1387,33,46,23,11,98,1598,1671,22,53,23,16,101,1886,
20221015,153,119,서대전,판암,2089,14,21,12,25,129,2290,2026,14,22,8,20,145,2235,
20221015,153,154,서대전,안영,1134,19,28,22,95,63,1361,1051,23,30,13,87,64,1268,
20221015,153,579,서대전,남세종,1109,12,7,5,11,61,1205,1028,18,9,5,26,49,1135,
20221015,154,152,안영,유성,994,12,19,15,29,50,1119,1028,7,26,11,11,53,1136,
20221015,154,153,안영,서대전,1051,23,30,13,87,64,1268,1134,19,28,22,95,63,1361,
20221015,158,167,전주,광주,1000,19,56,17,12,35,1139,1132,25,76,16,9,35,1293,
20221015,159,167,서전주,광주,2042,46,51,30,21,46,2236,2149,44,40,21,21,51,2326,
20221015,163,167,정읍,광주,990,13,41,22,15,37,1118,949,21,44,19,8,31,1072,
20221015,166,167,장성,광주,3327,65,51,21,35,103,3602,4520,87,62,23,21,174,4887,
20221015,167,158,광주,전주,1132,25,76,16,9,35,1293,1000,19,56,17,12,35,1139,
20221015,167,159,광주,서전주,2149,44,40,21,21,51,2326,2042,46,51,30,21,46,2236,
20221015,167,163,광주,정읍,949,21,44,19,8,31,1072,990,13,41,22,15,37,1118,
20221015,167,166,광주,장성,4520,87,62,23,21,174,4887,3327,65,51,21,35,103,3602,
20221015,167,567,광주,남고창,1672,24,42,12,11,46,1807,1674,21,35,10,12,52,1804,
20221015,171,101,마성,서울,3172,10,127,35,1,127,3472,3426,52,115,37,6,132,3768,
20221015,171,253,마성,서서울,1107,6,7,1,1,47,1169,1423,6,11,0,0,69,1509,
20221015,172,101,용인,서울,3788,94,76,33,26,204,4221,2815,65,66,21,16,139,3122,
20221015,172,173,용인,양지,1712,86,59,46,45,104,2052,1347,88,51,74,57,98,1715,
20221015,172,253,용인,서서울,1104,32,12,19,13,60,1240,1016,27,21,14,16,48,1142,
20221015,173,101,양지,서울,4450,267,113,121,58,132,5141,2657,117,98,52,34,74,3032,
20221015,173,172,양지,용인,1347,88,51,74,57,98,1715,1712,86,59,46,45,104,2052,
20221015,174,179,춘천,홍천,3346,46,69,13,27,268,3769,3152,57,69,19,30,241,3568,
20221015,174,216,춘천,횡성,1296,40,26,13,20,59,1454,1144,31,25,10,15,60,1285,
20221015,174,218,춘천,남원주,1499,24,54,8,10,80,1675,1415,22,51,9,9,103,1609,
20221015,174,554,춘천,동홍천,1340,15,27,16,10,91,1499,1307,12,17,10,2,74,1422,
20221015,176,190,이천,동서울,1921,34,72,104,50,110,2291,1185,29,55,22,24,71,1386,
20221015,177,190,여주,동서울,1094,17,39,33,22,38,1243,1177,6,40,25,23,40,1311,
20221015,179,174,홍천,춘천,3152,57,69,19,30,241,3568,3346,46,69,13,27,268,3769,
20221015,184,189,대관령,강릉,1613,34,58,6,19,75,1805,1690,37,55,6,5,85,1878,
20221015,189,184,강릉,대관령,1690,37,55,6,5,85,1878,1613,34,58,6,19,75,1805,
20221015,190,176,동서울,이천,1185,29,55,22,24,71,1386,1921,34,72,104,50,110,2291,
20221015,190,177,동서울,여주,1177,6,40,25,23,40,1311,1094,17,39,33,22,38,1243,
20221015,190,191,동서울,경기광주,9413,293,280,109,145,564,10804,8990,296,289,156,230,504,10465,
20221015,190,192,동서울,곤지암,4607,217,123,99,56,237,5339,4345,235,86,94,49,259,5068,
20221015,190,193,동서울,일죽,2808,52,99,82,49,93,3183,2922,69,87,127,58,104,3367,
20221015,190,194,동서울,서이천,4480,346,198,118,75,218,5435,3624,283,152,109,64,169,4401,
20221015,190,198,동서울,서청주,1348,17,25,16,5,55,1466,1540,14,27,11,1,53,1646,
20221015,190,199,동서울,오창,1092,7,12,5,21,43,1180,1297,3,3,10,8,61,1382,
20221015,190,560,동서울,감곡,1255,9,10,16,36,33,1359,1123,15,17,8,29,40,1232,
20221015,190,705,동서울,남이천,1418,32,30,41,53,45,1619,1833,49,20,70,50,47,2069,
20221015,191,190,경기광주,동서울,8990,296,289,156,230,504,10465,9413,293,280,109,145,564,10804,
20221015,192,190,곤지암,동서울,4345,235,86,94,49,259,5068,4607,217,123,99,56,237,5339,
20221015,192,194,곤지암,서이천,1587,146,85,66,55,95,2034,1245,90,64,46,51,62,1558,
20221015,193,190,일죽,동서울,2922,69,87,127,58,104,3367,2808,52,99,82,49,93,3183,
20221015,194,190,서이천,동서울,3624,283,152,109,64,169,4401,4480,346,198,118,75,218,5435,
20221015,194,192,서이천,곤지암,1245,90,64,46,51,62,1558,1587,146,85,66,55,95,2034,
20221015,196,198,진천,서청주,1134,22,56,24,13,63,1312,903,19,50,15,13,43,1043,
20221015,198,190,서청주,동서울,1540,14,27,11,1,53,1646,1348,17,25,16,5,55,1466,
20221015,198,196,서청주,진천,903,19,50,15,13,43,1043,1134,22,56,24,13,63,1312,
20221015,199,190,오창,동서울,1297,3,3,10,8,61,1382,1092,7,12,5,21,43,1180,
20221015,201,203,칠곡,가산,852,19,21,7,98,29,1026,885,20,23,18,126,26,1098,
20221015,203,127,가산,서대구,2229,47,42,26,60,95,2499,2468,36,39,21,24,94,2682,
20221015,203,201,가산,칠곡,885,20,23,18,126,26,1098,852,19,21,7,98,29,1026,
20221015,203,775,가산,동명동호,2013,32,43,26,278,78,2470,1826,33,32,17,133,79,2120,
20221015,207,775,남안동,동명동호,1073,9,8,2,3,27,1122,1020,8,6,5,11,43,1093,
20221015,212,102,북수원,동수원,3311,26,148,10,17,176,3688,3217,21,148,3,14,146,3549,
20221015,212,254,북수원,군자,2054,26,30,7,17,114,2248,1511,23,26,14,15,81,1670,
20221015,213,253,부곡,서서울,1393,61,35,19,49,105,1662,1116,54,30,21,48,59,1328,
20221015,213,254,부곡,군자,1041,19,13,12,123,51,1259,1170,23,23,11,116,61,1404,
20221015,214,102,동군포,동수원,1261,19,8,4,0,60,1352,1495,25,7,5,1,79,1612,
20221015,215,102,군포,동수원,1856,8,14,4,5,96,1983,1228,10,11,3,3,67,1322,
20221015,215,253,군포,서서울,3545,41,48,28,45,205,3912,4043,76,84,52,61,255,4571,
20221015,215,254,군포,군자,2816,39,34,19,33,160,3101,3225,66,55,49,71,181,3647,
20221015,215,255,군포,서안산,920,19,8,9,8,64,1028,1076,41,14,44,24,82,1281,
20221015,216,174,횡성,춘천,1144,31,25,10,15,60,1285,1296,40,26,13,20,59,1454,
20221015,218,174,남원주,춘천,1415,22,51,9,9,103,1609,1499,24,54,8,10,80,1675,
20221015,218,240,남원주,제천,2159,25,37,11,36,122,2390,2219,36,42,8,25,113,2443,
20221015,225,291,서진주,사천,1047,23,20,5,19,64,1178,969,15,29,9,13,68,1103,
20221015,225,516,서진주,통영,954,6,6,2,7,68,1043,936,7,4,1,6,65,1019,
20221015,229,108,북천안,천안,2101,47,86,30,35,107,2406,2170,39,83,21,12,99,2424,
20221015,230,127,팔공산,서대구,957,16,13,5,5,43,1039,1538,26,33,8,4,81,1690,
20221015,230,131,팔공산,경산,1179,45,30,6,14,75,1349,1076,42,20,2,13,75,1228,
20221015,230,524,팔공산,청통와촌,1085,24,17,5,6,58,1195,948,25,18,5,9,40,1045,
20221015,230,527,팔공산,포항,2644,23,13,12,12,80,2784,2274,26,14,7,30,74,2425,
20221015,231,519,화원옥포,남대구,5735,120,79,41,96,392,6463,5440,92,75,34,53,383,6077,
20221015,232,519,달성,남대구,1958,68,62,29,15,156,2288,1926,67,57,25,13,130,2218,
20221015,233,519,현풍,남대구,3886,97,94,38,77,263,4455,3590,98,95,43,62,218,4106,
20221015,237,239,남지,칠원,892,17,45,9,73,69,1105,987,15,45,9,77,76,1209,
20221015,238,239,칠서,칠원,1032,35,55,53,269,77,1521,1256,44,46,35,277,72,1730,
20221015,239,237,칠원,남지,987,15,45,9,77,76,1209,892,17,45,9,73,69,1105,
20221015,239,238,칠원,칠서,1256,44,46,35,277,72,1730,1032,35,55,53,269,77,1521,
20221015,239,519,칠원,남대구,2202,20,94,17,43,97,2473,2533,19,89,25,32,101,2799,
20221015,240,218,제천,남원주,2219,36,42,8,25,113,2443,2159,25,37,11,36,122,2390,
20221015,241,519,동고령,남대구,3183,57,70,37,113,152,3612,3158,54,63,26,118,163,3582,
20221015,242,519,고령,남대구,2833,27,52,12,165,122,3211,3580,23,54,14,200,136,4007,
20221015,243,519,해인사,남대구,978,5,3,0,2,31,1019,1176,5,7,0,3,47,1238,
20221015,244,146,서부산,동창원,1549,21,31,15,15,89,1720,1310,15,27,4,18,87,1461,
20221015,244,147,서부산,진례,1106,45,29,23,42,78,1323,1083,32,27,29,49,95,1315,
20221015,244,245,서부산,장유,14149,128,282,58,104,942,15663,13282,120,287,56,96,946,14787,
20221015,244,289,서부산,마산,5435,35,317,19,35,240,6081,3924,34,283,20,26,190,4477,
20221015,245,146,장유,동창원,904,2,8,2,13,72,1001,892,11,6,3,11,86,1009,
20221015,245,150,장유,북부산,3280,26,70,7,11,236,3630,4127,25,78,14,12,232,4488,
20221015,245,244,장유,서부산,13282,120,287,56,96,946,14787,14149,128,282,58,104,942,15663,
20221015,245,289,장유,마산,1921,12,34,11,16,100,2094,1682,13,30,16,8,112,1861,
20221015,248,261,순창,동광주,1863,17,16,6,24,55,1981,1940,12,17,1,21,74,2065,
20221015,249,261,담양,동광주,3116,19,106,9,31,110,3391,2625,23,97,6,31,84,2866,
20221015,250,140,남양산,부산,7692,115,168,9,25,560,8569,7887,129,185,13,29,545,8788,
20221015,250,149,남양산,동김해,861,13,54,5,4,72,1009,1012,17,52,8,3,84,1176,
20221015,250,252,남양산,대동,2923,92,66,41,71,203,3396,3696,80,73,40,68,230,4187,
20221015,251,140,물금,부산,1127,90,18,24,19,61,1339,889,110,23,15,22,42,1101,
20221015,251,148,물금,서김해,900,36,8,32,10,73,1059,945,30,8,16,7,76,1082,
20221015,251,149,물금,동김해,1027,36,7,11,2,104,1187,1158,45,12,8,1,108,1332,
20221015,251,252,물금,대동,2681,169,34,62,246,189,3381,3533,160,46,59,255,236,4289,
20221015,252,135,대동,경주,2328,23,85,13,35,105,2589,1720,21,70,15,48,81,1955,
20221015,252,138,대동,양산,1852,185,68,57,142,87,2391,1721,177,81,57,121,72,2229,
20221015,252,139,대동,서울산,1414,21,20,17,9,60,1541,1176,21,17,13,22,45,1294,
20221015,252,140,대동,부산,1118,16,26,26,55,62,1303,1288,15,26,20,21,78,1448,
20221015,252,250,대동,남양산,3696,80,73,40,68,230,4187,2923,92,66,41,71,203,3396,
20221015,252,251,대동,물금,3533,160,46,59,255,236,4289,2681,169,34,62,246,189,3381,
20221015,252,641,대동,울산,1970,25,56,10,41,118,2220,1904,35,69,15,37,116,2176,
20221015,252,752,대동,기장철마,1714,21,28,9,68,132,1972,1810,21,28,7,39,141,2046,
20221015,252,753,대동,금정,1673,37,44,37,101,94,1986,969,20,22,16,53,47,1127,
20221015,252,755,대동,광재,1804,42,30,23,151,122,2172,1695,30,22,23,156,77,2003,
20221015,253,102,서서울,동수원,5781,45,48,14,17,305,6210,5917,45,45,12,32,289,6340,
20221015,253,103,서서울,수원신갈,2789,91,51,37,24,148,3140,2182,97,56,47,19,127,2528,
20221015,253,171,서서울,마성,1423,6,11,0,0,69,1509,1107,6,7,1,1,47,1169,
20221015,253,172,서서울,용인,1016,27,21,14,16,48,1142,1104,32,12,19,13,60,1240,
20221015,253,213,서서울,부곡,1116,54,30,21,48,59,1328,1393,61,35,19,49,105,1662,
20221015,253,215,서서울,군포,4043,76,84,52,61,255,4571,3545,41,48,28,45,205,3912,
20221015,253,255,서서울,서안산,10905,262,145,162,237,598,12309,11325,233,101,125,221,657,12662,
20221015,253,256,서서울,안산,9287,114,81,25,29,565,10101,6282,69,51,15,52,356,6825,
20221015,253,257,서서울,홍성,1822,5,9,4,2,56,1898,1074,4,11,4,9,33,1135,
20221015,253,259,서서울,대천,1691,8,17,3,0,52,1771,1015,4,13,5,0,31,1068,
20221015,253,281,서서울,매송,3397,29,14,13,24,205,3682,3825,30,19,10,65,217,4166,
20221015,253,282,서서울,비봉,4981,98,105,58,317,242,5801,5068,115,98,71,379,274,6005,
20221015,253,283,서서울,발안,2615,45,32,32,98,142,2964,3679,83,46,53,135,199,4195,
20221015,253,285,서서울,서평택,1509,15,40,56,95,84,1799,1683,40,51,87,213,110,2184,
20221015,253,287,서서울,송악,2397,17,22,21,123,88,2668,2998,27,28,47,220,110,3430,
20221015,253,288,서서울,당진,1817,13,36,15,12,74,1967,2095,14,39,16,35,111,2310,
20221015,253,298,서서울,서산,4227,23,41,34,10,170,4505,3627,21,36,16,25,133,3858,
20221015,253,520,서서울,평택,3271,45,59,69,71,131,3646,3334,39,66,74,71,127,3711,
20221015,253,540,서서울,청북,923,11,15,19,34,42,1044,909,27,30,51,48,52,1117,
20221015,253,741,서서울,평택고덕,1255,16,9,16,7,64,1367,1664,12,7,17,8,107,1815,
20221015,254,102,군자,동수원,5446,41,56,21,25,291,5880,4743,28,45,8,19,212,5055,
20221015,254,103,군자,수원신갈,2626,75,42,82,55,119,2999,1933,77,42,54,39,104,2249,
20221015,254,212,군자,북수원,1511,23,26,14,15,81,1670,2054,26,30,7,17,114,2248,
20221015,254,213,군자,부곡,1170,23,23,11,116,61,1404,1041,19,13,12,123,51,1259,
20221015,254,215,군자,군포,3225,66,55,49,71,181,3647,2816,39,34,19,33,160,3101,
20221015,254,255,군자,서안산,9557,174,92,128,195,566,10712,8713,193,87,112,140,513,9758,
20221015,254,256,군자,안산,5030,91,108,25,57,361,5672,5602,85,109,39,42,376,6253,
20221015,254,281,군자,매송,882,14,14,10,60,61,1041,1126,18,17,8,54,58,1281,
20221015,254,282,군자,비봉,1154,46,32,33,116,62,1443,969,50,19,23,86,57,1204,
20221015,254,283,군자,발안,921,18,17,30,45,59,1090,1044,26,21,22,44,73,1230,
20221015,255,102,서안산,동수원,1581,26,13,9,3,73,1705,1367,24,10,6,2,56,1465,
20221015,255,215,서안산,군포,1076,41,14,44,24,82,1281,920,19,8,9,8,64,1028,
20221015,255,253,서안산,서서울,11325,233,101,125,221,657,12662,10905,262,145,162,237,598,12309,
20221015,255,254,서안산,군자,8713,193,87,112,140,513,9758,9557,174,92,128,195,566,10712,
20221015,256,253,안산,서서울,6282,69,51,15,52,356,6825,9287,114,81,25,29,565,10101,
20221015,256,254,안산,군자,5602,85,109,39,42,376,6253,5030,91,108,25,57,361,5672,
20221015,257,253,홍성,서서울,1074,4,11,4,9,33,1135,1822,5,9,4,2,56,1898,
20221015,259,253,대천,서서울,1015,4,13,5,0,31,1068,1691,8,17,3,0,52,1771,
20221015,261,248,동광주,순창,1940,12,17,1,21,74,2065,1863,17,16,6,24,55,1981,
20221015,261,249,동광주,담양,2625,23,97,6,31,84,2866,3116,19,106,9,31,110,3391,
20221015,261,262,동광주,창평,1894,63,20,13,16,64,2070,1893,55,24,25,17,77,2091,
20221015,261,263,동광주,옥과,2931,23,90,18,23,134,3219,2650,14,86,14,51,119,2934,
20221015,261,265,동광주,곡성,2004,13,39,9,14,82,2161,1655,10,37,11,9,63,1785,
20221015,261,270,동광주,서순천,1194,24,49,2,3,44,1316,1211,13,42,7,5,54,1332,
20221015,261,271,동광주,순천,4623,57,67,19,35,120,4921,4433,76,58,15,32,123,4737,
20221015,262,261,창평,동광주,1893,55,24,25,17,77,2091,1894,63,20,13,16,64,2070,
20221015,263,261,옥과,동광주,2650,14,86,14,51,119,2934,2931,23,90,18,23,134,3219,
20221015,265,261,곡성,동광주,1655,10,37,11,9,63,1785,2004,13,39,9,14,82,2161,
20221015,270,261,서순천,동광주,1211,13,42,7,5,54,1332,1194,24,49,2,3,44,1316,
20221015,271,261,순천,동광주,4433,76,58,15,32,123,4737,4623,57,67,19,35,120,4921,
20221015,271,569,순천,북광주,1121,40,21,12,50,28,1272,1257,43,11,14,32,37,1394,
20221015,280,519,거창,남대구,1490,22,39,4,5,82,1642,1808,21,46,7,6,102,1990,
20221015,281,253,매송,서서울,3825,30,19,10,65,217,4166,3397,29,14,13,24,205,3682,
20221015,281,254,매송,군자,1126,18,17,8,54,58,1281,882,14,14,10,60,61,1041,
20221015,282,253,비봉,서서울,5068,115,98,71,379,274,6005,4981,98,105,58,317,242,5801,
20221015,282,254,비봉,군자,969,50,19,23,86,57,1204,1154,46,32,33,116,62,1443,
20221015,283,253,발안,서서울,3679,83,46,53,135,199,4195,2615,45,32,32,98,142,2964,
20221015,283,254,발안,군자,1044,26,21,22,44,73,1230,921,18,17,30,45,59,1090,
20221015,285,253,서평택,서서울,1683,40,51,87,213,110,2184,1509,15,40,56,95,84,1799,
20221015,285,287,서평택,송악,877,19,30,21,278,45,1270,708,18,30,24,190,43,1013,
20221015,286,140,통도사휴게소,부산,1105,3,4,0,0,31,1143,1121,7,5,0,0,42,1175,
20221015,287,253,송악,서서울,2998,27,28,47,220,110,3430,2397,17,22,21,123,88,2668,
20221015,287,285,송악,서평택,708,18,30,24,190,43,1013,877,19,30,21,278,45,1270,
20221015,288,253,당진,서서울,2095,14,39,16,35,111,2310,1817,13,36,15,12,74,1967,
20221015,289,140,마산,부산,1074,12,10,1,1,39,1137,1533,1,8,0,3,56,1601,
20221015,289,146,마산,동창원,2434,39,40,22,59,173,2767,2662,41,38,25,71,202,3039,
20221015,289,148,마산,서김해,1643,22,45,8,4,104,1826,2026,15,55,11,2,105,2214,
20221015,289,149,마산,동김해,996,23,43,13,4,62,1141,1093,21,34,22,6,70,1246,
20221015,289,150,마산,북부산,3975,23,98,5,9,198,4308,4853,25,93,2,14,196,5183,
20221015,289,244,마산,서부산,3924,34,283,20,26,190,4477,5435,35,317,19,35,240,6081,
20221015,289,245,마산,장유,1682,13,30,16,8,112,1861,1921,12,34,11,16,100,2094,
20221015,291,145,사천,산인,1982,39,38,14,6,92,2171,2543,27,41,7,16,103,2737,
20221015,291,225,사천,서진주,969,15,29,9,13,68,1103,1047,23,20,5,19,64,1178,
20221015,291,292,사천,진주,2219,41,58,24,23,177,2542,2882,60,69,33,29,201,3274,
20221015,292,145,진주,산인,2593,16,134,5,8,138,2894,2910,16,141,7,16,130,3220,
20221015,292,291,진주,사천,2882,60,69,33,29,201,3274,2219,41,58,24,23,177,2542,
20221015,292,516,진주,통영,1142,14,21,4,4,74,1259,1144,22,16,3,11,94,1290,
20221015,293,145,문산,산인,1806,20,14,9,4,79,1932,2141,15,14,8,2,115,2295,
20221015,295,145,진성,산인,1030,13,18,1,9,45,1116,1239,10,10,3,7,57,1326,
20221015,298,253,서산,서서울,3627,21,36,16,25,133,3858,4227,23,41,34,10,170,4505,
20221015,508,509,무안,목포,1154,30,19,21,25,47,1296,1490,30,37,12,22,67,1658,
20221015,508,553,무안,동광산,1513,12,20,13,8,54,1620,1860,20,20,18,13,54,1985,
20221015,509,508,목포,무안,1490,30,37,12,22,67,1658,1154,30,19,21,25,47,1296,
20221015,509,553,목포,동광산,10269,135,177,96,186,337,11200,9984,105,199,130,172,292,10882,
20221015,513,515,고성,북통영,2731,32,60,10,19,163,3015,2559,26,68,12,6,149,2820,
20221015,513,516,고성,통영,5584,52,91,32,90,340,6189,4645,49,85,40,93,293,5205,
20221015,514,516,동고성,통영,1272,13,26,12,42,121,1486,1272,12,27,6,43,130,1490,
20221015,515,513,북통영,고성,2559,26,68,12,6,149,2820,2731,32,60,10,19,163,3015,
20221015,516,225,통영,서진주,936,7,4,1,6,65,1019,954,6,6,2,7,68,1043,
20221015,516,292,통영,진주,1144,22,16,3,11,94,1290,1142,14,21,4,4,74,1259,
20221015,516,513,통영,고성,4645,49,85,40,93,293,5205,5584,52,91,32,90,340,6189,
20221015,516,514,통영,동고성,1272,12,27,6,43,130,1490,1272,13,26,12,42,121,1486,
20221015,517,598,양평,북여주,2035,16,6,13,29,56,2155,1232,11,5,12,16,53,1329,
20221015,519,231,남대구,화원옥포,5440,92,75,34,53,383,6077,5735,120,79,41,96,392,6463,
20221015,519,232,남대구,달성,1926,67,57,25,13,130,2218,1958,68,62,29,15,156,2288,
20221015,519,233,남대구,현풍,3590,98,95,43,62,218,4106,3886,97,94,38,77,263,4455,
20221015,519,239,남대구,칠원,2533,19,89,25,32,101,2799,2202,20,94,17,43,97,2473,
20221015,519,241,남대구,동고령,3158,54,63,26,118,163,3582,3183,57,70,37,113,152,3612,
20221015,519,242,남대구,고령,3580,23,54,14,200,136,4007,2833,27,52,12,165,122,3211,
20221015,519,243,남대구,해인사,1176,5,7,0,3,47,1238,978,5,3,0,2,31,1019,
20221015,519,280,남대구,거창,1808,21,46,7,6,102,1990,1490,22,39,4,5,82,1642,
20221015,519,730,남대구,유천,2175,33,13,0,5,121,2347,2522,38,12,0,0,149,2721,
20221015,519,731,남대구,북현풍,1778,21,22,0,1,99,1921,1514,16,4,0,0,105,1639,
20221015,520,253,평택,서서울,3334,39,66,74,71,127,3711,3271,45,59,69,71,131,3646,
20221015,520,540,평택,청북,1320,32,68,48,53,52,1573,1095,24,78,64,61,48,1370,
20221015,524,129,청통와촌,북대구,1051,53,17,12,38,35,1206,905,30,12,6,25,32,1010,
20221015,524,230,청통와촌,팔공산,948,25,18,5,9,40,1045,1085,24,17,5,6,58,1195,
20221015,524,527,청통와촌,포항,1056,34,12,4,20,46,1172,1009,27,10,8,22,47,1123,
20221015,526,527,서포항,포항,1109,8,13,2,85,67,1284,1503,8,14,4,89,92,1710,
20221015,527,127,포항,서대구,1384,26,27,6,31,67,1541,2208,27,36,13,40,94,2418,
20221015,527,129,포항,북대구,3218,30,35,15,62,128,3488,2625,15,20,20,39,91,2810,
20221015,527,230,포항,팔공산,2274,26,14,7,30,74,2425,2644,23,13,12,12,80,2784,
20221015,527,524,포항,청통와촌,1009,27,10,8,22,47,1123,1056,34,12,4,20,46,1172,
20221015,527,526,포항,서포항,1503,8,14,4,89,92,1710,1109,8,13,2,85,67,1284,
20221015,528,101,기흥동탄,서울,6776,30,551,96,4,271,7728,6944,35,541,95,8,295,7918,
20221015,528,103,기흥동탄,수원신갈,1716,9,7,2,2,84,1820,1197,7,18,5,5,59,1291,
20221015,540,253,청북,서서울,909,27,30,51,48,52,1117,923,11,15,19,34,42,1044,
20221015,540,520,청북,평택,1095,24,78,64,61,48,1370,1320,32,68,48,53,52,1573,
20221015,542,101,서안성,서울,2325,33,69,148,37,129,2741,1159,26,98,82,10,57,1432,
20221015,542,543,서안성,남안성,767,17,47,66,74,51,1022,1036,16,48,70,70,59,1299,
20221015,543,101,남안성,서울,1223,75,57,70,43,55,1523,1109,48,42,45,31,52,1327,
20221015,543,542,남안성,서안성,1036,16,48,70,70,59,1299,767,17,47,66,74,51,1022,
20221015,548,553,북무안,동광산,2189,17,27,26,64,71,2394,3113,28,31,31,90,93,3386,
20221015,549,553,동함평,동광산,3425,20,40,16,34,117,3652,3609,29,48,23,29,116,3854,
20221015,551,553,나주,동광산,1200,7,11,16,31,64,1329,1234,11,12,13,22,56,1348,
20221015,552,553,서광산,동광산,3770,150,111,120,162,95,4408,5378,159,124,123,126,155,6065,
20221015,553,508,동광산,무안,1860,20,20,18,13,54,1985,1513,12,20,13,8,54,1620,
20221015,553,509,동광산,목포,9984,105,199,130,172,292,10882,10269,135,177,96,186,337,11200,
20221015,553,548,동광산,북무안,3113,28,31,31,90,93,3386,2189,17,27,26,64,71,2394,
20221015,553,549,동광산,동함평,3609,29,48,23,29,116,3854,3425,20,40,16,34,117,3652,
20221015,553,551,동광산,나주,1234,11,12,13,22,56,1348,1200,7,11,16,31,64,1329,
20221015,553,552,동광산,서광산,5378,159,124,123,126,155,6065,3770,150,111,120,162,95,4408,
20221015,554,174,동홍천,춘천,1307,12,17,10,2,74,1422,1340,15,27,16,10,91,1499,
20221015,556,557,동순천,황전,1225,6,20,6,36,37,1330,976,8,15,3,38,35,1075,
20221015,557,556,황전,동순천,976,8,15,3,38,35,1075,1225,6,20,6,36,37,1330,
20221015,560,190,감곡,동서울,1123,15,17,8,29,40,1232,1255,9,10,16,36,33,1359,
20221015,567,167,남고창,광주,1674,21,35,10,12,52,1804,1672,24,42,12,11,46,1807,
20221015,569,271,북광주,순천,1257,43,11,14,32,37,1394,1121,40,21,12,50,28,1272,
20221015,573,578,예산수덕사,서세종,1107,16,14,8,11,38,1194,1297,9,13,9,12,43,1383,
20221015,578,573,서세종,예산수덕사,1297,9,13,9,12,43,1383,1107,16,14,8,11,38,1194,
20221015,579,153,남세종,서대전,1028,18,9,5,26,49,1135,1109,12,7,5,11,61,1205,
20221015,583,584,동해,남강릉,932,19,12,6,44,77,1090,884,16,15,5,27,61,1008,
20221015,583,704,동해,근덕,951,5,28,4,55,57,1100,1019,12,27,3,37,49,1147,
20221015,584,583,남강릉,동해,884,16,15,5,27,61,1008,932,19,12,6,44,77,1090,
20221015,587,589,오수,상관,1224,7,58,25,41,41,1396,1430,14,45,21,104,46,1660,
20221015,589,587,상관,오수,1430,14,45,21,104,46,1660,1224,7,58,25,41,41,1396,
20221015,597,598,서여주,북여주,852,33,103,23,23,45,1079,947,24,53,19,20,40,1103,
20221015,598,517,북여주,양평,1232,11,5,12,16,53,1329,2035,16,6,13,29,56,2155,
20221015,598,597,북여주,서여주,947,24,53,19,20,40,1103,852,33,103,23,23,45,1079,
20221015,621,127,동대구,서대구,1087,21,10,25,23,52,1218,1687,36,59,26,23,100,1931,
20221015,621,131,동대구,경산,1884,46,29,12,28,93,2092,1825,39,32,13,44,105,2058,
20221015,621,132,동대구,영천,1255,16,23,3,30,44,1371,1169,11,28,3,40,47,1298,
20221015,621,135,동대구,경주,1380,3,48,3,1,49,1484,1153,7,53,0,1,43,1257,
20221015,624,626,청도,남밀양,1107,16,15,13,33,39,1223,1144,17,19,16,23,53,1272,
20221015,625,626,밀양,남밀양,1779,34,40,27,39,63,1982,2137,33,38,21,58,83,2370,
20221015,626,624,남밀양,청도,1144,17,19,16,23,53,1272,1107,16,15,13,33,39,1223,
20221015,626,625,남밀양,밀양,2137,33,38,21,58,83,2370,1779,34,40,27,39,63,1982,
20221015,626,627,남밀양,삼랑진,1053,23,22,4,14,92,1208,1023,19,14,6,18,86,1166,
20221015,627,626,삼랑진,남밀양,1023,19,14,6,18,86,1166,1053,23,22,4,14,92,1208,
20221015,641,139,울산,서울산,1292,14,39,7,16,80,1448,1365,23,50,14,17,103,1572,
20221015,641,252,울산,대동,1904,35,69,15,37,116,2176,1970,25,56,10,41,118,2220,
20221015,641,648,울산,해운대,1231,4,2,0,6,70,1313,1464,8,6,1,3,75,1557,
20221015,641,706,울산,남경주,1548,7,16,6,23,83,1683,1614,5,13,17,12,83,1744,
20221015,641,707,울산,남포항,1878,11,32,10,115,101,2147,1691,11,26,28,91,76,1923,
20221015,643,645,청량,장안,836,11,9,10,139,56,1061,758,8,9,13,177,45,1010,
20221015,643,648,청량,해운대,3897,14,17,9,38,203,4178,3834,27,57,17,203,186,4324,
20221015,645,643,장안,청량,758,8,9,13,177,45,1010,836,11,9,10,139,56,1061,
20221015,645,648,장안,해운대,1447,6,1,2,8,70,1534,2768,17,9,9,50,136,2989,
20221015,646,648,기장일광,해운대,4916,12,14,4,30,258,5234,5695,23,13,20,80,303,6134,
20221015,648,641,해운대,울산,1464,8,6,1,3,75,1557,1231,4,2,0,6,70,1313,
20221015,648,643,해운대,청량,3834,27,57,17,203,186,4324,3897,14,17,9,38,203,4178,
20221015,648,645,해운대,장안,2768,17,9,9,50,136,2989,1447,6,1,2,8,70,1534,
20221015,648,646,해운대,기장일광,5695,23,13,20,80,303,6134,4916,12,14,4,30,258,5234,
20221015,648,707,해운대,남포항,1311,7,33,9,44,64,1468,1220,2,9,7,25,56,1319,
20221015,651,652,남양주,화도,10403,209,275,249,100,677,11913,11699,212,315,257,77,659,13219,
20221015,651,653,남양주,서종,1964,7,10,5,10,80,2076,2513,13,10,4,9,110,2659,
20221015,651,654,남양주,설악,5615,25,62,11,12,197,5922,4217,24,82,10,6,165,4504,
20221015,651,655,남양주,강촌,3785,16,101,18,30,134,4084,3178,23,106,10,17,102,3436,
20221015,651,656,남양주,남춘천,3967,25,44,17,21,132,4206,2474,11,36,6,14,65,2606,
20221015,652,651,화도,남양주,11699,212,315,257,77,659,13219,10403,209,275,249,100,677,11913,
20221015,652,653,화도,서종,1141,15,7,13,3,87,1266,1641,26,13,22,5,96,1803,
20221015,652,654,화도,설악,1596,9,8,3,5,67,1688,1265,19,8,4,9,60,1365,
20221015,653,651,서종,남양주,2513,13,10,4,9,110,2659,1964,7,10,5,10,80,2076,
20221015,653,652,서종,화도,1641,26,13,22,5,96,1803,1141,15,7,13,3,87,1266,
20221015,654,651,설악,남양주,4217,24,82,10,6,165,4504,5615,25,62,11,12,197,5922,
20221015,654,652,설악,화도,1265,19,8,4,9,60,1365,1596,9,8,3,5,67,1688,
20221015,655,651,강촌,남양주,3178,23,106,10,17,102,3436,3785,16,101,18,30,134,4084,
20221015,656,651,남춘천,남양주,2474,11,36,6,14,65,2606,3967,25,44,17,21,132,4206,
20221015,671,672,봉담,정남,1932,62,33,28,106,117,2278,2579,58,32,20,158,149,2996,
20221015,671,673,봉담,북오산,1724,44,28,9,14,102,1921,2147,40,40,9,26,115,2377,
20221015,671,677,봉담,북평택,10042,87,104,59,91,477,10860,9975,88,109,46,76,481,10775,
20221015,672,671,정남,봉담,2579,58,32,20,158,149,2996,1932,62,33,28,106,117,2278,
20221015,673,101,북오산,서울,1689,29,93,18,11,83,1923,1675,22,96,18,7,98,1916,
20221015,673,671,북오산,봉담,2147,40,40,9,26,115,2377,1724,44,28,9,14,102,1921,
20221015,673,677,북오산,북평택,2508,31,26,14,14,126,2719,1795,32,20,9,11,99,1966,
20221015,675,676,서오산,향남,2200,70,27,20,41,132,2490,2003,45,25,17,27,130,2247,
20221015,675,677,서오산,북평택,15356,124,194,96,115,778,16663,13103,107,190,74,103,692,14269,
20221015,675,876,서오산,양감,750,28,17,11,149,45,1000,819,26,10,9,148,50,1062,
20221015,676,675,향남,서오산,2003,45,25,17,27,130,2247,2200,70,27,20,41,132,2490,
20221015,676,677,향남,북평택,1728,69,73,58,70,90,2088,1405,55,53,67,61,71,1712,
20221015,677,101,북평택,서울,2608,30,164,41,97,132,3072,3736,39,210,48,89,131,4253,
20221015,677,671,북평택,봉담,9975,88,109,46,76,481,10775,10042,87,104,59,91,477,10860,
20221015,677,673,북평택,북오산,1795,32,20,9,11,99,1966,2508,31,26,14,14,126,2719,
20221015,677,675,북평택,서오산,13103,107,190,74,103,692,14269,15356,124,194,96,115,778,16663,
20221015,677,676,북평택,향남,1405,55,53,67,61,71,1712,1728,69,73,58,70,90,2088,
20221015,677,876,북평택,양감,2901,52,46,47,75,145,3266,1695,38,53,44,61,96,1987,
20221015,682,685,조암,서시흥,1511,59,83,57,134,83,1927,1618,60,85,77,177,89,2106,
20221015,683,684,송산마도,남안산,2149,94,59,52,144,99,2597,2286,80,58,36,42,118,2620,
20221015,683,685,송산마도,서시흥,5133,84,105,99,699,258,6378,4745,90,83,85,703,221,5927,
20221015,684,683,남안산,송산마도,2286,80,58,36,42,118,2620,2149,94,59,52,144,99,2597,
20221015,684,685,남안산,서시흥,3148,206,140,247,306,230,4277,3798,162,156,199,182,273,4770,
20221015,685,682,서시흥,조암,1618,60,85,77,177,89,2106,1511,59,83,57,134,83,1927,
20221015,685,683,서시흥,송산마도,4745,90,83,85,703,221,5927,5133,84,105,99,699,258,6378,
20221015,685,684,서시흥,남안산,3798,162,156,199,182,273,4770,3148,206,140,247,306,230,4277,
20221015,704,583,근덕,동해,1019,12,27,3,37,49,1147,951,5,28,4,55,57,1100,
20221015,705,190,남이천,동서울,1833,49,20,70,50,47,2069,1418,32,30,41,53,45,1619,
20221015,706,641,남경주,울산,1614,5,13,17,12,83,1744,1548,7,16,6,23,83,1683,
20221015,706,707,남경주,남포항,1693,23,37,19,154,86,2012,1536,33,41,24,118,95,1847,
20221015,707,641,남포항,울산,1691,11,26,28,91,76,1923,1878,11,32,10,115,101,2147,
20221015,707,648,남포항,해운대,1220,2,9,7,25,56,1319,1311,7,33,9,44,64,1468,
20221015,707,706,남포항,남경주,1536,33,41,24,118,95,1847,1693,23,37,19,154,86,2012,
20221015,707,708,남포항,동경주,1870,18,11,14,188,74,2175,1810,14,10,14,228,103,2179,
20221015,708,707,동경주,남포항,1810,14,10,14,228,103,2179,1870,18,11,14,188,74,2175,
20221015,715,716,동안동,청송,1075,9,9,8,2,48,1151,1018,14,9,4,7,52,1104,
20221015,715,749,동안동,영덕,1250,9,23,4,22,38,1346,1024,4,23,5,20,27,1103,
20221015,716,715,청송,동안동,1018,14,9,4,7,52,1104,1075,9,9,8,2,48,1151,
20221015,730,519,유천,남대구,2522,38,12,0,0,149,2721,2175,33,13,0,5,121,2347,
20221015,731,519,북현풍,남대구,1514,16,4,0,0,105,1639,1778,21,22,0,1,99,1921,
20221015,741,253,평택고덕,서서울,1664,12,7,17,8,107,1815,1255,16,9,16,7,64,1367,
20221015,742,107,남사진위,안성,1824,28,45,19,7,92,2015,1196,26,44,17,4,74,1361,
20221015,742,108,남사진위,천안,1546,23,29,19,9,65,1691,1022,13,18,13,3,50,1119,
20221015,749,715,영덕,동안동,1024,4,23,5,20,27,1103,1250,9,23,4,22,38,1346,
20221015,752,252,기장철마,대동,1810,21,28,7,39,141,2046,1714,21,28,9,68,132,1972,
20221015,753,252,금정,대동,969,20,22,16,53,47,1127,1673,37,44,37,101,94,1986,
20221015,755,140,광재,부산,925,6,10,2,24,56,1023,1034,10,14,3,15,57,1133,
20221015,755,252,광재,대동,1695,30,22,23,156,77,2003,1804,42,30,23,151,122,2172,
20221015,772,774,북달성,남칠곡,2368,24,29,17,21,109,2568,2458,30,39,21,26,108,2682,
20221015,773,774,북다사,남칠곡,1318,13,16,3,15,59,1424,1148,12,15,4,11,61,1251,
20221015,774,772,남칠곡,북달성,2458,30,39,21,26,108,2682,2368,24,29,17,21,109,2568,
20221015,774,773,남칠곡,북다사,1148,12,15,4,11,61,1251,1318,13,16,3,15,59,1424,
20221015,775,203,동명동호,가산,1826,33,32,17,133,79,2120,2013,32,43,26,278,78,2470,
20221015,775,207,동명동호,남안동,1020,8,6,5,11,43,1093,1073,9,8,2,3,27,1122,
20221015,776,777,연경,파군재,4467,35,25,5,21,248,4801,3590,26,17,5,21,178,3837,
20221015,776,779,연경,율암,5657,57,57,59,215,333,6378,6101,59,71,46,209,364,6850,
20221015,777,776,파군재,연경,3590,26,17,5,21,178,3837,4467,35,25,5,21,248,4801,
20221015,777,779,파군재,율암,2953,14,7,5,7,202,3188,3067,6,8,3,5,195,3284,
20221015,779,776,율암,연경,6101,59,71,46,209,364,6850,5657,57,57,59,215,333,6378,
20221015,779,777,율암,파군재,3067,6,8,3,5,195,3284,2953,14,7,5,7,202,3188,
20221015,876,675,양감,서오산,819,26,10,9,148,50,1062,750,28,17,11,149,45,1000,
20221015,876,677,양감,북평택,1695,38,53,44,61,96,1987,2901,52,46,47,75,145,3266,
20221015,981,982,서영암,강진무위사,2392,24,75,39,31,63,2624,2198,27,81,36,26,60,2428,
20221015,981,987,서영암,남순천,2335,17,73,41,141,76,2683,2254,24,89,45,144,64,2620,
20221015,982,981,강진무위사,서영암,2198,27,81,36,26,60,2428,2392,24,75,39,31,63,2624,
20221015,982,987,강진무위사,남순천,1054,6,41,29,42,37,1209,1169,16,60,27,61,32,1365,
20221015,984,985,보성,벌교,2649,34,57,32,30,61,2863,2117,39,57,19,20,40,2292,
20221015,984,987,보성,남순천,2356,24,53,32,152,72,2689,2634,31,65,42,159,71,3002,
20221015,985,984,벌교,보성,2117,39,57,19,20,40,2292,2649,34,57,32,30,61,2863,
20221015,986,987,고흥,남순천,4332,37,92,83,121,139,4804,5453,52,120,90,131,183,6029,
20221015,987,981,남순천,서영암,2254,24,89,45,144,64,2620,2335,17,73,41,141,76,2683,
20221015,987,982,남순천,강진무위사,1169,16,60,27,61,32,1365,1054,6,41,29,42,37,1209,
20221015,987,984,남순천,보성,2634,31,65,42,159,71,3002,2356,24,53,32,152,72,2689,
20221015,987,986,남순천,고흥,5453,52,120,90,131,183,6029,4332,37,92,83,121,139,4804,
20221016,101,102,서울,동수원,3186,15,176,8,1,156,3542,4004,17,278,20,6,181,4506,
20221016,101,103,서울,수원신갈,13158,237,889,238,22,538,15082,11652,250,857,226,27,530,13542,
20221016,101,105,서울,기흥,5673,26,136,40,8,230,6113,5248,27,155,70,3,202,5705,
20221016,101,106,서울,오산,5102,140,261,67,10,295,5875,4333,123,269,69,10,248,5052,
20221016,101,107,서울,안성,4406,34,254,9,3,220,4926,3149,30,258,13,6,156,3612,
20221016,101,108,서울,천안,5540,25,300,8,3,223,6099,4898,22,318,14,5,189,5446,
20221016,101,111,서울,청주,1072,11,244,5,3,43,1378,718,8,292,0,0,36,1054,
20221016,101,171,서울,마성,2411,8,116,29,1,93,2658,2390,3,121,29,2,107,2652,
20221016,101,172,서울,용인,3056,42,61,15,0,151,3325,3667,48,62,16,3,181,3977,
20221016,101,173,서울,양지,3327,60,70,22,16,100,3595,4531,114,89,41,30,150,4955,
20221016,101,528,서울,기흥동탄,6155,16,409,104,4,293,6981,5812,19,415,113,7,251,6617,
20221016,101,542,서울,서안성,1586,15,60,59,4,76,1800,1912,19,54,82,9,88,2164,
20221016,101,543,서울,남안성,1411,22,38,34,11,49,1565,1195,36,43,45,10,42,1371,
20221016,101,673,서울,북오산,1656,16,89,7,4,105,1877,1381,12,87,6,1,97,1584,
20221016,101,677,서울,북평택,2218,17,252,23,22,129,2661,2835,15,165,19,24,128,3186,
20221016,102,101,동수원,서울,4004,17,278,20,6,181,4506,3186,15,176,8,1,156,3542,
20221016,102,173,동수원,양지,1061,13,16,2,21,50,1163,1438,12,14,3,2,57,1526,
20221016,102,212,동수원,북수원,2468,10,131,2,2,134,2747,2420,7,134,2,2,121,2686,
20221016,102,215,동수원,군포,1021,6,12,1,0,56,1096,1570,5,5,2,0,77,1659,
20221016,102,253,동수원,서서울,5426,26,32,2,8,254,5748,5614,25,35,7,5,304,5990,
20221016,102,254,동수원,군자,4358,16,28,5,8,227,4642,5153,18,39,11,6,234,5461,
20221016,102,255,동수원,서안산,953,22,5,1,2,60,1043,1233,15,10,7,3,60,1328,
20221016,103,101,수원신갈,서울,11652,250,857,226,27,530,13542,13158,237,889,238,22,538,15082,
20221016,103,105,수원신갈,기흥,1533,9,9,3,55,78,1687,2195,10,2,2,64,95,2368,
20221016,103,108,수원신갈,천안,1006,2,25,15,3,37,1088,1114,6,27,15,1,37,1200,
20221016,103,253,수원신갈,서서울,1927,60,34,34,6,94,2155,2536,59,36,27,5,134,2797,
20221016,103,254,수원신갈,군자,1696,41,23,16,25,87,1888,2360,47,23,50,25,133,2638,
20221016,105,101,기흥,서울,5248,27,155,70,3,202,5705,5673,26,136,40,8,230,6113,
20221016,105,103,기흥,수원신갈,2195,10,2,2,64,95,2368,1533,9,9,3,55,78,1687,
20221016,106,101,오산,서울,4333,123,269,69,10,248,5052,5102,140,261,67,10,295,5875,
20221016,107,101,안성,서울,3149,30,258,13,6,156,3612,4406,34,254,9,3,220,4926,
20221016,107,108,안성,천안,1556,2,29,1,2,105,1695,1602,8,23,0,1,99,1733,
20221016,107,742,안성,남사진위,908,14,31,12,5,65,1035,1116,17,30,14,3,62,1242,
20221016,108,101,천안,서울,4898,22,318,14,5,189,5446,5540,25,300,8,3,223,6099,
20221016,108,103,천안,수원신갈,1114,6,27,15,1,37,1200,1006,2,25,15,3,37,1088,
20221016,108,107,천안,안성,1602,8,23,0,1,99,1733,1556,2,29,1,2,105,1695,
20221016,108,229,천안,북천안,1239,24,42,10,7,58,1380,1550,26,46,5,10,79,1716,
20221016,111,101,청주,서울,718,8,292,0,0,36,1054,1072,11,244,5,3,43,1378,
20221016,112,115,남청주,대전,1004,17,49,1,0,65,1136,999,21,40,3,2,54,1119,
20221016,114,153,남대전,서대전,1362,6,9,8,1,56,1442,1137,5,9,19,5,50,1225,
20221016,115,112,대전,남청주,999,21,40,3,2,54,1119,1004,17,49,1,0,65,1136,
20221016,115,116,대전,옥천,1842,12,12,5,79,119,2069,1847,12,14,2,74,134,2083,
20221016,116,115,옥천,대전,1847,12,14,2,74,134,2083,1842,12,12,5,79,119,2069,
20221016,119,153,판암,서대전,1698,11,9,2,0,114,1834,1627,7,12,2,0,79,1727,
20221016,123,127,구미,서대구,1571,10,18,3,0,85,1687,1705,8,25,0,1,85,1824,
20221016,123,129,구미,북대구,1752,3,55,1,0,66,1877,1892,3,51,1,1,80,2028,
20221016,125,127,남구미,서대구,1314,10,37,9,3,86,1459,1620,9,32,5,3,91,1760,
20221016,125,129,남구미,북대구,1301,1,19,0,3,44,1368,1607,4,15,4,2,65,1697,
20221016,126,127,왜관,서대구,1924,31,17,6,12,97,2087,1975,36,19,5,11,95,2141,
20221016,126,129,왜관,북대구,2582,19,10,1,0,110,2722,2762,16,14,2,3,115,2912,
20221016,127,123,서대구,구미,1705,8,25,0,1,85,1824,1571,10,18,3,0,85,1687,
20221016,127,125,서대구,남구미,1620,9,32,5,3,91,1760,1314,10,37,9,3,86,1459,
20221016,127,126,서대구,왜관,1975,36,19,5,11,95,2141,1924,31,17,6,12,97,2087,
20221016,127,131,서대구,경산,1685,32,19,13,7,119,1875,1165,21,8,7,5,69,1275,
20221016,127,135,서대구,경주,1113,4,27,8,1,38,1191,963,5,17,4,0,34,1023,
20221016,127,203,서대구,가산,2330,14,31,6,4,115,2500,1966,12,18,1,2,99,2098,
20221016,127,527,서대구,포항,1929,13,31,3,13,88,2077,1611,6,21,1,7,65,1711,
20221016,129,123,북대구,구미,1892,3,51,1,1,80,2028,1752,3,55,1,0,66,1877,
20221016,129,125,북대구,남구미,1607,4,15,4,2,65,1697,1301,1,19,0,3,44,1368,
20221016,129,126,북대구,왜관,2762,16,14,2,3,115,2912,2582,19,10,1,0,110,2722,
20221016,129,131,북대구,경산,1303,31,11,6,4,67,1422,1950,28,12,14,4,100,2108,
20221016,129,527,북대구,포항,2210,13,12,4,9,94,2342,3661,28,25,7,13,131,3865,
20221016,131,127,경산,서대구,1165,21,8,7,5,69,1275,1685,32,19,13,7,119,1875,
20221016,131,129,경산,북대구,1950,28,12,14,4,100,2108,1303,31,11,6,4,67,1422,
20221016,131,621,경산,동대구,1408,20,15,1,4,69,1517,1370,19,14,3,2,62,1470,
20221016,135,127,경주,서대구,963,5,17,4,0,34,1023,1113,4,27,8,1,38,1191,
20221016,135,140,경주,부산,2532,4,20,11,1,100,2668,2444,6,15,1,1,93,2560,
20221016,135,252,경주,대동,2063,8,65,15,16,95,2262,2093,9,61,12,10,114,2299,
20221016,135,621,경주,동대구,1280,5,40,0,0,44,1369,1230,2,39,1,0,56,1328,
20221016,138,140,양산,부산,3259,40,45,10,8,131,3493,2950,50,36,13,7,140,3196,
20221016,138,252,양산,대동,1306,17,19,7,20,62,1431,1400,44,27,12,17,71,1571,
20221016,139,140,서울산,부산,2804,6,18,0,0,96,2924,1928,6,8,1,1,79,2023,
20221016,139,252,서울산,대동,1556,11,23,2,2,66,1660,1221,8,11,2,5,64,1311,
20221016,139,641,서울산,울산,1515,13,46,2,3,93,1672,1091,4,49,3,3,76,1226,
20221016,140,135,부산,경주,2444,6,15,1,1,93,2560,2532,4,20,11,1,100,2668,
20221016,140,138,부산,양산,2950,50,36,13,7,140,3196,3259,40,45,10,8,131,3493,
20221016,140,139,부산,서울산,1928,6,8,1,1,79,2023,2804,6,18,0,0,96,2924,
20221016,140,250,부산,남양산,6920,29,132,5,8,441,7535,6502,32,116,8,7,417,7082,
20221016,140,286,부산,통도사휴게소,1204,4,3,0,0,35,1246,1184,3,4,0,0,31,1222,
20221016,142,145,군북,산인,4960,18,65,6,8,261,5318,3693,13,32,2,12,211,3963,
20221016,144,145,함안,산인,2635,3,14,3,3,167,2825,2678,4,12,1,7,166,2868,
20221016,145,142,산인,군북,3693,13,32,2,12,211,3963,4960,18,65,6,8,261,5318,
20221016,145,144,산인,함안,2678,4,12,1,7,166,2868,2635,3,14,3,3,167,2825,
20221016,145,291,산인,사천,1575,10,24,7,3,72,1691,2418,16,38,3,2,101,2578,
20221016,145,292,산인,진주,1759,8,124,1,0,92,1984,2489,7,139,1,3,139,2778,
20221016,145,293,산인,문산,1412,6,12,4,3,70,1507,1705,6,11,3,4,72,1801,
20221016,146,244,동창원,서부산,1272,5,17,8,0,82,1384,1416,6,17,4,5,85,1533,
20221016,146,289,동창원,마산,1800,14,6,1,10,132,1963,2107,16,13,1,3,156,2296,
20221016,148,150,서김해,북부산,5311,43,51,10,20,327,5762,5038,33,50,11,7,317,5456,
20221016,148,289,서김해,마산,1219,8,42,2,2,67,1340,1707,4,48,3,1,89,1852,
20221016,149,150,동김해,북부산,8919,87,109,13,17,599,9744,7510,67,106,5,6,514,8208,
20221016,150,148,북부산,서김해,5038,33,50,11,7,317,5456,5311,43,51,10,20,327,5762,
20221016,150,149,북부산,동김해,7510,67,106,5,6,514,8208,8919,87,109,13,17,599,9744,
20221016,150,245,북부산,장유,3608,11,63,1,8,213,3904,2998,6,61,1,9,147,3222,
20221016,150,289,북부산,마산,2773,7,82,3,6,115,2986,5094,21,138,1,9,185,5448,
20221016,153,114,서대전,남대전,1137,5,9,19,5,50,1225,1362,6,9,8,1,56,1442,
20221016,153,119,서대전,판암,1627,7,12,2,0,79,1727,1698,11,9,2,0,114,1834,
20221016,153,154,서대전,안영,991,11,26,3,6,49,1086,967,14,21,6,1,38,1047,
20221016,154,153,안영,서대전,967,14,21,6,1,38,1047,991,11,26,3,6,49,1086,
20221016,159,167,서전주,광주,1816,11,40,13,7,46,1933,1915,9,15,8,4,61,2012,
20221016,166,167,장성,광주,3449,27,41,8,9,121,3655,3825,35,42,7,8,121,4038,
20221016,167,159,광주,서전주,1915,9,15,8,4,61,2012,1816,11,40,13,7,46,1933,
20221016,167,166,광주,장성,3825,35,42,7,8,121,4038,3449,27,41,8,9,121,3655,
20221016,167,567,광주,남고창,1468,7,48,6,4,56,1589,1727,6,28,5,3,65,1834,
20221016,171,101,마성,서울,2390,3,121,29,2,107,2652,2411,8,116,29,1,93,2658,
20221016,172,101,용인,서울,3667,48,62,16,3,181,3977,3056,42,61,15,0,151,3325,
20221016,172,173,용인,양지,1031,63,29,13,5,65,1206,1050,33,25,12,3,68,1191,
20221016,172,253,용인,서서울,1105,11,1,7,2,51,1177,1171,19,3,10,0,56,1259,
20221016,173,101,양지,서울,4531,114,89,41,30,150,4955,3327,60,70,22,16,100,3595,
20221016,173,102,양지,동수원,1438,12,14,3,2,57,1526,1061,13,16,2,21,50,1163,
20221016,173,172,양지,용인,1050,33,25,12,3,68,1191,1031,63,29,13,5,65,1206,
20221016,173,212,양지,북수원,1271,26,9,5,1,42,1354,949,35,13,8,5,30,1040,
20221016,173,253,양지,서서울,1434,24,15,22,8,44,1547,1041,45,13,17,9,58,1183,
20221016,174,179,춘천,홍천,3713,26,52,6,4,236,4037,2566,20,38,5,3,201,2833,
20221016,174,218,춘천,남원주,1354,14,40,4,1,76,1489,1331,2,44,5,4,63,1449,
20221016,174,554,춘천,동홍천,1037,8,20,4,1,71,1141,1255,8,18,1,0,71,1353,
20221016,176,190,이천,동서울,1454,26,39,12,4,78,1613,1661,19,58,50,9,80,1877,
20221016,177,190,여주,동서울,1168,8,19,17,1,40,1253,1169,3,26,13,0,31,1242,
20221016,179,174,홍천,춘천,2566,20,38,5,3,201,2833,3713,26,52,6,4,236,4037,
20221016,184,189,대관령,강릉,1373,18,46,3,1,70,1511,1347,20,50,4,2,67,1490,
20221016,189,184,강릉,대관령,1347,20,50,4,2,67,1490,1373,18,46,3,1,70,1511,
20221016,190,176,동서울,이천,1661,19,58,50,9,80,1877,1454,26,39,12,4,78,1613,
20221016,190,177,동서울,여주,1169,3,26,13,0,31,1242,1168,8,19,17,1,40,1253,
20221016,190,191,동서울,경기광주,9153,186,240,52,21,525,10177,7095,127,218,33,30,401,7904,
20221016,190,192,동서울,곤지암,4093,142,75,60,23,194,4587,3678,84,57,41,22,164,4046,
20221016,190,193,동서울,일죽,2929,26,71,40,11,112,3189,3141,25,54,54,18,92,3384,
20221016,190,194,동서울,서이천,3817,155,106,78,18,200,4374,2862,53,92,56,17,150,3230,
20221016,190,198,동서울,서청주,1518,3,31,6,1,56,1615,1211,6,17,7,0,46,1287,
20221016,190,199,동서울,오창,1304,3,4,4,4,49,1368,1191,5,2,4,6,39,1247,
20221016,190,560,동서울,감곡,1065,4,14,5,4,39,1131,1377,5,8,12,14,41,1457,
20221016,190,705,동서울,남이천,1417,27,26,23,2,42,1537,1580,27,12,12,4,47,1682,
20221016,191,190,경기광주,동서울,7095,127,218,33,30,401,7904,9153,186,240,52,21,525,10177,
20221016,192,190,곤지암,동서울,3678,84,57,41,22,164,4046,4093,142,75,60,23,194,4587,
20221016,192,194,곤지암,서이천,1222,73,37,22,10,71,1435,1171,38,27,27,5,72,1340,
20221016,193,190,일죽,동서울,3141,25,54,54,18,92,3384,2929,26,71,40,11,112,3189,
20221016,194,190,서이천,동서울,2862,53,92,56,17,150,3230,3817,155,106,78,18,200,4374,
20221016,194,192,서이천,곤지암,1171,38,27,27,5,72,1340,1222,73,37,22,10,71,1435,
20221016,198,190,서청주,동서울,1211,6,17,7,0,46,1287,1518,3,31,6,1,56,1615,
20221016,199,190,오창,동서울,1191,5,2,4,6,39,1247,1304,3,4,4,4,49,1368,
20221016,203,127,가산,서대구,1966,12,18,1,2,99,2098,2330,14,31,6,4,115,2500,
20221016,203,775,가산,동명동호,1622,7,7,6,3,69,1714,1797,10,13,9,4,84,1917,
20221016,212,102,북수원,동수원,2420,7,134,2,2,121,2686,2468,10,131,2,2,134,2747,
20221016,212,173,북수원,양지,949,35,13,8,5,30,1040,1271,26,9,5,1,42,1354,
20221016,212,254,북수원,군자,1716,8,17,4,5,106,1856,1229,12,12,5,8,70,1336,
20221016,213,253,부곡,서서울,1103,48,18,14,18,62,1263,950,49,18,23,8,62,1110,
20221016,215,102,군포,동수원,1570,5,5,2,0,77,1659,1021,6,12,1,0,56,1096,
20221016,215,253,군포,서서울,2669,17,29,9,14,149,2887,2732,40,57,30,26,182,3067,
20221016,215,254,군포,군자,2186,10,24,5,18,132,2375,2676,29,20,28,16,163,2932,
20221016,218,174,남원주,춘천,1331,2,44,5,4,63,1449,1354,14,40,4,1,76,1489,
20221016,218,240,남원주,제천,1779,13,28,2,8,103,1933,1822,9,35,5,4,96,1971,
20221016,229,108,북천안,천안,1550,26,46,5,10,79,1716,1239,24,42,10,7,58,1380,
20221016,230,527,팔공산,포항,2453,11,7,1,0,96,2568,2345,12,14,0,3,88,2462,
20221016,231,519,화원옥포,남대구,4319,29,45,6,1,294,4694,4373,27,27,2,2,298,4729,
20221016,232,519,달성,남대구,1443,24,31,4,2,105,1609,1430,21,20,7,2,106,1586,
20221016,233,519,현풍,남대구,3391,30,43,13,11,199,3687,3017,24,51,27,10,194,3323,
20221016,239,519,칠원,남대구,2202,19,72,9,1,88,2391,2227,19,85,8,4,97,2440,
20221016,240,218,제천,남원주,1822,9,35,5,4,96,1971,1779,13,28,2,8,103,1933,
20221016,241,519,동고령,남대구,3563,17,57,8,3,153,3801,2535,13,46,1,1,114,2710,
20221016,242,519,고령,남대구,3230,15,41,8,8,142,3444,3257,11,30,2,11,143,3454,
20221016,243,519,해인사,남대구,1207,1,4,0,0,53,1265,1008,2,4,0,0,48,1062,
20221016,244,146,서부산,동창원,1416,6,17,4,5,85,1533,1272,5,17,8,0,82,1384,
20221016,244,245,서부산,장유,13162,63,258,20,16,864,14383,12349,62,253,27,18,792,13501,
20221016,244,289,서부산,마산,3352,16,240,7,7,173,3795,5137,25,304,11,8,209,5694,
20221016,245,150,장유,북부산,2998,6,61,1,9,147,3222,3608,11,63,1,8,213,3904,
20221016,245,244,장유,서부산,12349,62,253,27,18,792,13501,13162,63,258,20,16,864,14383,
20221016,245,289,장유,마산,1145,7,17,1,3,73,1246,1877,6,26,4,0,97,2010,
20221016,248,261,순창,동광주,2015,5,14,0,0,80,2114,1941,8,17,0,2,62,2030,
20221016,249,261,담양,동광주,3108,13,95,9,2,92,3319,2632,12,100,1,3,65,2813,
20221016,250,140,남양산,부산,6502,32,116,8,7,417,7082,6920,29,132,5,8,441,7535,
20221016,250,252,남양산,대동,2327,20,17,13,19,155,2551,3106,21,19,14,10,213,3383,
20221016,251,252,물금,대동,2297,81,22,23,99,156,2678,3238,99,20,21,50,196,3624,
20221016,252,135,대동,경주,2093,9,61,12,10,114,2299,2063,8,65,15,16,95,2262,
20221016,252,138,대동,양산,1400,44,27,12,17,71,1571,1306,17,19,7,20,62,1431,
20221016,252,139,대동,서울산,1221,8,11,2,5,64,1311,1556,11,23,2,2,66,1660,
20221016,252,250,대동,남양산,3106,21,19,14,10,213,3383,2327,20,17,13,19,155,2551,
20221016,252,251,대동,물금,3238,99,20,21,50,196,3624,2297,81,22,23,99,156,2678,
20221016,252,641,대동,울산,2172,14,41,3,2,128,2360,1672,11,34,2,12,100,1831,
20221016,252,752,대동,기장철마,1647,3,15,5,13,117,1800,1518,13,16,6,18,103,1674,
20221016,252,755,대동,광재,1443,7,14,6,3,81,1554,1306,4,12,6,7,69,1404,
20221016,253,102,서서울,동수원,5614,25,35,7,5,304,5990,5426,26,32,2,8,254,5748,
20221016,253,103,서서울,수원신갈,2536,59,36,27,5,134,2797,1927,60,34,34,6,94,2155,
20221016,253,172,서서울,용인,1171,19,3,10,0,56,1259,1105,11,1,7,2,51,1177,
20221016,253,173,서서울,양지,1041,45,13,17,9,58,1183,1434,24,15,22,8,44,1547,
20221016,253,213,서서울,부곡,950,49,18,23,8,62,1110,1103,48,18,14,18,62,1263,
20221016,253,215,서서울,군포,2732,40,57,30,26,182,3067,2669,17,29,9,14,149,2887,
20221016,253,255,서서울,서안산,8699,108,73,61,144,477,9562,8491,114,67,57,136,494,9359,
20221016,253,256,서서울,안산,7047,58,42,10,8,460,7625,4430,29,29,6,6,296,4796,
20221016,253,257,서서울,홍성,1270,3,19,3,1,58,1354,2182,3,10,3,0,88,2286,
20221016,253,259,서서울,대천,1132,4,23,1,1,35,1196,1859,9,4,6,0,64,1942,
20221016,253,281,서서울,매송,2989,16,11,5,27,184,3232,2361,12,7,2,33,163,2578,
20221016,253,282,서서울,비봉,4225,54,35,15,28,232,4589,4283,47,36,19,55,222,4662,
20221016,253,283,서서울,발안,3567,30,22,13,235,233,4100,2427,30,24,15,199,143,2838,
20221016,253,285,서서울,서평택,2244,14,29,42,82,139,2550,1884,17,30,48,93,82,2154,
20221016,253,287,서서울,송악,3170,16,43,9,49,141,3428,4645,30,39,20,69,178,4981,
20221016,253,288,서서울,당진,2376,7,39,9,3,113,2547,2366,5,31,12,3,123,2540,
20221016,253,298,서서울,서산,3645,9,49,11,3,160,3877,4820,17,35,44,7,189,5112,
20221016,253,520,서서울,평택,3519,21,32,23,29,160,3784,3404,22,22,32,23,156,3659,
20221016,253,741,서서울,평택고덕,1902,9,8,4,4,126,2053,977,11,7,6,1,59,1061,
20221016,254,102,군자,동수원,5153,18,39,11,6,234,5461,4358,16,28,5,8,227,4642,
20221016,254,103,군자,수원신갈,2360,47,23,50,25,133,2638,1696,41,23,16,25,87,1888,
20221016,254,212,군자,북수원,1229,12,12,5,8,70,1336,1716,8,17,4,5,106,1856,
20221016,254,215,군자,군포,2676,29,20,28,16,163,2932,2186,10,24,5,18,132,2375,
20221016,254,255,군자,서안산,6866,81,39,16,23,426,7451,7645,61,31,37,29,461,8264,
20221016,254,256,군자,안산,4499,27,93,17,20,298,4954,4445,36,87,14,17,299,4898,
20221016,255,102,서안산,동수원,1233,15,10,7,3,60,1328,953,22,5,1,2,60,1043,
20221016,255,253,서안산,서서울,8491,114,67,57,136,494,9359,8699,108,73,61,144,477,9562,
20221016,255,254,서안산,군자,7645,61,31,37,29,461,8264,6866,81,39,16,23,426,7451,
20221016,256,253,안산,서서울,4430,29,29,6,6,296,4796,7047,58,42,10,8,460,7625,
20221016,256,254,안산,군자,4445,36,87,14,17,299,4898,4499,27,93,17,20,298,4954,
20221016,257,253,홍성,서서울,2182,3,10,3,0,88,2286,1270,3,19,3,1,58,1354,
20221016,259,253,대천,서서울,1859,9,4,6,0,64,1942,1132,4,23,1,1,35,1196,
20221016,261,248,동광주,순창,1941,8,17,0,2,62,2030,2015,5,14,0,0,80,2114,
20221016,261,249,동광주,담양,2632,12,100,1,3,65,2813,3108,13,95,9,2,92,3319,
20221016,261,262,동광주,창평,1647,20,11,7,3,48,1736,1836,7,11,7,1,53,1915,
20221016,261,263,동광주,옥과,2464,8,73,3,102,93,2743,2585,10,73,5,88,102,2863,
20221016,261,265,동광주,곡성,1630,12,32,5,3,56,1738,1861,7,28,7,1,58,1962,
20221016,261,270,동광주,서순천,1034,7,50,0,3,34,1128,911,6,48,2,2,43,1012,
20221016,261,271,동광주,순천,3957,21,57,6,17,90,4148,3917,26,59,4,12,120,4138,
20221016,262,261,창평,동광주,1836,7,11,7,1,53,1915,1647,20,11,7,3,48,1736,
20221016,263,261,옥과,동광주,2585,10,73,5,88,102,2863,2464,8,73,3,102,93,2743,
20221016,265,261,곡성,동광주,1861,7,28,7,1,58,1962,1630,12,32,5,3,56,1738,
20221016,270,261,서순천,동광주,911,6,48,2,2,43,1012,1034,7,50,0,3,34,1128,
20221016,271,261,순천,동광주,3917,26,59,4,12,120,4138,3957,21,57,6,17,90,4148,
20221016,280,519,거창,남대구,1764,1,32,3,0,65,1865,1583,8,38,1,0,56,1686,
20221016,281,253,매송,서서울,2361,12,7,2,33,163,2578,2989,16,11,5,27,184,3232,
20221016,282,253,비봉,서서울,4283,47,36,19,55,222,4662,4225,54,35,15,28,232,4589,
20221016,283,253,발안,서서울,2427,30,24,15,199,143,2838,3567,30,22,13,235,233,4100,
20221016,285,253,서평택,서서울,1884,17,30,48,93,82,2154,2244,14,29,42,82,139,2550,
20221016,286,140,통도사휴게소,부산,1184,3,4,0,0,31,1222,1204,4,3,0,0,35,1246,
20221016,287,253,송악,서서울,4645,30,39,20,69,178,4981,3170,16,43,9,49,141,3428,
20221016,287,520,송악,평택,1053,9,13,3,45,41,1164,927,2,23,3,33,45,1033,
20221016,288,253,당진,서서울,2366,5,31,12,3,123,2540,2376,7,39,9,3,113,2547,
20221016,289,146,마산,동창원,2107,16,13,1,3,156,2296,1800,14,6,1,10,132,1963,
20221016,289,148,마산,서김해,1707,4,48,3,1,89,1852,1219,8,42,2,2,67,1340,
20221016,289,150,마산,북부산,5094,21,138,1,9,185,5448,2773,7,82,3,6,115,2986,
20221016,289,244,마산,서부산,5137,25,304,11,8,209,5694,3352,16,240,7,7,173,3795,
20221016,289,245,마산,장유,1877,6,26,4,0,97,2010,1145,7,17,1,3,73,1246,
20221016,291,145,사천,산인,2418,16,38,3,2,101,2578,1575,10,24,7,3,72,1691,
20221016,291,292,사천,진주,1681,6,18,5,6,132,1848,2092,25,17,8,4,138,2284,
20221016,292,145,진주,산인,2489,7,139,1,3,139,2778,1759,8,124,1,0,92,1984,
20221016,292,291,진주,사천,2092,25,17,8,4,138,2284,1681,6,18,5,6,132,1848,
20221016,292,516,진주,통영,1123,4,16,0,0,88,1231,1037,10,17,0,0,73,1137,
20221016,293,145,문산,산인,1705,6,11,3,4,72,1801,1412,6,12,4,3,70,1507,
20221016,298,253,서산,서서울,4820,17,35,44,7,189,5112,3645,9,49,11,3,160,3877,
20221016,298,520,서산,평택,1073,3,46,5,2,33,1162,1087,4,87,4,4,38,1224,
20221016,508,509,무안,목포,1047,8,11,5,3,38,1112,1288,11,13,7,6,45,1370,
20221016,508,553,무안,동광산,1427,7,20,6,6,36,1502,1525,6,19,5,5,58,1618,
20221016,509,508,목포,무안,1288,11,13,7,6,45,1370,1047,8,11,5,3,38,1112,
20221016,509,553,목포,동광산,9212,48,133,58,33,244,9728,8781,35,113,43,28,261,9261,
20221016,513,515,고성,북통영,2004,13,59,2,1,104,2183,2872,14,57,5,1,128,3077,
20221016,513,516,고성,통영,4591,22,68,7,7,288,4983,5344,32,56,7,6,279,5724,
20221016,514,516,동고성,통영,1252,11,13,9,0,114,1399,1292,6,16,4,4,125,1447,
20221016,515,513,북통영,고성,2872,14,57,5,1,128,3077,2004,13,59,2,1,104,2183,
20221016,516,292,통영,진주,1037,10,17,0,0,73,1137,1123,4,16,0,0,88,1231,
20221016,516,513,통영,고성,5344,32,56,7,6,279,5724,4591,22,68,7,7,288,4983,
20221016,516,514,통영,동고성,1292,6,16,4,4,125,1447,1252,11,13,9,0,114,1399,
20221016,519,231,남대구,화원옥포,4373,27,27,2,2,298,4729,4319,29,45,6,1,294,4694,
20221016,519,232,남대구,달성,1430,21,20,7,2,106,1586,1443,24,31,4,2,105,1609,
20221016,519,233,남대구,현풍,3017,24,51,27,10,194,3323,3391,30,43,13,11,199,3687,
20221016,519,239,남대구,칠원,2227,19,85,8,4,97,2440,2202,19,72,9,1,88,2391,
20221016,519,241,남대구,동고령,2535,13,46,1,1,114,2710,3563,17,57,8,3,153,3801,
20221016,519,242,남대구,고령,3257,11,30,2,11,143,3454,3230,15,41,8,8,142,3444,
20221016,519,243,남대구,해인사,1008,2,4,0,0,48,1062,1207,1,4,0,0,53,1265,
20221016,519,280,남대구,거창,1583,8,38,1,0,56,1686,1764,1,32,3,0,65,1865,
20221016,519,730,남대구,유천,1676,14,12,1,0,89,1792,1875,13,2,0,0,103,1993,
20221016,519,731,남대구,북현풍,1494,3,16,0,0,62,1575,1379,5,7,0,0,59,1450,
20221016,520,253,평택,서서울,3404,22,22,32,23,156,3659,3519,21,32,23,29,160,3784,
20221016,520,287,평택,송악,927,2,23,3,33,45,1033,1053,9,13,3,45,41,1164,
20221016,520,298,평택,서산,1087,4,87,4,4,38,1224,1073,3,46,5,2,33,1162,
20221016,524,527,청통와촌,포항,971,22,5,0,4,31,1033,1146,21,9,2,2,48,1228,
20221016,526,527,서포항,포항,1259,6,13,1,1,65,1345,1201,7,15,3,1,56,1283,
20221016,527,127,포항,서대구,1611,6,21,1,7,65,1711,1929,13,31,3,13,88,2077,
20221016,527,129,포항,북대구,3661,28,25,7,13,131,3865,2210,13,12,4,9,94,2342,
20221016,527,230,포항,팔공산,2345,12,14,0,3,88,2462,2453,11,7,1,0,96,2568,
20221016,527,524,포항,청통와촌,1146,21,9,2,2,48,1228,971,22,5,0,4,31,1033,
20221016,527,526,포항,서포항,1201,7,15,3,1,56,1283,1259,6,13,1,1,65,1345,
20221016,528,101,기흥동탄,서울,5812,19,415,113,7,251,6617,6155,16,409,104,4,293,6981,
20221016,542,101,서안성,서울,1912,19,54,82,9,88,2164,1586,15,60,59,4,76,1800,
20221016,543,101,남안성,서울,1195,36,43,45,10,42,1371,1411,22,38,34,11,49,1565,
20221016,548,553,북무안,동광산,2692,12,15,19,6,74,2818,2399,13,23,5,6,56,2502,
20221016,549,553,동함평,동광산,3382,15,31,6,10,114,3558,3138,18,31,8,14,110,3319,
20221016,551,553,나주,동광산,1098,4,5,8,6,28,1149,1001,6,3,3,3,32,1048,
20221016,552,553,서광산,동광산,3051,32,84,73,37,89,3366,3737,50,108,62,33,100,4090,
20221016,553,508,동광산,무안,1525,6,19,5,5,58,1618,1427,7,20,6,6,36,1502,
20221016,553,509,동광산,목포,8781,35,113,43,28,261,9261,9212,48,133,58,33,244,9728,
20221016,553,548,동광산,북무안,2399,13,23,5,6,56,2502,2692,12,15,19,6,74,2818,
20221016,553,549,동광산,동함평,3138,18,31,8,14,110,3319,3382,15,31,6,10,114,3558,
20221016,553,551,동광산,나주,1001,6,3,3,3,32,1048,1098,4,5,8,6,28,1149,
20221016,553,552,동광산,서광산,3737,50,108,62,33,100,4090,3051,32,84,73,37,89,3366,
20221016,554,174,동홍천,춘천,1255,8,18,1,0,71,1353,1037,8,20,4,1,71,1141,
20221016,556,557,동순천,황전,1155,7,10,2,4,35,1213,1065,7,11,1,1,35,1120,
20221016,557,556,황전,동순천,1065,7,11,1,1,35,1120,1155,7,10,2,4,35,1213,
20221016,560,190,감곡,동서울,1377,5,8,12,14,41,1457,1065,4,14,5,4,39,1131,
20221016,567,167,남고창,광주,1727,6,28,5,3,65,1834,1468,7,48,6,4,56,1589,
20221016,583,704,동해,근덕,926,7,31,3,23,56,1046,1005,10,27,3,10,66,1121,
20221016,587,589,오수,상관,1012,3,20,9,5,34,1083,1012,6,31,6,9,30,1094,
20221016,589,587,상관,오수,1012,6,31,6,9,30,1094,1012,3,20,9,5,34,1083,
20221016,621,131,동대구,경산,1370,19,14,3,2,62,1470,1408,20,15,1,4,69,1517,
20221016,621,135,동대구,경주,1230,2,39,1,0,56,1328,1280,5,40,0,0,44,1369,
20221016,623,624,수성,청도,1016,5,4,3,0,42,1070,1401,6,5,1,0,46,1459,
20221016,624,623,청도,수성,1401,6,5,1,0,46,1459,1016,5,4,3,0,42,1070,
20221016,624,626,청도,남밀양,1067,4,6,11,11,62,1161,1013,7,10,7,8,44,1089,
20221016,625,626,밀양,남밀양,2295,20,13,14,5,85,2432,1842,12,9,10,8,79,1960,
20221016,626,624,남밀양,청도,1013,7,10,7,8,44,1089,1067,4,6,11,11,62,1161,
20221016,626,625,남밀양,밀양,1842,12,9,10,8,79,1960,2295,20,13,14,5,85,2432,
20221016,626,627,남밀양,삼랑진,967,5,6,2,1,69,1050,931,11,7,2,3,79,1033,
20221016,627,626,삼랑진,남밀양,931,11,7,2,3,79,1033,967,5,6,2,1,69,1050,
20221016,641,139,울산,서울산,1091,4,49,3,3,76,1226,1515,13,46,2,3,93,1672,
20221016,641,252,울산,대동,1672,11,34,2,12,100,1831,2172,14,41,3,2,128,2360,
20221016,641,648,울산,해운대,1142,2,2,0,0,70,1216,1271,2,3,0,1,72,1349,
20221016,641,706,울산,남경주,1228,3,4,2,2,68,1307,1563,4,8,3,3,77,1658,
20221016,641,707,울산,남포항,1615,5,28,4,35,91,1778,2030,4,33,11,26,112,2216,
20221016,643,648,청량,해운대,3537,7,14,1,0,173,3732,4143,13,49,3,16,204,4428,
20221016,645,648,장안,해운대,1460,0,5,0,0,72,1537,2862,4,9,6,2,141,3024,
20221016,646,648,기장일광,해운대,4863,7,7,2,5,236,5120,5387,11,11,7,31,245,5692,
20221016,648,641,해운대,울산,1271,2,3,0,1,72,1349,1142,2,2,0,0,70,1216,
20221016,648,643,해운대,청량,4143,13,49,3,16,204,4428,3537,7,14,1,0,173,3732,
20221016,648,645,해운대,장안,2862,4,9,6,2,141,3024,1460,0,5,0,0,72,1537,
20221016,648,646,해운대,기장일광,5387,11,11,7,31,245,5692,4863,7,7,2,5,236,5120,
20221016,648,707,해운대,남포항,1387,3,25,4,13,59,1491,1167,3,8,2,5,45,1230,
20221016,651,652,남양주,화도,11885,120,268,163,35,685,13156,14885,112,284,203,33,759,16276,
20221016,651,653,남양주,서종,1806,5,5,3,3,81,1903,4159,3,7,2,0,134,4305,
20221016,651,654,남양주,설악,4354,17,70,7,2,155,4605,4357,21,65,5,3,153,4604,
20221016,651,655,남양주,강촌,3054,18,108,11,8,108,3307,2840,9,93,20,8,88,3058,
20221016,651,656,남양주,남춘천,3257,10,30,7,7,91,3402,1902,6,14,8,3,40,1973,
20221016,652,651,화도,남양주,14885,112,284,203,33,759,16276,11885,120,268,163,35,685,13156,
20221016,652,653,화도,서종,1148,10,7,6,1,57,1229,2410,15,10,11,2,96,2544,
20221016,652,654,화도,설악,1000,3,8,3,2,64,1080,1269,8,14,7,3,59,1360,
20221016,653,651,서종,남양주,4159,3,7,2,0,134,4305,1806,5,5,3,3,81,1903,
20221016,653,652,서종,화도,2410,15,10,11,2,96,2544,1148,10,7,6,1,57,1229,
20221016,654,651,설악,남양주,4357,21,65,5,3,153,4604,4354,17,70,7,2,155,4605,
20221016,654,652,설악,화도,1269,8,14,7,3,59,1360,1000,3,8,3,2,64,1080,
20221016,655,651,강촌,남양주,2840,9,93,20,8,88,3058,3054,18,108,11,8,108,3307,
20221016,656,651,남춘천,남양주,1902,6,14,8,3,40,1973,3257,10,30,7,7,91,3402,
20221016,671,672,봉담,정남,1489,21,13,10,14,83,1630,1571,26,17,9,14,92,1729,
20221016,671,673,봉담,북오산,1508,9,11,13,5,101,1647,1763,23,21,5,6,105,1923,
20221016,671,677,봉담,북평택,8084,34,57,17,18,400,8610,9712,45,44,33,8,410,10252,
20221016,672,671,정남,봉담,1571,26,17,9,14,92,1729,1489,21,13,10,14,83,1630,
20221016,673,101,북오산,서울,1381,12,87,6,1,97,1584,1656,16,89,7,4,105,1877,
20221016,673,671,북오산,봉담,1763,23,21,5,6,105,1923,1508,9,11,13,5,101,1647,
20221016,673,677,북오산,북평택,1850,5,11,6,5,106,1983,1859,13,7,5,10,102,1996,
20221016,675,676,서오산,향남,1493,12,10,4,22,79,1620,1216,18,13,4,22,66,1339,
20221016,675,677,서오산,북평택,9902,60,128,34,52,510,10686,13485,63,121,50,36,587,14342,
20221016,676,675,향남,서오산,1216,18,13,4,22,66,1339,1493,12,10,4,22,79,1620,
20221016,676,677,향남,북평택,1111,18,20,37,15,71,1272,1524,22,22,43,15,69,1695,
20221016,677,101,북평택,서울,2835,15,165,19,24,128,3186,2218,17,252,23,22,129,2661,
20221016,677,671,북평택,봉담,9712,45,44,33,8,410,10252,8084,34,57,17,18,400,8610,
20221016,677,673,북평택,북오산,1859,13,7,5,10,102,1996,1850,5,11,6,5,106,1983,
20221016,677,675,북평택,서오산,13485,63,121,50,36,587,14342,9902,60,128,34,52,510,10686,
20221016,677,676,북평택,향남,1524,22,22,43,15,69,1695,1111,18,20,37,15,71,1272,
20221016,677,876,북평택,양감,2505,19,20,13,9,96,2662,1018,10,13,8,8,64,1121,
20221016,682,685,조암,서시흥,1210,14,16,15,24,56,1335,1583,14,21,23,47,85,1773,
20221016,683,684,송산마도,남안산,1546,16,19,18,33,107,1739,1514,24,13,15,18,84,1668,
20221016,683,685,송산마도,서시흥,4419,28,41,30,277,220,5015,4418,30,37,29,265,230,5009,
20221016,684,683,남안산,송산마도,1514,24,13,15,18,84,1668,1546,16,19,18,33,107,1739,
20221016,684,685,남안산,서시흥,2020,74,65,163,138,143,2603,3572,99,81,144,139,232,4267,
20221016,685,682,서시흥,조암,1583,14,21,23,47,85,1773,1210,14,16,15,24,56,1335,
20221016,685,683,서시흥,송산마도,4418,30,37,29,265,230,5009,4419,28,41,30,277,220,5015,
20221016,685,684,서시흥,남안산,3572,99,81,144,139,232,4267,2020,74,65,163,138,143,2603,
20221016,704,583,근덕,동해,1005,10,27,3,10,66,1121,926,7,31,3,23,56,1046,
20221016,705,190,남이천,동서울,1580,27,12,12,4,47,1682,1417,27,26,23,2,42,1537,
20221016,706,641,남경주,울산,1563,4,8,3,3,77,1658,1228,3,4,2,2,68,1307,
20221016,706,707,남경주,남포항,1550,7,34,1,24,87,1703,1799,11,38,4,27,92,1971,
20221016,707,641,남포항,울산,2030,4,33,11,26,112,2216,1615,5,28,4,35,91,1778,
20221016,707,648,남포항,해운대,1167,3,8,2,5,45,1230,1387,3,25,4,13,59,1491,
20221016,707,706,남포항,남경주,1799,11,38,4,27,92,1971,1550,7,34,1,24,87,1703,
20221016,707,708,남포항,동경주,1896,6,9,4,4,97,2016,2028,11,20,6,5,96,2166,
20221016,708,707,동경주,남포항,2028,11,20,6,5,96,2166,1896,6,9,4,4,97,2016,
20221016,715,749,동안동,영덕,1109,3,21,1,0,46,1180,1311,8,18,1,1,55,1394,
20221016,730,519,유천,남대구,1875,13,2,0,0,103,1993,1676,14,12,1,0,89,1792,
20221016,731,519,북현풍,남대구,1379,5,7,0,0,59,1450,1494,3,16,0,0,62,1575,
20221016,741,253,평택고덕,서서울,977,11,7,6,1,59,1061,1902,9,8,4,4,126,2053,
20221016,742,107,남사진위,안성,1116,17,30,14,3,62,1242,908,14,31,12,5,65,1035,
20221016,749,715,영덕,동안동,1311,8,18,1,1,55,1394,1109,3,21,1,0,46,1180,
20221016,752,252,기장철마,대동,1518,13,16,6,18,103,1674,1647,3,15,5,13,117,1800,
20221016,755,252,광재,대동,1306,4,12,6,7,69,1404,1443,7,14,6,3,81,1554,
20221016,772,774,북달성,남칠곡,1953,14,13,8,6,86,2080,2429,15,14,5,5,104,2572,
20221016,773,774,북다사,남칠곡,985,1,2,2,1,46,1037,1093,1,5,2,0,43,1144,
20221016,774,772,남칠곡,북달성,2429,15,14,5,5,104,2572,1953,14,13,8,6,86,2080,
20221016,774,773,남칠곡,북다사,1093,1,5,2,0,43,1144,985,1,2,2,1,46,1037,
20221016,775,203,동명동호,가산,1797,10,13,9,4,84,1917,1622,7,7,6,3,69,1714,
20221016,776,777,연경,파군재,3776,15,15,2,2,175,3985,3449,13,9,2,5,158,3636,
20221016,776,779,연경,율암,4483,11,26,18,18,248,4804,4823,22,36,34,25,256,5196,
20221016,777,776,파군재,연경,3449,13,9,2,5,158,3636,3776,15,15,2,2,175,3985,
20221016,777,779,파군재,율암,2880,4,4,0,2,164,3054,2805,2,7,3,2,157,2976,
20221016,779,776,율암,연경,4823,22,36,34,25,256,5196,4483,11,26,18,18,248,4804,
20221016,779,777,율암,파군재,2805,2,7,3,2,157,2976,2880,4,4,0,2,164,3054,
20221016,876,677,양감,북평택,1018,10,13,8,8,64,1121,2505,19,20,13,9,96,2662,
20221016,981,982,서영암,강진무위사,1874,12,54,24,18,58,2040,2396,18,66,18,22,58,2578,
20221016,981,987,서영암,남순천,2187,13,68,31,45,69,2413,2433,16,62,25,42,101,2679,
20221016,982,981,강진무위사,서영암,2396,18,66,18,22,58,2578,1874,12,54,24,18,58,2040,
20221016,982,987,강진무위사,남순천,1123,17,46,39,20,35,1280,1042,10,38,13,11,25,1139,
20221016,984,985,보성,벌교,1962,15,33,12,26,59,2107,2604,20,31,16,25,76,2772,
20221016,984,987,보성,남순천,2439,16,48,35,38,80,2656,2333,22,44,18,36,61,2514,
20221016,985,984,벌교,보성,2604,20,31,16,25,76,2772,1962,15,33,12,26,59,2107,
20221016,986,987,고흥,남순천,5168,20,134,90,50,149,5611,4067,24,100,31,27,128,4377,
20221016,987,981,남순천,서영암,2433,16,62,25,42,101,2679,2187,13,68,31,45,69,2413,
20221016,987,982,남순천,강진무위사,1042,10,38,13,11,25,1139,1123,17,46,39,20,35,1280,
20221016,987,984,남순천,보성,2333,22,44,18,36,61,2514,2439,16,48,35,38,80,2656,
20221016,987,986,남순천,고흥,4067,24,100,31,27,128,4377,5168,20,134,90,50,149,5611,
20221017,101,102,서울,동수원,3617,49,260,14,10,221,4171,4972,58,382,21,17,282,5732,
20221017,101,103,서울,수원신갈,16029,869,1943,491,136,817,20285,14061,654,1615,382,108,661,17481,
20221017,101,105,서울,기흥,6812,87,398,64,19,320,7700,5995,87,357,98,28,298,6863,
20221017,101,106,서울,오산,4795,341,409,164,100,303,6112,4242,417,439,165,103,267,5633,
20221017,101,107,서울,안성,3571,81,280,40,14,194,4180,2936,87,271,46,19,152,3511,
20221017,101,108,서울,천안,4303,49,348,32,11,200,4943,3822,41,345,34,19,186,4447,
20221017,101,111,서울,청주,1078,16,185,17,27,26,1349,818,14,221,25,27,39,1144,
20221017,101,171,서울,마성,2316,31,198,52,2,110,2709,2707,23,257,48,2,135,3172,
20221017,101,172,서울,용인,3456,140,121,36,22,250,4025,3792,140,123,40,25,230,4350,
20221017,101,173,서울,양지,3422,207,132,101,74,153,4089,4156,357,128,120,95,167,5023,
20221017,101,229,서울,북천안,970,48,41,42,19,36,1156,851,56,46,54,20,37,1064,
20221017,101,528,서울,기흥동탄,6746,65,1151,130,11,354,8457,7169,63,1281,129,10,338,8990,
20221017,101,542,서울,서안성,1463,43,69,80,30,68,1753,1802,49,84,105,39,82,2161,
20221017,101,543,서울,남안성,1239,55,62,49,68,47,1520,1294,79,81,94,98,47,1693,
20221017,101,673,서울,북오산,1556,40,126,21,9,111,1863,1542,35,120,15,22,102,1836,
20221017,101,677,서울,북평택,1966,62,237,54,82,116,2517,1657,67,273,88,108,89,2282,
20221017,102,101,동수원,서울,4972,58,382,21,17,282,5732,3617,49,260,14,10,221,4171,
20221017,102,172,동수원,용인,1022,20,24,6,3,87,1162,1029,37,18,3,2,75,1164,
20221017,102,173,동수원,양지,1213,35,31,8,32,63,1382,1337,37,32,11,13,79,1509,
20221017,102,212,동수원,북수원,4277,30,222,39,29,254,4851,4733,34,232,45,35,291,5370,
20221017,102,213,동수원,부곡,1069,11,17,5,21,72,1195,1015,12,16,5,18,83,1149,
20221017,102,214,동수원,동군포,1571,26,19,13,2,92,1723,1562,20,18,11,4,98,1713,
20221017,102,215,동수원,군포,1653,20,23,7,10,106,1819,2231,19,47,4,6,165,2472,
20221017,102,253,동수원,서서울,5641,57,63,14,23,329,6127,5152,59,69,11,29,346,5666,
20221017,102,254,동수원,군자,3880,50,73,16,28,215,4262,4277,67,64,26,33,240,4707,
20221017,102,255,동수원,서안산,1788,39,18,10,6,92,1953,1925,35,19,12,5,123,2119,
20221017,103,101,수원신갈,서울,14061,654,1615,382,108,661,17481,16029,869,1943,491,136,817,20285,
20221017,103,105,수원신갈,기흥,1639,25,39,13,17,106,1839,2186,27,44,29,18,168,2472,
20221017,103,106,수원신갈,오산,1084,68,55,41,13,70,1331,1376,73,68,58,10,93,1678,
20221017,103,107,수원신갈,안성,921,15,56,2,1,67,1062,1104,21,56,7,2,78,1268,
20221017,103,108,수원신갈,천안,1042,9,55,13,0,44,1163,1205,8,47,20,2,49,1331,
20221017,103,253,수원신갈,서서울,2074,140,66,65,18,127,2490,2324,180,87,93,27,135,2846,
20221017,103,254,수원신갈,군자,1577,100,55,70,85,109,1996,2087,156,113,117,156,110,2739,
20221017,103,528,수원신갈,기흥동탄,1350,8,170,4,3,79,1614,2037,29,178,3,3,113,2363,
20221017,105,101,기흥,서울,5995,87,357,98,28,298,6863,6812,87,398,64,19,320,7700,
20221017,105,103,기흥,수원신갈,2186,27,44,29,18,168,2472,1639,25,39,13,17,106,1839,
20221017,105,253,기흥,서서울,957,26,4,17,9,46,1059,991,22,19,13,13,65,1123,
20221017,106,101,오산,서울,4242,417,439,165,103,267,5633,4795,341,409,164,100,303,6112,
20221017,106,103,오산,수원신갈,1376,73,68,58,10,93,1678,1084,68,55,41,13,70,1331,
20221017,106,107,오산,안성,1605,45,32,27,24,132,1865,1359,48,22,21,15,124,1589,
20221017,106,108,오산,천안,1059,27,22,18,13,66,1205,1025,29,24,12,7,55,1152,
20221017,107,101,안성,서울,2936,87,271,46,19,152,3511,3571,81,280,40,14,194,4180,
20221017,107,103,안성,수원신갈,1104,21,56,7,2,78,1268,921,15,56,2,1,67,1062,
20221017,107,106,안성,오산,1359,48,22,21,15,124,1589,1605,45,32,27,24,132,1865,
20221017,107,108,안성,천안,1599,29,52,9,6,137,1832,1554,31,42,18,6,126,1777,
20221017,107,528,안성,기흥동탄,1021,13,22,6,4,94,1160,1188,21,23,4,7,100,1343,
20221017,107,742,안성,남사진위,1181,32,49,26,4,105,1397,1362,31,50,28,14,118,1603,
20221017,108,101,천안,서울,3822,41,345,34,19,186,4447,4303,49,348,32,11,200,4943,
20221017,108,103,천안,수원신갈,1205,8,47,20,2,49,1331,1042,9,55,13,0,44,1163,
20221017,108,106,천안,오산,1025,29,24,12,7,55,1152,1059,27,22,18,13,66,1205,
20221017,108,107,천안,안성,1554,31,42,18,6,126,1777,1599,29,52,9,6,137,1832,
20221017,108,111,천안,청주,1114,35,59,21,29,63,1321,1131,34,61,23,28,68,1345,
20221017,108,229,천안,북천안,3547,78,125,46,31,217,4044,3845,81,132,51,47,249,4405,
20221017,108,528,천안,기흥동탄,1084,13,97,7,13,62,1276,1145,19,126,4,13,63,1370,
20221017,108,742,천안,남사진위,1050,24,31,19,7,72,1203,1054,29,29,26,7,75,1220,
20221017,111,101,청주,서울,818,14,221,25,27,39,1144,1078,16,185,17,27,26,1349,
20221017,111,108,청주,천안,1131,34,61,23,28,68,1345,1114,35,59,21,29,63,1321,
20221017,112,115,남청주,대전,1545,72,56,9,10,111,1803,1668,90,62,8,7,111,1946,
20221017,113,115,신탄진,대전,933,25,10,4,4,101,1077,1091,20,21,7,9,114,1262,
20221017,114,153,남대전,서대전,1881,39,53,55,26,141,2195,1739,38,73,62,24,132,2068,
20221017,115,112,대전,남청주,1668,90,62,8,7,111,1946,1545,72,56,9,10,111,1803,
20221017,115,113,대전,신탄진,1091,20,21,7,9,114,1262,933,25,10,4,4,101,1077,
20221017,115,116,대전,옥천,2230,110,42,20,23,174,2599,1999,62,53,30,23,147,2314,
20221017,115,151,대전,북대전,1111,10,13,6,7,118,1265,914,9,10,2,5,110,1050,
20221017,115,153,대전,서대전,938,13,8,3,0,82,1044,895,15,7,2,7,85,1011,
20221017,115,579,대전,남세종,1066,9,27,4,28,91,1225,1130,16,23,3,22,88,1282,
20221017,116,115,옥천,대전,1999,62,53,30,23,147,2314,2230,110,42,20,23,174,2599,
20221017,119,153,판암,서대전,1768,22,13,9,43,142,1997,1875,19,26,6,34,153,2113,
20221017,123,127,구미,서대구,1563,23,21,16,6,91,1720,1725,32,21,16,6,91,1891,
20221017,123,129,구미,북대구,1839,11,47,5,9,103,2014,1945,11,59,7,3,112,2137,
20221017,123,130,구미,동김천,1118,22,43,45,44,70,1342,1158,23,32,33,19,67,1332,
20221017,125,127,남구미,서대구,1908,55,102,34,13,123,2235,2247,64,101,44,24,134,2614,
20221017,125,129,남구미,북대구,1783,22,77,3,8,83,1976,2231,23,81,19,9,118,2481,
20221017,126,127,왜관,서대구,2474,117,65,38,129,129,2952,2857,139,64,37,93,158,3348,
20221017,126,129,왜관,북대구,2976,97,52,19,79,130,3353,3379,114,63,14,73,167,3810,
20221017,127,123,서대구,구미,1725,32,21,16,6,91,1891,1563,23,21,16,6,91,1720,
20221017,127,125,서대구,남구미,2247,64,101,44,24,134,2614,1908,55,102,34,13,123,2235,
20221017,127,126,서대구,왜관,2857,139,64,37,93,158,3348,2474,117,65,38,129,129,2952,
20221017,127,131,서대구,경산,2521,205,142,105,81,164,3218,1839,149,109,82,55,135,2369,
20221017,127,203,서대구,가산,2179,59,83,39,104,91,2555,2120,51,56,33,154,102,2516,
20221017,127,230,서대구,팔공산,1403,36,44,13,5,95,1596,1082,31,41,20,8,76,1258,
20221017,127,518,서대구,칠곡물류,929,119,79,97,29,43,1296,729,94,78,65,24,39,1029,
20221017,127,621,서대구,동대구,1849,53,92,28,36,122,2180,1272,39,36,28,25,86,1486,
20221017,129,123,북대구,구미,1945,11,59,7,3,112,2137,1839,11,47,5,9,103,2014,
20221017,129,125,북대구,남구미,2231,23,81,19,9,118,2481,1783,22,77,3,8,83,1976,
20221017,129,126,북대구,왜관,3379,114,63,14,73,167,3810,2976,97,52,19,79,130,3353,
20221017,129,131,북대구,경산,2385,139,93,47,34,122,2820,2994,205,145,62,49,167,3622,
20221017,129,524,북대구,청통와촌,896,59,20,10,11,36,1032,1093,68,36,8,19,40,1264,
20221017,129,527,북대구,포항,1622,30,31,17,58,81,1839,1946,47,31,18,75,91,2208,
20221017,130,123,동김천,구미,1158,23,32,33,19,67,1332,1118,22,43,45,44,70,1342,
20221017,131,127,경산,서대구,1839,149,109,82,55,135,2369,2521,205,142,105,81,164,3218,
20221017,131,129,경산,북대구,2994,205,145,62,49,167,3622,2385,139,93,47,34,122,2820,
20221017,131,132,경산,영천,890,55,46,44,65,52,1152,822,46,48,41,32,47,1036,
20221017,131,230,경산,팔공산,1217,81,37,25,18,82,1460,1546,75,62,37,22,101,1843,
20221017,131,621,경산,동대구,2259,68,31,168,30,127,2683,2476,66,43,163,29,119,2896,
20221017,132,131,영천,경산,822,46,48,41,32,47,1036,890,55,46,44,65,52,1152,
20221017,132,621,영천,동대구,1099,11,24,2,29,52,1217,1212,9,20,4,40,63,1348,
20221017,135,140,경주,부산,1326,17,45,9,54,54,1505,1433,11,44,16,35,53,1592,
20221017,135,252,경주,대동,920,47,64,52,145,55,1283,1265,55,87,43,98,57,1605,
20221017,138,140,양산,부산,4979,255,157,334,266,274,6265,5369,309,184,358,247,270,6737,
20221017,138,252,양산,대동,2557,325,194,174,343,129,3722,2964,324,189,157,327,139,4100,
20221017,139,140,서울산,부산,1376,42,15,15,17,76,1541,1303,46,21,14,11,74,1469,
20221017,139,252,서울산,대동,807,42,32,30,55,38,1004,898,29,29,21,30,59,1066,
20221017,139,641,서울산,울산,1121,29,52,24,48,90,1364,1084,21,47,20,38,101,1311,
20221017,140,135,부산,경주,1433,11,44,16,35,53,1592,1326,17,45,9,54,54,1505,
20221017,140,138,부산,양산,5369,309,184,358,247,270,6737,4979,255,157,334,266,274,6265,
20221017,140,139,부산,서울산,1303,46,21,14,11,74,1469,1376,42,15,15,17,76,1541,
20221017,140,250,부산,남양산,7880,137,221,26,38,655,8957,7745,147,214,37,39,642,8824,
20221017,140,251,부산,물금,1013,117,28,28,73,72,1331,1007,94,31,20,70,78,1300,
20221017,140,252,부산,대동,1767,44,48,53,58,105,2075,1462,34,33,30,118,77,1754,
20221017,140,755,부산,광재,1104,18,22,10,22,66,1242,971,17,17,8,27,55,1095,
20221017,142,145,군북,산인,4030,70,117,50,106,303,4676,4211,65,115,31,75,303,4800,
20221017,143,145,장지,산인,1167,26,30,34,46,88,1391,1212,26,26,31,42,92,1429,
20221017,144,145,함안,산인,2127,54,42,36,91,147,2497,2198,48,55,26,64,157,2548,
20221017,145,142,산인,군북,4211,65,115,31,75,303,4800,4030,70,117,50,106,303,4676,
20221017,145,143,산인,장지,1212,26,26,31,42,92,1429,1167,26,30,34,46,88,1391,
20221017,145,144,산인,함안,2198,48,55,26,64,157,2548,2127,54,42,36,91,147,2497,
20221017,145,291,산인,사천,1323,44,52,18,48,66,1551,1381,69,53,29,38,76,1646,
20221017,145,292,산인,진주,1369,31,143,10,11,74,1638,1632,28,127,21,15,103,1926,
20221017,145,293,산인,문산,1242,28,18,9,4,80,1381,1150,19,22,15,7,92,1305,
20221017,146,150,동창원,북부산,1011,17,12,3,25,86,1154,970,15,20,4,21,69,1099,
20221017,146,244,동창원,서부산,1233,34,32,22,25,67,1413,1254,30,35,25,43,83,1470,
20221017,146,245,동창원,장유,942,18,9,4,19,85,1077,1002,13,15,7,18,89,1144,
20221017,146,289,동창원,마산,2690,85,60,87,74,243,3239,2560,83,78,87,47,219,3074,
20221017,147,150,진례,북부산,1319,41,26,18,33,81,1518,1588,60,26,19,23,104,1820,
20221017,147,244,진례,서부산,1737,105,84,50,64,109,2149,1920,109,68,51,84,102,2334,
20221017,147,245,진례,장유,1063,59,88,44,15,103,1372,1421,53,93,37,24,146,1774,
20221017,147,289,진례,마산,1167,98,89,53,112,81,1600,1279,84,70,49,63,103,1648,
20221017,148,150,서김해,북부산,6505,120,87,50,101,467,7330,6500,109,65,48,64,500,7286,
20221017,148,251,서김해,물금,881,31,22,28,8,104,1074,879,41,25,17,14,82,1058,
20221017,148,289,서김해,마산,1458,39,54,15,7,114,1687,1396,35,55,10,12,92,1600,
20221017,149,150,동김해,북부산,10317,185,191,36,81,839,11649,8920,162,143,35,38,685,9983,
20221017,149,250,동김해,남양산,1078,21,53,9,5,83,1249,1027,17,51,8,7,74,1184,
20221017,149,251,동김해,물금,1115,43,13,10,3,101,1285,1100,30,10,7,10,97,1254,
20221017,149,289,동김해,마산,848,36,33,19,41,65,1042,841,36,35,19,31,46,1008,
20221017,150,146,북부산,동창원,970,15,20,4,21,69,1099,1011,17,12,3,25,86,1154,
20221017,150,147,북부산,진례,1588,60,26,19,23,104,1820,1319,41,26,18,33,81,1518,
20221017,150,148,북부산,서김해,6500,109,65,48,64,500,7286,6505,120,87,50,101,467,7330,
20221017,150,149,북부산,동김해,8920,162,143,35,38,685,9983,10317,185,191,36,81,839,11649,
20221017,150,245,북부산,장유,3852,37,81,18,27,263,4278,3087,41,76,6,20,218,3448,
20221017,150,289,북부산,마산,2713,32,82,8,12,142,2989,2819,32,63,15,28,153,3110,
20221017,151,115,북대전,대전,914,9,10,2,5,110,1050,1111,10,13,6,7,118,1265,
20221017,151,153,북대전,서대전,1118,12,13,12,21,89,1265,1296,18,23,16,19,85,1457,
20221017,152,154,유성,안영,920,19,31,15,14,66,1065,1097,17,26,13,17,68,1238,
20221017,153,114,서대전,남대전,1739,38,73,62,24,132,2068,1881,39,53,55,26,141,2195,
20221017,153,115,서대전,대전,895,15,7,2,7,85,1011,938,13,8,3,0,82,1044,
20221017,153,119,서대전,판암,1875,19,26,6,34,153,2113,1768,22,13,9,43,142,1997,
20221017,153,151,서대전,북대전,1296,18,23,16,19,85,1457,1118,12,13,12,21,89,1265,
20221017,153,154,서대전,안영,1047,42,44,103,62,62,1360,1077,42,42,102,30,64,1357,
20221017,153,579,서대전,남세종,1220,17,19,9,12,89,1366,1023,19,24,7,14,76,1163,
20221017,154,152,안영,유성,1097,17,26,13,17,68,1238,920,19,31,15,14,66,1065,
20221017,154,153,안영,서대전,1077,42,42,102,30,64,1357,1047,42,44,103,62,62,1360,
20221017,159,167,서전주,광주,1284,56,69,47,48,46,1550,1272,67,47,37,43,36,1502,
20221017,166,167,장성,광주,2254,80,71,23,51,110,2589,2387,101,64,29,23,108,2712,
20221017,167,159,광주,서전주,1272,67,47,37,43,36,1502,1284,56,69,47,48,46,1550,
20221017,167,166,광주,장성,2387,101,64,29,23,108,2712,2254,80,71,23,51,110,2589,
20221017,167,567,광주,남고창,1188,24,44,13,32,35,1336,1321,28,57,12,43,41,1502,
20221017,171,101,마성,서울,2707,23,257,48,2,135,3172,2316,31,198,52,2,110,2709,
20221017,172,101,용인,서울,3792,140,123,40,25,230,4350,3456,140,121,36,22,250,4025,
20221017,172,102,용인,동수원,1029,37,18,3,2,75,1164,1022,20,24,6,3,87,1162,
20221017,172,173,용인,양지,1937,246,114,143,110,152,2702,1836,210,126,120,112,160,2564,
20221017,172,212,용인,북수원,900,28,16,15,15,57,1031,1184,53,17,22,11,81,1368,
20221017,172,253,용인,서서울,1091,52,20,22,12,61,1258,1123,50,25,26,15,73,1312,
20221017,173,101,양지,서울,4156,357,128,120,95,167,5023,3422,207,132,101,74,153,4089,
20221017,173,102,양지,동수원,1337,37,32,11,13,79,1509,1213,35,31,8,32,63,1382,
20221017,173,172,양지,용인,1836,210,126,120,112,160,2564,1937,246,114,143,110,152,2702,
20221017,173,212,양지,북수원,1197,86,49,54,53,56,1495,1330,86,56,46,91,60,1669,
20221017,173,253,양지,서서울,1257,144,68,100,51,54,1674,1068,114,53,110,39,50,1434,
20221017,173,254,양지,군자,768,108,63,159,177,36,1311,803,109,93,145,183,43,1376,
20221017,174,179,춘천,홍천,3308,63,90,125,37,303,3926,3048,56,88,119,28,283,3622,
20221017,174,216,춘천,횡성,1082,43,27,28,13,80,1273,1096,41,24,13,18,51,1243,
20221017,174,218,춘천,남원주,1140,28,74,13,12,74,1341,1078,19,71,9,17,71,1265,
20221017,174,554,춘천,동홍천,1280,19,17,9,12,93,1430,1219,17,18,1,4,94,1353,
20221017,176,190,이천,동서울,1386,67,179,94,105,71,1902,1727,57,165,124,90,92,2255,
20221017,179,174,홍천,춘천,3048,56,88,119,28,283,3622,3308,63,90,125,37,303,3926,
20221017,184,189,대관령,강릉,1231,67,56,10,11,74,1449,1343,51,52,7,18,91,1562,
20221017,189,184,강릉,대관령,1343,51,52,7,18,91,1562,1231,67,56,10,11,74,1449,
20221017,190,176,동서울,이천,1727,57,165,124,90,92,2255,1386,67,179,94,105,71,1902,
20221017,190,191,동서울,경기광주,10380,624,440,337,203,705,12689,10142,625,389,263,192,705,12316,
20221017,190,192,동서울,곤지암,6116,474,226,190,80,392,7478,5483,436,162,187,61,346,6675,
20221017,190,193,동서울,일죽,2779,147,186,188,108,121,3529,2373,164,134,218,108,93,3090,
20221017,190,194,동서울,서이천,4477,539,316,277,161,244,6014,3158,396,222,211,109,176,4272,
20221017,190,560,동서울,감곡,968,22,36,41,73,36,1176,939,31,34,31,90,29,1154,
20221017,190,705,동서울,남이천,1457,69,64,124,90,48,1852,1432,89,59,96,59,61,1796,
20221017,191,190,경기광주,동서울,10142,625,389,263,192,705,12316,10380,624,440,337,203,705,12689,
20221017,192,190,곤지암,동서울,5483,436,162,187,61,346,6675,6116,474,226,190,80,392,7478,
20221017,192,194,곤지암,서이천,1317,232,114,290,90,93,2136,1028,154,92,232,126,85,1717,
20221017,193,190,일죽,동서울,2373,164,134,218,108,93,3090,2779,147,186,188,108,121,3529,
20221017,194,190,서이천,동서울,3158,396,222,211,109,176,4272,4477,539,316,277,161,244,6014,
20221017,194,192,서이천,곤지암,1028,154,92,232,126,85,1717,1317,232,114,290,90,93,2136,
20221017,196,198,진천,서청주,1294,33,73,36,27,77,1540,1226,31,72,31,29,77,1466,
20221017,198,196,서청주,진천,1226,31,72,31,29,77,1466,1294,33,73,36,27,77,1540,
20221017,201,203,칠곡,가산,877,38,34,37,114,47,1147,855,42,46,29,142,51,1165,
20221017,203,127,가산,서대구,2120,51,56,33,154,102,2516,2179,59,83,39,104,91,2555,
20221017,203,201,가산,칠곡,855,42,46,29,142,51,1165,877,38,34,37,114,47,1147,
20221017,203,775,가산,동명동호,1600,45,40,51,245,82,2063,1551,57,43,49,164,72,1936,
20221017,212,102,북수원,동수원,4733,34,232,45,35,291,5370,4277,30,222,39,29,254,4851,
20221017,212,172,북수원,용인,1184,53,17,22,11,81,1368,900,28,16,15,15,57,1031,
20221017,212,173,북수원,양지,1330,86,56,46,91,60,1669,1197,86,49,54,53,56,1495,
20221017,212,253,북수원,서서울,2657,38,26,14,15,166,2916,903,22,13,7,5,55,1005,
20221017,212,254,북수원,군자,1742,36,29,9,24,108,1948,1125,31,18,16,23,68,1281,
20221017,213,102,부곡,동수원,1015,12,16,5,18,83,1149,1069,11,17,5,21,72,1195,
20221017,213,253,부곡,서서울,1423,70,37,26,174,103,1833,1026,49,29,40,175,65,1384,
20221017,213,254,부곡,군자,1026,31,30,45,522,58,1712,864,39,22,36,404,58,1423,
20221017,214,102,동군포,동수원,1562,20,18,11,4,98,1713,1571,26,19,13,2,92,1723,
20221017,215,102,군포,동수원,2231,19,47,4,6,165,2472,1653,20,23,7,10,106,1819,
20221017,215,253,군포,서서울,3022,78,74,34,49,228,3485,3719,138,132,157,85,242,4473,
20221017,215,254,군포,군자,2007,63,54,30,87,153,2394,2712,125,93,124,154,213,3421,
20221017,215,255,군포,서안산,1251,45,33,24,19,99,1471,1456,66,72,93,80,119,1886,
20221017,216,174,횡성,춘천,1096,41,24,13,18,51,1243,1082,43,27,28,13,80,1273,
20221017,218,174,남원주,춘천,1078,19,71,9,17,71,1265,1140,28,74,13,12,74,1341,
20221017,218,240,남원주,제천,2086,42,49,22,49,145,2393,2050,49,50,12,42,154,2357,
20221017,225,291,서진주,사천,1057,30,17,11,33,64,1212,1054,25,28,11,36,70,1224,
20221017,229,101,북천안,서울,851,56,46,54,20,37,1064,970,48,41,42,19,36,1156,
20221017,229,108,북천안,천안,3845,81,132,51,47,249,4405,3547,78,125,46,31,217,4044,
20221017,230,127,팔공산,서대구,1082,31,41,20,8,76,1258,1403,36,44,13,5,95,1596,
20221017,230,131,팔공산,경산,1546,75,62,37,22,101,1843,1217,81,37,25,18,82,1460,
20221017,230,524,팔공산,청통와촌,1206,37,35,7,13,64,1362,979,41,29,11,18,51,1129,
20221017,230,527,팔공산,포항,1611,21,24,10,31,68,1765,1239,23,12,6,24,48,1352,
20221017,231,519,화원옥포,남대구,6466,182,101,61,171,492,7473,6275,170,108,44,87,446,7130,
20221017,232,519,달성,남대구,2696,114,137,43,25,206,3221,2981,128,142,47,32,204,3534,
20221017,233,519,현풍,남대구,4923,221,211,80,127,357,5919,4464,198,198,104,137,311,5412,
20221017,237,239,남지,칠원,773,16,37,14,157,80,1077,796,27,36,21,157,78,1115,
20221017,238,239,칠서,칠원,1578,88,104,145,451,95,2461,1720,81,105,126,479,102,2613,
20221017,239,237,칠원,남지,796,27,36,21,157,78,1115,773,16,37,14,157,80,1077,
20221017,239,238,칠원,칠서,1720,81,105,126,479,102,2613,1578,88,104,145,451,95,2461,
20221017,239,519,칠원,남대구,1176,40,85,37,90,44,1472,1160,56,89,40,51,45,1441,
20221017,240,218,제천,남원주,2050,49,50,12,42,154,2357,2086,42,49,22,49,145,2393,
20221017,241,519,동고령,남대구,2987,94,76,290,143,155,3745,3001,95,94,281,160,160,3791,
20221017,242,519,고령,남대구,1664,36,37,28,167,89,2021,1783,35,41,18,157,95,2129,
20221017,244,146,서부산,동창원,1254,30,35,25,43,83,1470,1233,34,32,22,25,67,1413,
20221017,244,147,서부산,진례,1920,109,68,51,84,102,2334,1737,105,84,50,64,109,2149,
20221017,244,245,서부산,장유,12997,256,368,177,338,935,15071,12169,214,377,180,404,939,14283,
20221017,244,289,서부산,마산,3154,53,240,41,54,170,3712,2900,65,233,51,86,146,3481,
20221017,245,146,장유,동창원,1002,13,15,7,18,89,1144,942,18,9,4,19,85,1077,
20221017,245,147,장유,진례,1421,53,93,37,24,146,1774,1063,59,88,44,15,103,1372,
20221017,245,150,장유,북부산,3087,41,76,6,20,218,3448,3852,37,81,18,27,263,4278,
20221017,245,244,장유,서부산,12169,214,377,180,404,939,14283,12997,256,368,177,338,935,15071,
20221017,245,289,장유,마산,1475,32,49,15,29,114,1714,1355,27,43,19,16,109,1569,
20221017,248,261,순창,동광주,1291,15,17,8,20,47,1398,1270,17,23,13,22,47,1392,
20221017,249,261,담양,동광주,2403,37,117,28,59,119,2763,1817,35,116,17,45,88,2118,
20221017,250,140,남양산,부산,7745,147,214,37,39,642,8824,7880,137,221,26,38,655,8957,
20221017,250,149,남양산,동김해,1027,17,51,8,7,74,1184,1078,21,53,9,5,83,1249,
20221017,250,252,남양산,대동,3256,144,115,105,101,235,3956,4193,180,109,74,115,289,4960,
20221017,251,140,물금,부산,1007,94,31,20,70,78,1300,1013,117,28,28,73,72,1331,
20221017,251,148,물금,서김해,879,41,25,17,14,82,1058,881,31,22,28,8,104,1074,
20221017,251,149,물금,동김해,1100,30,10,7,10,97,1254,1115,43,13,10,3,101,1285,
20221017,251,252,물금,대동,3182,194,93,132,385,242,4228,3897,200,90,122,558,293,5160,
20221017,252,135,대동,경주,1265,55,87,43,98,57,1605,920,47,64,52,145,55,1283,
20221017,252,138,대동,양산,2964,324,189,157,327,139,4100,2557,325,194,174,343,129,3722,
20221017,252,139,대동,서울산,898,29,29,21,30,59,1066,807,42,32,30,55,38,1004,
20221017,252,140,대동,부산,1462,34,33,30,118,77,1754,1767,44,48,53,58,105,2075,
20221017,252,250,대동,남양산,4193,180,109,74,115,289,4960,3256,144,115,105,101,235,3956,
20221017,252,251,대동,물금,3897,200,90,122,558,293,5160,3182,194,93,132,385,242,4228,
20221017,252,641,대동,울산,1780,70,98,40,58,110,2156,1283,57,95,32,49,71,1587,
20221017,252,752,대동,기장철마,1841,67,42,37,140,144,2271,1950,50,45,39,66,165,2315,
20221017,252,753,대동,금정,1923,121,99,84,139,104,2470,1196,68,74,59,71,87,1555,
20221017,252,755,대동,광재,2415,101,101,111,353,165,3246,2322,97,83,106,480,157,3245,
20221017,252,756,대동,한림,901,42,46,27,92,41,1149,938,43,42,29,109,41,1202,
20221017,253,102,서서울,동수원,5152,59,69,11,29,346,5666,5641,57,63,14,23,329,6127,
20221017,253,103,서서울,수원신갈,2324,180,87,93,27,135,2846,2074,140,66,65,18,127,2490,
20221017,253,105,서서울,기흥,991,22,19,13,13,65,1123,957,26,4,17,9,46,1059,
20221017,253,172,서서울,용인,1123,50,25,26,15,73,1312,1091,52,20,22,12,61,1258,
20221017,253,173,서서울,양지,1068,114,53,110,39,50,1434,1257,144,68,100,51,54,1674,
20221017,253,212,서서울,북수원,903,22,13,7,5,55,1005,2657,38,26,14,15,166,2916,
20221017,253,213,서서울,부곡,1026,49,29,40,175,65,1384,1423,70,37,26,174,103,1833,
20221017,253,215,서서울,군포,3719,138,132,157,85,242,4473,3022,78,74,34,49,228,3485,
20221017,253,255,서서울,서안산,15215,485,665,614,301,890,18170,14579,502,623,558,285,893,17440,
20221017,253,256,서서울,안산,9042,169,87,41,32,673,10044,6074,111,55,34,48,452,6774,
20221017,253,281,서서울,매송,3777,82,44,17,17,232,4169,3530,72,31,22,70,215,3940,
20221017,253,282,서서울,비봉,5704,262,234,167,330,351,7048,5292,291,252,164,378,383,6760,
20221017,253,283,서서울,발안,3685,179,162,163,154,212,4555,3590,208,157,185,155,218,4513,
20221017,253,285,서서울,서평택,1860,65,108,257,382,93,2765,1340,88,116,324,519,87,2474,
20221017,253,287,서서울,송악,1995,29,56,62,205,84,2431,1678,48,63,90,381,74,2334,
20221017,253,288,서서울,당진,1441,21,42,34,28,69,1635,1379,17,47,47,40,68,1598,
20221017,253,298,서서울,서산,2062,26,73,47,26,97,2331,2253,31,59,66,52,78,2539,
20221017,253,520,서서울,평택,2471,94,117,161,125,110,3078,2154,124,134,214,129,103,2858,
20221017,253,540,서서울,청북,1014,45,63,102,42,57,1323,867,53,46,89,81,50,1186,
20221017,253,741,서서울,평택고덕,1405,24,18,24,6,100,1577,907,28,27,29,15,78,1084,
20221017,254,102,군자,동수원,4277,67,64,26,33,240,4707,3880,50,73,16,28,215,4262,
20221017,254,103,군자,수원신갈,2087,156,113,117,156,110,2739,1577,100,55,70,85,109,1996,
20221017,254,173,군자,양지,803,109,93,145,183,43,1376,768,108,63,159,177,36,1311,
20221017,254,212,군자,북수원,1125,31,18,16,23,68,1281,1742,36,29,9,24,108,1948,
20221017,254,213,군자,부곡,864,39,22,36,404,58,1423,1026,31,30,45,522,58,1712,
20221017,254,215,군자,군포,2712,125,93,124,154,213,3421,2007,63,54,30,87,153,2394,
20221017,254,255,군자,서안산,10666,391,230,243,334,696,12560,9652,402,200,229,329,633,11445,
20221017,254,256,군자,안산,4473,119,116,45,51,356,5160,4957,107,114,57,65,387,5687,
20221017,254,281,군자,매송,1215,35,22,18,70,81,1441,846,16,18,9,68,60,1017,
20221017,254,282,군자,비봉,1254,123,83,91,184,83,1818,1091,99,70,69,147,86,1562,
20221017,254,283,군자,발안,1243,92,70,75,161,74,1715,1075,81,62,47,110,60,1435,
20221017,255,102,서안산,동수원,1925,35,19,12,5,123,2119,1788,39,18,10,6,92,1953,
20221017,255,215,서안산,군포,1456,66,72,93,80,119,1886,1251,45,33,24,19,99,1471,
20221017,255,253,서안산,서서울,14579,502,623,558,285,893,17440,15215,485,665,614,301,890,18170,
20221017,255,254,서안산,군자,9652,402,200,229,329,633,11445,10666,391,230,243,334,696,12560,
20221017,256,253,안산,서서울,6074,111,55,34,48,452,6774,9042,169,87,41,32,673,10044,
20221017,256,254,안산,군자,4957,107,114,57,65,387,5687,4473,119,116,45,51,356,5160,
20221017,261,248,동광주,순창,1270,17,23,13,22,47,1392,1291,15,17,8,20,47,1398,
20221017,261,249,동광주,담양,1817,35,116,17,45,88,2118,2403,37,117,28,59,119,2763,
20221017,261,262,동광주,창평,1590,81,31,44,69,61,1876,1699,70,29,46,65,76,1985,
20221017,261,263,동광주,옥과,2691,36,119,20,139,138,3143,2569,20,120,15,135,137,2996,
20221017,261,265,동광주,곡성,1597,40,59,17,63,64,1840,1471,30,44,20,60,57,1682,
20221017,261,271,동광주,순천,3254,78,70,34,119,100,3655,2768,79,70,23,128,95,3163,
20221017,262,261,창평,동광주,1699,70,29,46,65,76,1985,1590,81,31,44,69,61,1876,
20221017,263,261,옥과,동광주,2569,20,120,15,135,137,2996,2691,36,119,20,139,138,3143,
20221017,265,261,곡성,동광주,1471,30,44,20,60,57,1682,1597,40,59,17,63,64,1840,
20221017,271,261,순천,동광주,2768,79,70,23,128,95,3163,3254,78,70,34,119,100,3655,
20221017,271,569,순천,북광주,816,66,34,31,133,30,1110,864,66,39,33,140,34,1176,
20221017,280,519,거창,남대구,913,19,39,5,11,51,1038,947,24,55,5,13,61,1105,
20221017,281,253,매송,서서울,3530,72,31,22,70,215,3940,3777,82,44,17,17,232,4169,
20221017,281,254,매송,군자,846,16,18,9,68,60,1017,1215,35,22,18,70,81,1441,
20221017,282,253,비봉,서서울,5292,291,252,164,378,383,6760,5704,262,234,167,330,351,7048,
20221017,282,254,비봉,군자,1091,99,70,69,147,86,1562,1254,123,83,91,184,83,1818,
20221017,283,253,발안,서서울,3590,208,157,185,155,218,4513,3685,179,162,163,154,212,4555,
20221017,283,254,발안,군자,1075,81,62,47,110,60,1435,1243,92,70,75,161,74,1715,
20221017,285,253,서평택,서서울,1340,88,116,324,519,87,2474,1860,65,108,257,382,93,2765,
20221017,285,287,서평택,송악,624,27,92,67,711,35,1556,660,25,86,78,603,43,1495,
20221017,285,520,서평택,평택,769,41,68,71,112,65,1126,843,36,59,72,105,88,1203,
20221017,287,253,송악,서서울,1678,48,63,90,381,74,2334,1995,29,56,62,205,84,2431,
20221017,287,285,송악,서평택,660,25,86,78,603,43,1495,624,27,92,67,711,35,1556,
20221017,288,253,당진,서서울,1379,17,47,47,40,68,1598,1441,21,42,34,28,69,1635,
20221017,289,146,마산,동창원,2560,83,78,87,47,219,3074,2690,85,60,87,74,243,3239,
20221017,289,147,마산,진례,1279,84,70,49,63,103,1648,1167,98,89,53,112,81,1600,
20221017,289,148,마산,서김해,1396,35,55,10,12,92,1600,1458,39,54,15,7,114,1687,
20221017,289,149,마산,동김해,841,36,35,19,31,46,1008,848,36,33,19,41,65,1042,
20221017,289,150,마산,북부산,2819,32,63,15,28,153,3110,2713,32,82,8,12,142,2989,
20221017,289,244,마산,서부산,2900,65,233,51,86,146,3481,3154,53,240,41,54,170,3712,
20221017,289,245,마산,장유,1355,27,43,19,16,109,1569,1475,32,49,15,29,114,1714,
20221017,289,757,마산,진영,736,36,49,40,92,50,1003,794,56,49,38,67,54,1058,
20221017,291,145,사천,산인,1381,69,53,29,38,76,1646,1323,44,52,18,48,66,1551,
20221017,291,225,사천,서진주,1054,25,28,11,36,70,1224,1057,30,17,11,33,64,1212,
20221017,291,292,사천,진주,2821,69,74,54,40,266,3324,3476,93,95,52,62,279,4057,
20221017,292,145,진주,산인,1632,28,127,21,15,103,1926,1369,31,143,10,11,74,1638,
20221017,292,291,진주,사천,3476,93,95,52,62,279,4057,2821,69,74,54,40,266,3324,
20221017,293,145,문산,산인,1150,19,22,15,7,92,1305,1242,28,18,9,4,80,1381,
20221017,298,253,서산,서서울,2253,31,59,66,52,78,2539,2062,26,73,47,26,97,2331,
20221017,508,509,무안,목포,1289,46,40,26,52,63,1516,1626,37,47,37,58,71,1876,
20221017,508,553,무안,동광산,1481,17,24,21,21,54,1618,1632,26,41,33,23,57,1812,
20221017,509,508,목포,무안,1626,37,47,37,58,71,1876,1289,46,40,26,52,63,1516,
20221017,509,553,목포,동광산,6574,176,181,124,369,251,7675,7233,147,202,140,425,270,8417,
20221017,513,515,고성,북통영,1285,36,66,11,23,98,1519,1713,34,73,20,21,126,1987,
20221017,513,516,고성,통영,3029,79,144,85,176,218,3731,3057,86,131,83,160,224,3741,
20221017,514,516,동고성,통영,1161,26,54,34,140,149,1564,1233,11,56,37,151,181,1669,
20221017,515,513,북통영,고성,1713,34,73,20,21,126,1987,1285,36,66,11,23,98,1519,
20221017,516,513,통영,고성,3057,86,131,83,160,224,3741,3029,79,144,85,176,218,3731,
20221017,516,514,통영,동고성,1233,11,56,37,151,181,1669,1161,26,54,34,140,149,1564,
20221017,518,127,칠곡물류,서대구,729,94,78,65,24,39,1029,929,119,79,97,29,43,1296,
20221017,519,231,남대구,화원옥포,6275,170,108,44,87,446,7130,6466,182,101,61,171,492,7473,
20221017,519,232,남대구,달성,2981,128,142,47,32,204,3534,2696,114,137,43,25,206,3221,
20221017,519,233,남대구,현풍,4464,198,198,104,137,311,5412,4923,221,211,80,127,357,5919,
20221017,519,239,남대구,칠원,1160,56,89,40,51,45,1441,1176,40,85,37,90,44,1472,
20221017,519,241,남대구,동고령,3001,95,94,281,160,160,3791,2987,94,76,290,143,155,3745,
20221017,519,242,남대구,고령,1783,35,41,18,157,95,2129,1664,36,37,28,167,89,2021,
20221017,519,280,남대구,거창,947,24,55,5,13,61,1105,913,19,39,5,11,51,1038,
20221017,519,730,남대구,유천,2323,54,18,2,37,151,2585,2857,55,13,1,0,190,3116,
20221017,519,731,남대구,북현풍,1968,28,27,0,3,139,2165,1587,23,5,0,0,114,1729,
20221017,520,253,평택,서서울,2154,124,134,214,129,103,2858,2471,94,117,161,125,110,3078,
20221017,520,285,평택,서평택,843,36,59,72,105,88,1203,769,41,68,71,112,65,1126,
20221017,520,540,평택,청북,970,73,147,134,77,61,1462,751,83,117,111,85,43,1190,
20221017,520,741,평택,평택고덕,1017,16,201,18,19,84,1355,754,11,168,16,22,70,1041,
20221017,524,129,청통와촌,북대구,1093,68,36,8,19,40,1264,896,59,20,10,11,36,1032,
20221017,524,230,청통와촌,팔공산,979,41,29,11,18,51,1129,1206,37,35,7,13,64,1362,
20221017,526,527,서포항,포항,909,10,19,8,30,64,1040,994,8,20,8,27,68,1125,
20221017,527,129,포항,북대구,1946,47,31,18,75,91,2208,1622,30,31,17,58,81,1839,
20221017,527,230,포항,팔공산,1239,23,12,6,24,48,1352,1611,21,24,10,31,68,1765,
20221017,527,526,포항,서포항,994,8,20,8,27,68,1125,909,10,19,8,30,64,1040,
20221017,528,101,기흥동탄,서울,7169,63,1281,129,10,338,8990,6746,65,1151,130,11,354,8457,
20221017,528,103,기흥동탄,수원신갈,2037,29,178,3,3,113,2363,1350,8,170,4,3,79,1614,
20221017,528,107,기흥동탄,안성,1188,21,23,4,7,100,1343,1021,13,22,6,4,94,1160,
20221017,528,108,기흥동탄,천안,1145,19,126,4,13,63,1370,1084,13,97,7,13,62,1276,
20221017,540,253,청북,서서울,867,53,46,89,81,50,1186,1014,45,63,102,42,57,1323,
20221017,540,520,청북,평택,751,83,117,111,85,43,1190,970,73,147,134,77,61,1462,
20221017,540,741,청북,평택고덕,879,16,35,56,79,88,1153,876,29,51,62,94,87,1199,
20221017,542,101,서안성,서울,1802,49,84,105,39,82,2161,1463,43,69,80,30,68,1753,
20221017,542,543,서안성,남안성,1026,41,75,126,90,83,1441,1175,43,79,135,70,107,1609,
20221017,543,101,남안성,서울,1294,79,81,94,98,47,1693,1239,55,62,49,68,47,1520,
20221017,543,542,남안성,서안성,1175,43,79,135,70,107,1609,1026,41,75,126,90,83,1441,
20221017,543,555,남안성,북진천,837,109,163,183,151,39,1482,798,96,161,135,153,53,1396,
20221017,548,553,북무안,동광산,1293,21,32,23,52,34,1455,1549,29,41,30,56,40,1745,
20221017,549,553,동함평,동광산,3243,31,54,40,50,128,3546,2937,37,67,36,42,114,3233,
20221017,551,553,나주,동광산,1224,16,26,110,57,70,1503,1198,16,30,117,47,68,1476,
20221017,552,553,서광산,동광산,4324,145,159,198,215,158,5199,5891,182,177,203,169,221,6843,
20221017,553,508,동광산,무안,1632,26,41,33,23,57,1812,1481,17,24,21,21,54,1618,
20221017,553,509,동광산,목포,7233,147,202,140,425,270,8417,6574,176,181,124,369,251,7675,
20221017,553,548,동광산,북무안,1549,29,41,30,56,40,1745,1293,21,32,23,52,34,1455,
20221017,553,549,동광산,동함평,2937,37,67,36,42,114,3233,3243,31,54,40,50,128,3546,
20221017,553,551,동광산,나주,1198,16,30,117,47,68,1476,1224,16,26,110,57,70,1503,
20221017,553,552,동광산,서광산,5891,182,177,203,169,221,6843,4324,145,159,198,215,158,5199,
20221017,554,174,동홍천,춘천,1219,17,18,1,4,94,1353,1280,19,17,9,12,93,1430,
20221017,555,543,북진천,남안성,798,96,161,135,153,53,1396,837,109,163,183,151,39,1482,
20221017,560,190,감곡,동서울,939,31,34,31,90,29,1154,968,22,36,41,73,36,1176,
20221017,567,167,남고창,광주,1321,28,57,12,43,41,1502,1188,24,44,13,32,35,1336,
20221017,569,271,북광주,순천,864,66,39,33,140,34,1176,816,66,34,31,133,30,1110,
20221017,579,115,남세종,대전,1130,16,23,3,22,88,1282,1066,9,27,4,28,91,1225,
20221017,579,153,남세종,서대전,1023,19,24,7,14,76,1163,1220,17,19,9,12,89,1366,
20221017,587,589,오수,상관,1077,19,40,27,54,30,1247,1158,26,33,23,131,43,1414,
20221017,589,587,상관,오수,1158,26,33,23,131,43,1414,1077,19,40,27,54,30,1247,
20221017,597,598,서여주,북여주,1061,38,82,30,44,42,1297,1130,38,54,29,41,58,1350,
20221017,598,597,북여주,서여주,1130,38,54,29,41,58,1350,1061,38,82,30,44,42,1297,
20221017,621,127,동대구,서대구,1272,39,36,28,25,86,1486,1849,53,92,28,36,122,2180,
20221017,621,131,동대구,경산,2476,66,43,163,29,119,2896,2259,68,31,168,30,127,2683,
20221017,621,132,동대구,영천,1212,9,20,4,40,63,1348,1099,11,24,2,29,52,1217,
20221017,625,626,밀양,남밀양,1194,55,44,42,67,54,1456,1204,55,52,38,82,60,1491,
20221017,626,625,남밀양,밀양,1204,55,52,38,82,60,1491,1194,55,44,42,67,54,1456,
20221017,626,627,남밀양,삼랑진,1029,19,26,16,31,111,1232,1035,21,22,17,25,114,1234,
20221017,627,626,삼랑진,남밀양,1035,21,22,17,25,114,1234,1029,19,26,16,31,111,1232,
20221017,641,139,울산,서울산,1084,21,47,20,38,101,1311,1121,29,52,24,48,90,1364,
20221017,641,252,울산,대동,1283,57,95,32,49,71,1587,1780,70,98,40,58,110,2156,
20221017,641,643,울산,청량,1118,9,12,16,44,105,1304,1222,4,11,14,20,129,1400,
20221017,641,648,울산,해운대,962,4,14,0,3,64,1047,1173,8,21,2,5,79,1288,
20221017,641,706,울산,남경주,1133,12,15,18,32,57,1267,1153,11,10,19,24,60,1277,
20221017,641,707,울산,남포항,1155,19,29,12,136,68,1419,1106,18,21,33,120,74,1372,
20221017,643,641,청량,울산,1222,4,11,14,20,129,1400,1118,9,12,16,44,105,1304,
20221017,643,648,청량,해운대,2839,15,33,18,79,190,3174,3465,21,80,48,399,218,4231,
20221017,645,648,장안,해운대,1637,13,10,4,8,91,1763,2932,31,26,179,81,183,3432,
20221017,646,648,기장일광,해운대,4708,27,20,84,47,272,5158,5435,43,26,24,142,331,6001,
20221017,648,641,해운대,울산,1173,8,21,2,5,79,1288,962,4,14,0,3,64,1047,
20221017,648,643,해운대,청량,3465,21,80,48,399,218,4231,2839,15,33,18,79,190,3174,
20221017,648,645,해운대,장안,2932,31,26,179,81,183,3432,1637,13,10,4,8,91,1763,
20221017,648,646,해운대,기장일광,5435,43,26,24,142,331,6001,4708,27,20,84,47,272,5158,
20221017,651,652,남양주,화도,14378,565,513,434,264,1092,17246,16591,586,571,489,223,1274,19734,
20221017,651,653,남양주,서종,1761,19,11,4,70,72,1937,1881,20,9,3,53,76,2042,
20221017,651,654,남양주,설악,3864,32,70,17,30,156,4169,3681,21,56,13,26,144,3941,
20221017,651,655,남양주,강촌,2353,35,125,21,27,76,2637,2513,35,107,24,35,97,2811,
20221017,651,656,남양주,남춘천,2703,28,48,27,77,96,2979,2313,17,39,12,58,58,2497,
20221017,652,651,화도,남양주,16591,586,571,489,223,1274,19734,14378,565,513,434,264,1092,17246,
20221017,652,653,화도,서종,1465,36,29,39,29,112,1710,1547,34,34,30,24,115,1784,
20221017,652,654,화도,설악,1241,18,19,41,14,98,1431,1241,20,9,39,20,92,1421,
20221017,653,651,서종,남양주,1881,20,9,3,53,76,2042,1761,19,11,4,70,72,1937,
20221017,653,652,서종,화도,1547,34,34,30,24,115,1784,1465,36,29,39,29,112,1710,
20221017,654,651,설악,남양주,3681,21,56,13,26,144,3941,3864,32,70,17,30,156,4169,
20221017,654,652,설악,화도,1241,20,9,39,20,92,1421,1241,18,19,41,14,98,1431,
20221017,655,651,강촌,남양주,2513,35,107,24,35,97,2811,2353,35,125,21,27,76,2637,
20221017,656,651,남춘천,남양주,2313,17,39,12,58,58,2497,2703,28,48,27,77,96,2979,
20221017,671,672,봉담,정남,3330,161,83,164,159,232,4129,3807,173,80,162,167,263,4652,
20221017,671,673,봉담,북오산,1902,66,38,21,24,141,2192,1878,39,43,22,25,156,2163,
20221017,671,676,봉담,향남,1394,110,52,27,40,102,1725,1188,104,49,33,21,80,1475,
20221017,671,677,봉담,북평택,8474,199,242,169,275,471,9830,7377,176,221,147,222,466,8609,
20221017,672,671,정남,봉담,3807,173,80,162,167,263,4652,3330,161,83,164,159,232,4129,
20221017,673,101,북오산,서울,1542,35,120,15,22,102,1836,1556,40,126,21,9,111,1863,
20221017,673,671,북오산,봉담,1878,39,43,22,25,156,2163,1902,66,38,21,24,141,2192,
20221017,673,677,북오산,북평택,1894,34,65,30,41,140,2204,1951,34,55,27,37,122,2226,
20221017,675,676,서오산,향남,3538,122,83,59,21,227,4050,3086,95,62,43,21,207,3514,
20221017,675,677,서오산,북평택,12173,226,403,144,254,770,13970,10982,233,348,166,218,693,12640,
20221017,675,876,서오산,양감,1770,59,36,49,130,119,2163,2069,62,36,31,112,135,2445,
20221017,676,671,향남,봉담,1188,104,49,33,21,80,1475,1394,110,52,27,40,102,1725,
20221017,676,675,향남,서오산,3086,95,62,43,21,207,3514,3538,122,83,59,21,227,4050,
20221017,676,677,향남,북평택,1776,185,176,204,162,131,2634,1661,140,143,169,139,89,2341,
20221017,677,101,북평택,서울,1657,67,273,88,108,89,2282,1966,62,237,54,82,116,2517,
20221017,677,671,북평택,봉담,7377,176,221,147,222,466,8609,8474,199,242,169,275,471,9830,
20221017,677,673,북평택,북오산,1951,34,55,27,37,122,2226,1894,34,65,30,41,140,2204,
20221017,677,675,북평택,서오산,10982,233,348,166,218,693,12640,12173,226,403,144,254,770,13970,
20221017,677,676,북평택,향남,1661,140,143,169,139,89,2341,1776,185,176,204,162,131,2634,
20221017,677,876,북평택,양감,2361,146,151,197,173,158,3186,2044,141,183,206,151,137,2862,
20221017,682,683,조암,송산마도,776,87,92,54,67,43,1119,987,104,92,46,76,52,1357,
20221017,682,684,조암,남안산,1009,171,175,101,100,39,1595,1156,154,174,124,94,50,1752,
20221017,682,685,조암,서시흥,1759,189,176,160,254,85,2623,2274,170,201,179,306,109,3239,
20221017,683,682,송산마도,조암,987,104,92,46,76,52,1357,776,87,92,54,67,43,1119,
20221017,683,684,송산마도,남안산,2565,181,144,112,217,152,3371,2298,163,121,103,137,131,2953,
20221017,683,685,송산마도,서시흥,5070,312,252,214,847,266,6961,4697,268,249,192,831,261,6498,
20221017,684,682,남안산,조암,1156,154,174,124,94,50,1752,1009,171,175,101,100,39,1595,
20221017,684,683,남안산,송산마도,2298,163,121,103,137,131,2953,2565,181,144,112,217,152,3371,
20221017,684,685,남안산,서시흥,5275,480,291,382,566,371,7365,4077,373,314,324,373,326,5787,
20221017,685,682,서시흥,조암,2274,170,201,179,306,109,3239,1759,189,176,160,254,85,2623,
20221017,685,683,서시흥,송산마도,4697,268,249,192,831,261,6498,5070,312,252,214,847,266,6961,
20221017,685,684,서시흥,남안산,4077,373,314,324,373,326,5787,5275,480,291,382,566,371,7365,
20221017,705,190,남이천,동서울,1432,89,59,96,59,61,1796,1457,69,64,124,90,48,1852,
20221017,706,641,남경주,울산,1153,11,10,19,24,60,1277,1133,12,15,18,32,57,1267,
20221017,706,707,남경주,남포항,1008,37,61,26,235,58,1425,1078,40,63,35,189,61,1466,
20221017,707,641,남포항,울산,1106,18,21,33,120,74,1372,1155,19,29,12,136,68,1419,
20221017,707,706,남포항,남경주,1078,40,63,35,189,61,1466,1008,37,61,26,235,58,1425,
20221017,707,708,남포항,동경주,1429,27,26,22,233,78,1815,1364,25,23,23,282,84,1801,
20221017,708,707,동경주,남포항,1364,25,23,23,282,84,1801,1429,27,26,22,233,78,1815,
20221017,715,716,동안동,청송,1105,23,18,13,25,61,1245,1060,19,13,10,33,65,1200,
20221017,716,715,청송,동안동,1060,19,13,10,33,65,1200,1105,23,18,13,25,61,1245,
20221017,730,519,유천,남대구,2857,55,13,1,0,190,3116,2323,54,18,2,37,151,2585,
20221017,731,519,북현풍,남대구,1587,23,5,0,0,114,1729,1968,28,27,0,3,139,2165,
20221017,741,253,평택고덕,서서울,907,28,27,29,15,78,1084,1405,24,18,24,6,100,1577,
20221017,741,520,평택고덕,평택,754,11,168,16,22,70,1041,1017,16,201,18,19,84,1355,
20221017,741,540,평택고덕,청북,876,29,51,62,94,87,1199,879,16,35,56,79,88,1153,
20221017,742,107,남사진위,안성,1362,31,50,28,14,118,1603,1181,32,49,26,4,105,1397,
20221017,742,108,남사진위,천안,1054,29,29,26,7,75,1220,1050,24,31,19,7,72,1203,
20221017,752,252,기장철마,대동,1950,50,45,39,66,165,2315,1841,67,42,37,140,144,2271,
20221017,753,252,금정,대동,1196,68,74,59,71,87,1555,1923,121,99,84,139,104,2470,
20221017,755,140,광재,부산,971,17,17,8,27,55,1095,1104,18,22,10,22,66,1242,
20221017,755,252,광재,대동,2322,97,83,106,480,157,3245,2415,101,101,111,353,165,3246,
20221017,756,252,한림,대동,938,43,42,29,109,41,1202,901,42,46,27,92,41,1149,
20221017,757,289,진영,마산,794,56,49,38,67,54,1058,736,36,49,40,92,50,1003,
20221017,772,774,북달성,남칠곡,2408,51,46,42,28,137,2712,2442,44,51,55,35,135,2762,
20221017,773,774,북다사,남칠곡,1306,24,24,11,20,91,1476,1306,20,15,14,12,86,1453,
20221017,774,772,남칠곡,북달성,2442,44,51,55,35,135,2762,2408,51,46,42,28,137,2712,
20221017,774,773,남칠곡,북다사,1306,20,15,14,12,86,1453,1306,24,24,11,20,91,1476,
20221017,775,203,동명동호,가산,1551,57,43,49,164,72,1936,1600,45,40,51,245,82,2063,
20221017,776,777,연경,파군재,3391,48,20,16,61,208,3744,2482,34,28,17,52,170,2783,
20221017,776,779,연경,율암,5708,95,88,75,159,440,6565,6079,107,96,76,167,427,6952,
20221017,777,776,파군재,연경,2482,34,28,17,52,170,2783,3391,48,20,16,61,208,3744,
20221017,777,779,파군재,율암,2376,22,18,5,8,210,2639,2305,18,26,3,5,211,2568,
20221017,779,776,율암,연경,6079,107,96,76,167,427,6952,5708,95,88,75,159,440,6565,
20221017,779,777,율암,파군재,2305,18,26,3,5,211,2568,2376,22,18,5,8,210,2639,
20221017,876,675,양감,서오산,2069,62,36,31,112,135,2445,1770,59,36,49,130,119,2163,
20221017,876,677,양감,북평택,2044,141,183,206,151,137,2862,2361,146,151,197,173,158,3186,
20221017,981,982,서영암,강진무위사,1837,42,64,60,46,81,2130,1815,40,76,85,57,70,2143,
20221017,981,987,서영암,남순천,1551,30,73,65,282,58,2059,1900,35,81,86,304,63,2469,
20221017,982,981,강진무위사,서영암,1815,40,76,85,57,70,2143,1837,42,64,60,46,81,2130,
20221017,984,985,보성,벌교,1556,43,50,36,55,52,1792,1346,46,50,26,44,36,1548,
20221017,984,987,보성,남순천,1844,32,92,95,267,64,2394,2002,40,78,74,252,64,2510,
20221017,985,984,벌교,보성,1346,46,50,26,44,36,1548,1556,43,50,36,55,52,1792,
20221017,986,987,고흥,남순천,3486,61,102,147,239,141,4176,3946,74,116,127,238,159,4660,
20221017,987,981,남순천,서영암,1900,35,81,86,304,63,2469,1551,30,73,65,282,58,2059,
20221017,987,984,남순천,보성,2002,40,78,74,252,64,2510,1844,32,92,95,267,64,2394,
20221017,987,986,남순천,고흥,3946,74,116,127,238,159,4660,3486,61,102,147,239,141,4176,
20221018,101,102,서울,동수원,3770,55,270,14,5,211,4325,5204,54,385,23,10,287,5963,
20221018,101,103,서울,수원신갈,15853,685,1725,419,136,816,19634,15187,705,1718,373,120,718,18821,
20221018,101,105,서울,기흥,7223,111,383,80,27,332,8156,6072,111,353,100,25,311,6972,
20221018,101,106,서울,오산,4404,374,418,154,80,298,5728,4319,444,458,180,98,289,5788,
20221018,101,107,서울,안성,3304,88,324,48,17,180,3961,2811,75,314,59,25,164,3448,
20221018,101,108,서울,천안,3692,51,329,36,13,161,4282,3524,55,333,46,25,154,4137,
20221018,101,111,서울,청주,1009,14,165,32,22,34,1276,835,14,204,23,17,39,1132,
20221018,101,171,서울,마성,2130,31,262,46,6,125,2600,2501,22,312,47,6,126,3014,
20221018,101,172,서울,용인,3436,164,126,37,33,208,4004,4018,173,131,60,27,269,4678,
20221018,101,173,서울,양지,3442,227,133,112,83,140,4137,4289,392,149,164,109,184,5287,
20221018,101,175,서울,덕평,817,65,90,51,31,47,1101,788,119,90,40,32,27,1096,
20221018,101,229,서울,북천안,819,45,51,45,20,35,1015,790,61,45,61,28,30,1015,
20221018,101,528,서울,기흥동탄,7036,76,1165,127,13,338,8755,7207,56,1289,130,18,334,9034,
20221018,101,542,서울,서안성,1250,46,82,97,38,53,1566,1711,49,70,161,64,75,2130,
20221018,101,543,서울,남안성,1072,70,44,73,71,39,1369,1290,97,92,85,101,56,1721,
20221018,101,673,서울,북오산,1546,49,127,23,13,108,1866,1485,39,130,25,9,85,1773,
20221018,101,677,서울,북평택,1484,54,249,78,114,62,2041,1406,55,282,90,129,57,2019,
20221018,102,101,동수원,서울,5204,54,385,23,10,287,5963,3770,55,270,14,5,211,4325,
20221018,102,172,동수원,용인,1109,32,25,6,2,82,1256,1045,42,26,3,1,93,1210,
20221018,102,173,동수원,양지,1228,52,38,2,30,63,1413,1422,48,43,5,13,85,1616,
20221018,102,212,동수원,북수원,4411,38,237,26,48,234,4994,4603,43,250,31,24,269,5220,
20221018,102,213,동수원,부곡,1114,20,15,8,34,79,1270,1053,11,17,5,26,93,1205,
20221018,102,214,동수원,동군포,1645,25,20,10,5,100,1805,1524,24,20,9,4,97,1678,
20221018,102,215,동수원,군포,1613,28,26,13,24,103,1807,2311,14,46,5,11,169,2556,
20221018,102,253,동수원,서서울,5362,47,65,19,47,319,5859,5061,61,71,19,27,304,5543,
20221018,102,254,동수원,군자,3665,50,79,20,40,197,4051,3818,72,78,26,56,228,4278,
20221018,102,255,동수원,서안산,1724,44,12,12,4,94,1890,1880,39,23,13,3,96,2054,
20221018,103,101,수원신갈,서울,15187,705,1718,373,120,718,18821,15853,685,1725,419,136,816,19634,
20221018,103,105,수원신갈,기흥,1611,33,59,22,16,98,1839,2126,37,35,22,14,144,2378,
20221018,103,106,수원신갈,오산,1006,73,67,51,16,80,1293,1337,82,60,55,11,104,1649,
20221018,103,107,수원신갈,안성,849,15,46,12,3,75,1000,1035,19,42,10,2,61,1169,
20221018,103,108,수원신갈,천안,931,7,49,13,1,43,1044,1224,7,48,18,2,53,1352,
20221018,103,212,수원신갈,북수원,860,57,25,16,14,43,1015,1329,72,41,44,6,73,1565,
20221018,103,253,수원신갈,서서울,1853,129,75,55,19,121,2252,2107,131,79,89,28,124,2558,
20221018,103,254,수원신갈,군자,1402,97,72,79,92,95,1837,1627,134,76,131,120,104,2192,
20221018,103,528,수원신갈,기흥동탄,1451,15,189,3,2,101,1761,2061,19,157,2,1,118,2358,
20221018,105,101,기흥,서울,6072,111,353,100,25,311,6972,7223,111,383,80,27,332,8156,
20221018,105,103,기흥,수원신갈,2126,37,35,22,14,144,2378,1611,33,59,22,16,98,1839,
20221018,106,101,오산,서울,4319,444,458,180,98,289,5788,4404,374,418,154,80,298,5728,
20221018,106,103,오산,수원신갈,1337,82,60,55,11,104,1649,1006,73,67,51,16,80,1293,
20221018,106,107,오산,안성,1808,57,42,22,14,148,2091,1485,41,20,15,13,131,1705,
20221018,106,108,오산,천안,1042,33,31,18,12,72,1208,959,30,21,13,10,64,1097,
20221018,106,528,오산,기흥동탄,927,32,36,17,13,86,1111,1033,32,53,16,11,74,1219,
20221018,107,101,안성,서울,2811,75,314,59,25,164,3448,3304,88,324,48,17,180,3961,
20221018,107,103,안성,수원신갈,1035,19,42,10,2,61,1169,849,15,46,12,3,75,1000,
20221018,107,106,안성,오산,1485,41,20,15,13,131,1705,1808,57,42,22,14,148,2091,
20221018,107,108,안성,천안,1590,14,39,4,9,144,1800,1568,23,39,11,3,142,1786,
20221018,107,528,안성,기흥동탄,992,14,27,2,3,96,1134,1143,21,29,5,14,93,1305,
20221018,107,742,안성,남사진위,1204,34,53,22,8,96,1417,1491,57,58,25,10,124,1765,
20221018,108,101,천안,서울,3524,55,333,46,25,154,4137,3692,51,329,36,13,161,4282,
20221018,108,103,천안,수원신갈,1224,7,48,18,2,53,1352,931,7,49,13,1,43,1044,
20221018,108,106,천안,오산,959,30,21,13,10,64,1097,1042,33,31,18,12,72,1208,
20221018,108,107,천안,안성,1568,23,39,11,3,142,1786,1590,14,39,4,9,144,1800,
20221018,108,110,천안,목천,1152,24,66,31,102,77,1452,761,19,61,14,100,58,1013,
20221018,108,111,천안,청주,1046,38,72,28,36,78,1298,1014,25,48,28,39,67,1221,
20221018,108,229,천안,북천안,3518,70,131,57,33,224,4033,3888,84,123,50,54,261,4460,
20221018,108,528,천안,기흥동탄,1080,12,97,5,11,65,1270,1144,19,125,1,8,68,1365,
20221018,108,742,천안,남사진위,1014,30,35,18,4,72,1173,1094,29,32,26,10,73,1264,
20221018,110,108,목천,천안,761,19,61,14,100,58,1013,1152,24,66,31,102,77,1452,
20221018,111,101,청주,서울,835,14,204,23,17,39,1132,1009,14,165,32,22,34,1276,
20221018,111,108,청주,천안,1014,25,48,28,39,67,1221,1046,38,72,28,36,78,1298,
20221018,112,115,남청주,대전,1586,88,64,7,23,106,1874,1659,98,52,12,5,122,1948,
20221018,113,115,신탄진,대전,964,22,15,9,5,128,1143,1103,29,10,10,8,132,1292,
20221018,113,198,신탄진,서청주,823,36,42,56,43,58,1058,926,37,22,25,22,69,1101,
20221018,114,153,남대전,서대전,1888,41,58,62,87,148,2284,1710,44,94,67,86,123,2124,
20221018,115,112,대전,남청주,1659,98,52,12,5,122,1948,1586,88,64,7,23,106,1874,
20221018,115,113,대전,신탄진,1103,29,10,10,8,132,1292,964,22,15,9,5,128,1143,
20221018,115,116,대전,옥천,2274,102,40,26,19,181,2642,2058,53,45,34,30,165,2385,
20221018,115,151,대전,북대전,1098,15,18,3,9,125,1268,901,13,18,4,9,98,1043,
20221018,115,152,대전,유성,965,7,24,9,1,71,1077,930,10,23,5,1,63,1032,
20221018,115,153,대전,서대전,986,20,9,1,3,85,1104,932,24,8,1,2,78,1045,
20221018,115,198,대전,서청주,911,20,11,5,3,70,1020,923,18,12,5,1,75,1034,
20221018,115,579,대전,남세종,1004,16,24,8,15,88,1155,1157,11,28,6,22,86,1310,
20221018,116,115,옥천,대전,2058,53,45,34,30,165,2385,2274,102,40,26,19,181,2642,
20221018,119,153,판암,서대전,1773,25,17,95,7,139,2056,1819,29,23,91,11,157,2130,
20221018,123,127,구미,서대구,1670,25,43,23,12,100,1873,1707,33,45,19,12,102,1918,
20221018,123,129,구미,북대구,1864,14,55,3,5,105,2046,1965,16,64,8,3,106,2162,
20221018,123,130,구미,동김천,1170,23,42,26,28,68,1357,1152,22,29,21,21,66,1311,
20221018,125,127,남구미,서대구,1917,60,98,35,16,110,2236,2160,68,115,39,25,115,2522,
20221018,125,129,남구미,북대구,1858,26,71,9,10,109,2083,2001,30,75,16,7,132,2261,
20221018,126,127,왜관,서대구,2468,111,68,47,125,138,2957,2819,136,77,52,97,145,3326,
20221018,126,129,왜관,북대구,3027,103,60,23,79,146,3438,3345,111,79,26,80,164,3805,
20221018,127,123,서대구,구미,1707,33,45,19,12,102,1918,1670,25,43,23,12,100,1873,
20221018,127,125,서대구,남구미,2160,68,115,39,25,115,2522,1917,60,98,35,16,110,2236,
20221018,127,126,서대구,왜관,2819,136,77,52,97,145,3326,2468,111,68,47,125,138,2957,
20221018,127,131,서대구,경산,2574,208,142,113,81,171,3289,1835,146,110,82,65,117,2355,
20221018,127,203,서대구,가산,2169,66,73,49,123,96,2576,1956,56,65,48,149,94,2368,
20221018,127,230,서대구,팔공산,1441,49,49,13,4,89,1645,1045,38,32,16,7,66,1204,
20221018,127,518,서대구,칠곡물류,884,108,88,113,33,51,1277,720,101,71,95,26,50,1063,
20221018,127,621,서대구,동대구,1838,51,80,33,26,125,2153,1311,49,41,32,17,95,1545,
20221018,129,123,북대구,구미,1965,16,64,8,3,106,2162,1864,14,55,3,5,105,2046,
20221018,129,125,북대구,남구미,2001,30,75,16,7,132,2261,1858,26,71,9,10,109,2083,
20221018,129,126,북대구,왜관,3345,111,79,26,80,164,3805,3027,103,60,23,79,146,3438,
20221018,129,131,북대구,경산,2402,156,78,58,39,116,2849,3068,226,131,77,53,176,3731,
20221018,129,524,북대구,청통와촌,922,51,26,12,15,48,1074,1141,74,36,19,15,43,1328,
20221018,129,527,북대구,포항,1605,33,21,28,43,75,1805,1971,56,25,28,83,88,2251,
20221018,130,123,동김천,구미,1152,22,29,21,21,66,1311,1170,23,42,26,28,68,1357,
20221018,131,127,경산,서대구,1835,146,110,82,65,117,2355,2574,208,142,113,81,171,3289,
20221018,131,129,경산,북대구,3068,226,131,77,53,176,3731,2402,156,78,58,39,116,2849,
20221018,131,132,경산,영천,872,57,48,49,52,50,1128,878,55,61,34,29,50,1107,
20221018,131,230,경산,팔공산,1325,84,47,17,15,93,1581,1572,90,64,25,25,100,1876,
20221018,131,621,경산,동대구,2300,72,41,226,72,142,2853,2416,72,61,235,61,129,2974,
20221018,132,131,영천,경산,878,55,61,34,29,50,1107,872,57,48,49,52,50,1128,
20221018,132,621,영천,동대구,1124,11,23,5,43,47,1253,1145,15,19,3,45,47,1274,
20221018,135,140,경주,부산,1193,16,48,10,32,46,1345,1247,10,53,7,22,58,1397,
20221018,135,252,경주,대동,890,33,95,61,171,43,1293,1115,46,103,51,93,48,1456,
20221018,138,140,양산,부산,5157,254,187,291,258,275,6422,5344,320,213,308,235,317,6737,
20221018,138,252,양산,대동,2711,336,191,184,396,116,3934,2943,344,197,167,395,137,4183,
20221018,139,140,서울산,부산,1300,45,31,10,23,86,1495,1251,50,27,10,22,63,1423,
20221018,139,641,서울산,울산,1128,38,56,33,42,94,1391,944,18,47,22,26,68,1125,
20221018,140,135,부산,경주,1247,10,53,7,22,58,1397,1193,16,48,10,32,46,1345,
20221018,140,138,부산,양산,5344,320,213,308,235,317,6737,5157,254,187,291,258,275,6422,
20221018,140,139,부산,서울산,1251,50,27,10,22,63,1423,1300,45,31,10,23,86,1495,
20221018,140,250,부산,남양산,7914,165,222,80,43,685,9109,7805,148,222,83,53,650,8961,
20221018,140,251,부산,물금,1056,133,32,43,64,83,1411,1051,99,35,36,55,78,1354,
20221018,140,252,부산,대동,1680,37,60,43,84,96,2000,1579,41,41,43,147,90,1941,
20221018,140,755,부산,광재,1101,23,18,7,29,64,1242,962,22,14,11,41,64,1114,
20221018,142,145,군북,산인,3904,60,123,51,85,299,4522,3896,66,102,43,67,285,4459,
20221018,143,145,장지,산인,1227,23,24,26,33,95,1428,1184,23,29,31,45,91,1403,
20221018,144,145,함안,산인,1967,53,48,27,96,150,2341,1934,45,50,28,81,138,2276,
20221018,145,142,산인,군북,3896,66,102,43,67,285,4459,3904,60,123,51,85,299,4522,
20221018,145,143,산인,장지,1184,23,29,31,45,91,1403,1227,23,24,26,33,95,1428,
20221018,145,144,산인,함안,1934,45,50,28,81,138,2276,1967,53,48,27,96,150,2341,
20221018,145,291,산인,사천,1108,32,54,15,24,51,1284,1320,68,58,18,23,50,1537,
20221018,145,292,산인,진주,1432,32,144,13,20,86,1727,1489,40,138,17,22,91,1797,
20221018,145,293,산인,문산,1197,34,27,10,6,63,1337,1054,28,28,14,7,59,1190,
20221018,146,150,동창원,북부산,1005,19,14,4,28,63,1133,940,13,12,2,22,65,1054,
20221018,146,244,동창원,서부산,1248,30,37,25,28,70,1438,1271,30,34,18,51,76,1480,
20221018,146,245,동창원,장유,895,20,11,93,8,81,1108,967,12,14,98,9,88,1188,
20221018,146,289,동창원,마산,2606,83,58,87,83,239,3156,2509,78,62,92,56,222,3019,
20221018,147,150,진례,북부산,1377,38,25,17,42,80,1579,1663,49,25,16,27,90,1870,
20221018,147,244,진례,서부산,1743,92,70,63,103,88,2159,1901,110,80,64,99,94,2348,
20221018,147,245,진례,장유,1128,63,87,52,16,122,1468,1435,48,97,54,26,135,1795,
20221018,147,289,진례,마산,1235,92,87,55,110,67,1646,1320,101,82,55,85,79,1722,
20221018,148,150,서김해,북부산,6521,116,85,78,111,538,7449,6548,124,74,72,60,508,7386,
20221018,148,251,서김해,물금,948,43,21,34,11,87,1144,939,42,23,38,16,90,1148,
20221018,148,289,서김해,마산,1334,31,54,9,19,106,1553,1336,28,56,8,21,102,1551,
20221018,149,150,동김해,북부산,10630,208,190,35,94,921,12078,9255,182,141,23,72,764,10437,
20221018,149,250,동김해,남양산,1158,25,50,7,7,81,1328,1022,20,52,10,10,67,1181,
20221018,149,251,동김해,물금,1171,41,16,11,8,114,1361,1097,35,16,11,3,115,1277,
20221018,150,146,북부산,동창원,940,13,12,2,22,65,1054,1005,19,14,4,28,63,1133,
20221018,150,147,북부산,진례,1663,49,25,16,27,90,1870,1377,38,25,17,42,80,1579,
20221018,150,148,북부산,서김해,6548,124,74,72,60,508,7386,6521,116,85,78,111,538,7449,
20221018,150,149,북부산,동김해,9255,182,141,23,72,764,10437,10630,208,190,35,94,921,12078,
20221018,150,245,북부산,장유,3645,36,82,15,25,244,4047,3102,38,85,5,26,218,3474,
20221018,150,289,북부산,마산,2363,33,76,11,23,118,2624,2608,45,70,10,35,134,2902,
20221018,151,115,북대전,대전,901,13,18,4,9,98,1043,1098,15,18,3,9,125,1268,
20221018,151,153,북대전,서대전,1114,23,14,22,13,88,1274,1262,13,27,27,24,97,1450,
20221018,152,115,유성,대전,930,10,23,5,1,63,1032,965,7,24,9,1,71,1077,
20221018,152,154,유성,안영,965,23,27,13,19,76,1123,1014,22,23,8,18,71,1156,
20221018,153,114,서대전,남대전,1710,44,94,67,86,123,2124,1888,41,58,62,87,148,2284,
20221018,153,115,서대전,대전,932,24,8,1,2,78,1045,986,20,9,1,3,85,1104,
20221018,153,119,서대전,판암,1819,29,23,91,11,157,2130,1773,25,17,95,7,139,2056,
20221018,153,151,서대전,북대전,1262,13,27,27,24,97,1450,1114,23,14,22,13,88,1274,
20221018,153,154,서대전,안영,1073,38,32,111,55,71,1380,1123,30,43,107,51,66,1420,
20221018,153,579,서대전,남세종,1213,17,23,9,13,95,1370,992,17,21,14,26,78,1148,
20221018,154,152,안영,유성,1014,22,23,8,18,71,1156,965,23,27,13,19,76,1123,
20221018,154,153,안영,서대전,1123,30,43,107,51,66,1420,1073,38,32,111,55,71,1380,
20221018,159,167,서전주,광주,1348,69,69,55,46,39,1626,1247,64,61,42,41,46,1501,
20221018,166,167,장성,광주,2237,78,66,34,79,108,2602,2464,111,81,45,57,117,2875,
20221018,167,159,광주,서전주,1247,64,61,42,41,46,1501,1348,69,69,55,46,39,1626,
20221018,167,166,광주,장성,2464,111,81,45,57,117,2875,2237,78,66,34,79,108,2602,
20221018,167,567,광주,남고창,1209,31,52,19,28,48,1387,1356,27,55,18,28,53,1537,
20221018,171,101,마성,서울,2501,22,312,47,6,126,3014,2130,31,262,46,6,125,2600,
20221018,172,101,용인,서울,4018,173,131,60,27,269,4678,3436,164,126,37,33,208,4004,
20221018,172,102,용인,동수원,1045,42,26,3,1,93,1210,1109,32,25,6,2,82,1256,
20221018,172,173,용인,양지,1914,277,142,167,122,152,2774,1831,190,163,152,111,154,2601,
20221018,172,212,용인,북수원,981,45,23,20,17,63,1149,1092,60,24,21,24,78,1299,
20221018,172,253,용인,서서울,1032,43,25,27,18,51,1196,976,55,13,31,13,61,1149,
20221018,173,101,양지,서울,4289,392,149,164,109,184,5287,3442,227,133,112,83,140,4137,
20221018,173,102,양지,동수원,1422,48,43,5,13,85,1616,1228,52,38,2,30,63,1413,
20221018,173,172,양지,용인,1831,190,163,152,111,154,2601,1914,277,142,167,122,152,2774,
20221018,173,212,양지,북수원,1178,77,30,68,47,75,1475,1163,106,51,42,83,65,1510,
20221018,173,253,양지,서서울,1167,136,78,127,61,57,1626,928,135,64,103,42,43,1315,
20221018,173,254,양지,군자,759,124,90,197,213,43,1426,654,126,88,157,212,31,1268,
20221018,174,179,춘천,홍천,3145,71,83,70,41,305,3715,3021,75,88,73,33,301,3591,
20221018,174,216,춘천,횡성,1024,47,33,33,24,70,1231,1133,48,31,23,16,75,1326,
20221018,174,218,춘천,남원주,1042,28,68,14,22,77,1251,999,26,70,12,17,73,1197,
20221018,174,554,춘천,동홍천,1170,22,22,15,15,86,1330,1240,22,18,8,15,93,1396,
20221018,175,101,덕평,서울,788,119,90,40,32,27,1096,817,65,90,51,31,47,1101,
20221018,176,190,이천,동서울,1466,63,191,163,125,62,2070,1337,56,178,143,93,59,1866,
20221018,179,174,홍천,춘천,3021,75,88,73,33,301,3591,3145,71,83,70,41,305,3715,
20221018,184,189,대관령,강릉,1208,44,69,10,14,88,1433,1317,48,68,13,13,67,1526,
20221018,189,184,강릉,대관령,1317,48,68,13,13,67,1526,1208,44,69,10,14,88,1433,
20221018,190,176,동서울,이천,1337,56,178,143,93,59,1866,1466,63,191,163,125,62,2070,
20221018,190,191,동서울,경기광주,9614,613,450,374,269,643,11963,10018,655,435,374,299,683,12464,
20221018,190,192,동서울,곤지암,5483,486,243,170,117,353,6852,5519,488,172,195,95,375,6844,
20221018,190,193,동서울,일죽,2187,165,192,158,117,87,2906,2512,190,186,273,129,87,3377,
20221018,190,194,동서울,서이천,3771,528,271,247,142,225,5184,3247,443,233,223,123,173,4442,
20221018,190,705,동서울,남이천,1284,75,58,131,134,32,1714,1612,102,53,146,98,53,2064,
20221018,191,190,경기광주,동서울,10018,655,435,374,299,683,12464,9614,613,450,374,269,643,11963,
20221018,192,190,곤지암,동서울,5519,488,172,195,95,375,6844,5483,486,243,170,117,353,6852,
20221018,192,194,곤지암,서이천,1394,245,103,201,107,98,2148,1073,155,97,164,125,79,1693,
20221018,193,190,일죽,동서울,2512,190,186,273,129,87,3377,2187,165,192,158,117,87,2906,
20221018,194,190,서이천,동서울,3247,443,233,223,123,173,4442,3771,528,271,247,142,225,5184,
20221018,194,192,서이천,곤지암,1073,155,97,164,125,79,1693,1394,245,103,201,107,98,2148,
20221018,196,198,진천,서청주,1321,43,90,46,37,67,1604,1191,36,82,31,28,73,1441,
20221018,198,113,서청주,신탄진,926,37,22,25,22,69,1101,823,36,42,56,43,58,1058,
20221018,198,115,서청주,대전,923,18,12,5,1,75,1034,911,20,11,5,3,70,1020,
20221018,198,196,서청주,진천,1191,36,82,31,28,73,1441,1321,43,90,46,37,67,1604,
20221018,201,203,칠곡,가산,839,41,31,41,153,49,1154,885,48,42,34,163,49,1221,
20221018,203,127,가산,서대구,1956,56,65,48,149,94,2368,2169,66,73,49,123,96,2576,
20221018,203,201,가산,칠곡,885,48,42,34,163,49,1221,839,41,31,41,153,49,1154,
20221018,203,775,가산,동명동호,1721,62,69,50,232,70,2204,1755,64,46,47,187,76,2175,
20221018,212,102,북수원,동수원,4603,43,250,31,24,269,5220,4411,38,237,26,48,234,4994,
20221018,212,103,북수원,수원신갈,1329,72,41,44,6,73,1565,860,57,25,16,14,43,1015,
20221018,212,172,북수원,용인,1092,60,24,21,24,78,1299,981,45,23,20,17,63,1149,
20221018,212,173,북수원,양지,1163,106,51,42,83,65,1510,1178,77,30,68,47,75,1475,
20221018,212,253,북수원,서서울,2520,45,32,6,14,178,2795,1059,28,16,9,11,73,1196,
20221018,212,254,북수원,군자,1648,35,37,15,31,107,1873,1111,35,26,17,26,77,1292,
20221018,213,102,부곡,동수원,1053,11,17,5,26,93,1205,1114,20,15,8,34,79,1270,
20221018,213,253,부곡,서서울,1464,69,29,37,173,93,1865,1095,55,31,51,145,64,1441,
20221018,213,254,부곡,군자,952,40,30,43,492,69,1626,839,36,28,38,375,46,1362,
20221018,214,102,동군포,동수원,1524,24,20,9,4,97,1678,1645,25,20,10,5,100,1805,
20221018,215,102,군포,동수원,2311,14,46,5,11,169,2556,1613,28,26,13,24,103,1807,
20221018,215,253,군포,서서울,3089,77,65,42,68,220,3561,4342,213,163,204,189,288,5399,
20221018,215,254,군포,군자,2039,73,64,40,72,135,2423,2936,143,96,146,157,173,3651,
20221018,215,255,군포,서안산,1284,47,32,23,13,106,1505,1539,77,56,69,96,138,1975,
20221018,216,174,횡성,춘천,1133,48,31,23,16,75,1326,1024,47,33,33,24,70,1231,
20221018,218,174,남원주,춘천,999,26,70,12,17,73,1197,1042,28,68,14,22,77,1251,
20221018,218,240,남원주,제천,2084,51,50,23,59,138,2405,2111,61,52,22,45,137,2428,
20221018,225,291,서진주,사천,1015,14,16,10,33,52,1140,1016,15,22,13,27,61,1154,
20221018,229,101,북천안,서울,790,61,45,61,28,30,1015,819,45,51,45,20,35,1015,
20221018,229,108,북천안,천안,3888,84,123,50,54,261,4460,3518,70,131,57,33,224,4033,
20221018,230,127,팔공산,서대구,1045,38,32,16,7,66,1204,1441,49,49,13,4,89,1645,
20221018,230,131,팔공산,경산,1572,90,64,25,25,100,1876,1325,84,47,17,15,93,1581,
20221018,230,524,팔공산,청통와촌,1180,52,43,13,12,66,1366,1008,42,29,5,17,60,1161,
20221018,230,527,팔공산,포항,1446,37,26,11,14,62,1596,1267,29,13,12,19,56,1396,
20221018,231,519,화원옥포,남대구,6338,172,90,107,173,471,7351,6181,151,98,103,107,477,7117,
20221018,232,519,달성,남대구,2902,120,138,51,22,200,3433,2896,134,145,64,30,178,3447,
20221018,233,519,현풍,남대구,4888,214,207,77,126,357,5869,4355,207,175,105,119,329,5290,
20221018,238,239,칠서,칠원,1603,96,118,187,509,89,2602,1617,81,106,150,451,99,2504,
20221018,239,238,칠원,칠서,1617,81,106,150,451,99,2504,1603,96,118,187,509,89,2602,
20221018,239,519,칠원,남대구,991,46,80,42,91,35,1285,1162,62,92,52,73,43,1484,
20221018,240,218,제천,남원주,2111,61,52,22,45,137,2428,2084,51,50,23,59,138,2405,
20221018,241,519,동고령,남대구,3045,106,82,236,162,143,3774,2945,97,86,222,152,144,3646,
20221018,242,519,고령,남대구,1559,41,59,32,226,83,2000,1663,37,58,19,209,99,2085,
20221018,244,146,서부산,동창원,1271,30,34,18,51,76,1480,1248,30,37,25,28,70,1438,
20221018,244,147,서부산,진례,1901,110,80,64,99,94,2348,1743,92,70,63,103,88,2159,
20221018,244,245,서부산,장유,12838,236,384,142,340,966,14906,12341,232,389,153,416,963,14494,
20221018,244,289,서부산,마산,2728,58,244,38,95,168,3331,2702,71,231,46,78,163,3291,
20221018,245,146,장유,동창원,967,12,14,98,9,88,1188,895,20,11,93,8,81,1108,
20221018,245,147,장유,진례,1435,48,97,54,26,135,1795,1128,63,87,52,16,122,1468,
20221018,245,150,장유,북부산,3102,38,85,5,26,218,3474,3645,36,82,15,25,244,4047,
20221018,245,244,장유,서부산,12341,232,389,153,416,963,14494,12838,236,384,142,340,966,14906,
20221018,245,289,장유,마산,1293,30,40,11,26,110,1510,1322,30,44,16,11,91,1514,
20221018,248,261,순창,동광주,1062,24,27,8,11,35,1167,1172,29,39,15,12,52,1319,
20221018,250,140,남양산,부산,7805,148,222,83,53,650,8961,7914,165,222,80,43,685,9109,
20221018,250,149,남양산,동김해,1022,20,52,10,10,67,1181,1158,25,50,7,7,81,1328,
20221018,250,252,남양산,대동,3271,158,124,133,119,239,4044,4070,167,125,121,147,287,4917,
20221018,251,140,물금,부산,1051,99,35,36,55,78,1354,1056,133,32,43,64,83,1411,
20221018,251,148,물금,서김해,939,42,23,38,16,90,1148,948,43,21,34,11,87,1144,
20221018,251,149,물금,동김해,1097,35,16,11,3,115,1277,1171,41,16,11,8,114,1361,
20221018,251,252,물금,대동,3110,209,99,164,458,227,4267,3752,201,95,157,537,279,5021,
20221018,252,135,대동,경주,1115,46,103,51,93,48,1456,890,33,95,61,171,43,1293,
20221018,252,138,대동,양산,2943,344,197,167,395,137,4183,2711,336,191,184,396,116,3934,
20221018,252,140,대동,부산,1579,41,41,43,147,90,1941,1680,37,60,43,84,96,2000,
20221018,252,250,대동,남양산,4070,167,125,121,147,287,4917,3271,158,124,133,119,239,4044,
20221018,252,251,대동,물금,3752,201,95,157,537,279,5021,3110,209,99,164,458,227,4267,
20221018,252,641,대동,울산,1587,67,89,36,36,87,1902,1272,63,95,30,60,62,1582,
20221018,252,752,대동,기장철마,1692,56,42,38,104,123,2055,1798,60,61,31,56,148,2154,
20221018,252,753,대동,금정,1831,114,110,104,183,125,2467,1053,73,55,67,97,80,1425,
20221018,252,755,대동,광재,2388,114,94,97,318,150,3161,2336,117,107,103,501,142,3306,
20221018,252,756,대동,한림,915,42,37,28,84,46,1152,968,50,40,19,108,56,1241,
20221018,253,102,서서울,동수원,5061,61,71,19,27,304,5543,5362,47,65,19,47,319,5859,
20221018,253,103,서서울,수원신갈,2107,131,79,89,28,124,2558,1853,129,75,55,19,121,2252,
20221018,253,172,서서울,용인,976,55,13,31,13,61,1149,1032,43,25,27,18,51,1196,
20221018,253,173,서서울,양지,928,135,64,103,42,43,1315,1167,136,78,127,61,57,1626,
20221018,253,212,서서울,북수원,1059,28,16,9,11,73,1196,2520,45,32,6,14,178,2795,
20221018,253,213,서서울,부곡,1095,55,31,51,145,64,1441,1464,69,29,37,173,93,1865,
20221018,253,215,서서울,군포,4342,213,163,204,189,288,5399,3089,77,65,42,68,220,3561,
20221018,253,255,서서울,서안산,15269,566,596,581,352,867,18231,14530,532,492,490,332,910,17286,
20221018,253,256,서서울,안산,9078,151,105,51,45,650,10080,5899,95,70,33,63,422,6582,
20221018,253,281,서서울,매송,3530,59,34,17,19,210,3869,3918,73,35,27,89,235,4377,
20221018,253,282,서서울,비봉,4862,219,270,120,327,266,6064,5493,290,273,165,431,339,6991,
20221018,253,283,서서울,발안,3034,149,147,143,127,181,3781,3605,210,164,175,139,200,4493,
20221018,253,285,서서울,서평택,1420,59,98,232,348,87,2244,1508,105,124,359,501,90,2687,
20221018,253,287,서서울,송악,1532,31,57,65,198,53,1936,1784,56,78,112,443,78,2551,
20221018,253,288,서서울,당진,1145,23,48,28,21,63,1328,1291,34,52,57,57,61,1552,
20221018,253,298,서서울,서산,1749,25,69,57,31,67,1998,1899,26,65,68,68,78,2204,
20221018,253,520,서서울,평택,2065,113,117,166,152,88,2701,1957,125,124,242,159,88,2695,
20221018,253,540,서서울,청북,793,52,53,98,59,41,1096,813,66,50,110,91,33,1163,
20221018,253,741,서서울,평택고덕,975,32,18,17,12,82,1136,933,32,17,26,10,64,1082,
20221018,254,102,군자,동수원,3818,72,78,26,56,228,4278,3665,50,79,20,40,197,4051,
20221018,254,103,군자,수원신갈,1627,134,76,131,120,104,2192,1402,97,72,79,92,95,1837,
20221018,254,173,군자,양지,654,126,88,157,212,31,1268,759,124,90,197,213,43,1426,
20221018,254,212,군자,북수원,1111,35,26,17,26,77,1292,1648,35,37,15,31,107,1873,
20221018,254,213,군자,부곡,839,36,28,38,375,46,1362,952,40,30,43,492,69,1626,
20221018,254,215,군자,군포,2936,143,96,146,157,173,3651,2039,73,64,40,72,135,2423,
20221018,254,255,군자,서안산,10051,426,242,236,314,668,11937,9707,452,230,201,288,610,11488,
20221018,254,256,군자,안산,4624,124,118,51,74,354,5345,4996,111,118,51,61,396,5733,
20221018,254,281,군자,매송,990,47,20,24,65,76,1222,962,26,8,19,55,64,1134,
20221018,254,282,군자,비봉,1211,117,89,91,242,89,1839,1050,117,75,63,207,75,1587,
20221018,254,283,군자,발안,1137,100,69,65,170,70,1611,1043,106,62,67,110,67,1455,
20221018,255,102,서안산,동수원,1880,39,23,13,3,96,2054,1724,44,12,12,4,94,1890,
20221018,255,215,서안산,군포,1539,77,56,69,96,138,1975,1284,47,32,23,13,106,1505,
20221018,255,253,서안산,서서울,14530,532,492,490,332,910,17286,15269,566,596,581,352,867,18231,
20221018,255,254,서안산,군자,9707,452,230,201,288,610,11488,10051,426,242,236,314,668,11937,
20221018,256,253,안산,서서울,5899,95,70,33,63,422,6582,9078,151,105,51,45,650,10080,
20221018,256,254,안산,군자,4996,111,118,51,61,396,5733,4624,124,118,51,74,354,5345,
20221018,261,248,동광주,순창,1172,29,39,15,12,52,1319,1062,24,27,8,11,35,1167,
20221018,271,569,순천,북광주,837,59,53,22,159,25,1155,831,55,64,34,131,25,1140,
20221018,280,519,거창,남대구,910,24,43,7,4,50,1038,903,26,53,7,9,48,1046,
20221018,281,253,매송,서서울,3918,73,35,27,89,235,4377,3530,59,34,17,19,210,3869,
20221018,281,254,매송,군자,962,26,8,19,55,64,1134,990,47,20,24,65,76,1222,
20221018,282,253,비봉,서서울,5493,290,273,165,431,339,6991,4862,219,270,120,327,266,6064,
20221018,282,254,비봉,군자,1050,117,75,63,207,75,1587,1211,117,89,91,242,89,1839,
20221018,283,253,발안,서서울,3605,210,164,175,139,200,4493,3034,149,147,143,127,181,3781,
20221018,283,254,발안,군자,1043,106,62,67,110,67,1455,1137,100,69,65,170,70,1611,
20221018,285,253,서평택,서서울,1508,105,124,359,501,90,2687,1420,59,98,232,348,87,2244,
20221018,285,287,서평택,송악,654,26,88,71,666,38,1543,701,45,82,71,576,47,1522,
20221018,285,520,서평택,평택,677,41,62,66,108,67,1021,699,21,49,69,111,69,1018,
20221018,287,253,송악,서서울,1784,56,78,112,443,78,2551,1532,31,57,65,198,53,1936,
20221018,287,285,송악,서평택,701,45,82,71,576,47,1522,654,26,88,71,666,38,1543,
20221018,288,253,당진,서서울,1291,34,52,57,57,61,1552,1145,23,48,28,21,63,1328,
20221018,289,146,마산,동창원,2509,78,62,92,56,222,3019,2606,83,58,87,83,239,3156,
20221018,289,147,마산,진례,1320,101,82,55,85,79,1722,1235,92,87,55,110,67,1646,
20221018,289,148,마산,서김해,1336,28,56,8,21,102,1551,1334,31,54,9,19,106,1553,
20221018,289,150,마산,북부산,2608,45,70,10,35,134,2902,2363,33,76,11,23,118,2624,
20221018,289,244,마산,서부산,2702,71,231,46,78,163,3291,2728,58,244,38,95,168,3331,
20221018,289,245,마산,장유,1322,30,44,16,11,91,1514,1293,30,40,11,26,110,1510,
20221018,291,145,사천,산인,1320,68,58,18,23,50,1537,1108,32,54,15,24,51,1284,
20221018,291,225,사천,서진주,1016,15,22,13,27,61,1154,1015,14,16,10,33,52,1140,
20221018,291,292,사천,진주,2814,68,87,63,59,251,3342,3366,104,107,61,55,293,3986,
20221018,292,145,진주,산인,1489,40,138,17,22,91,1797,1432,32,144,13,20,86,1727,
20221018,292,291,진주,사천,3366,104,107,61,55,293,3986,2814,68,87,63,59,251,3342,
20221018,293,145,문산,산인,1054,28,28,14,7,59,1190,1197,34,27,10,6,63,1337,
20221018,298,253,서산,서서울,1899,26,65,68,68,78,2204,1749,25,69,57,31,67,1998,
20221018,508,509,무안,목포,1301,50,44,30,61,62,1548,1618,52,53,35,70,87,1915,
20221018,508,553,무안,동광산,1452,28,26,19,27,53,1605,1535,26,29,23,35,62,1710,
20221018,509,508,목포,무안,1618,52,53,35,70,87,1915,1301,50,44,30,61,62,1548,
20221018,509,553,목포,동광산,6451,182,198,172,413,255,7671,6712,170,225,215,452,244,8018,
20221018,513,515,고성,북통영,1289,28,81,12,29,91,1530,1392,39,79,17,26,97,1650,
20221018,513,516,고성,통영,2761,90,130,99,167,210,3457,2714,87,129,82,149,199,3360,
20221018,514,516,동고성,통영,1183,25,55,45,127,134,1569,1176,15,58,52,138,133,1572,
20221018,515,513,북통영,고성,1392,39,79,17,26,97,1650,1289,28,81,12,29,91,1530,
20221018,516,513,통영,고성,2714,87,129,82,149,199,3360,2761,90,130,99,167,210,3457,
20221018,516,514,통영,동고성,1176,15,58,52,138,133,1572,1183,25,55,45,127,134,1569,
20221018,518,127,칠곡물류,서대구,720,101,71,95,26,50,1063,884,108,88,113,33,51,1277,
20221018,519,231,남대구,화원옥포,6181,151,98,103,107,477,7117,6338,172,90,107,173,471,7351,
20221018,519,232,남대구,달성,2896,134,145,64,30,178,3447,2902,120,138,51,22,200,3433,
20221018,519,233,남대구,현풍,4355,207,175,105,119,329,5290,4888,214,207,77,126,357,5869,
20221018,519,239,남대구,칠원,1162,62,92,52,73,43,1484,991,46,80,42,91,35,1285,
20221018,519,241,남대구,동고령,2945,97,86,222,152,144,3646,3045,106,82,236,162,143,3774,
20221018,519,242,남대구,고령,1663,37,58,19,209,99,2085,1559,41,59,32,226,83,2000,
20221018,519,280,남대구,거창,903,26,53,7,9,48,1046,910,24,43,7,4,50,1038,
20221018,519,730,남대구,유천,2397,61,19,2,14,174,2667,2908,59,12,0,0,212,3191,
20221018,519,731,남대구,북현풍,1908,32,32,0,0,118,2090,1447,22,6,0,0,107,1582,
20221018,520,253,평택,서서울,1957,125,124,242,159,88,2695,2065,113,117,166,152,88,2701,
20221018,520,285,평택,서평택,699,21,49,69,111,69,1018,677,41,62,66,108,67,1021,
20221018,520,540,평택,청북,1087,99,156,148,104,57,1651,840,102,148,155,111,40,1396,
20221018,520,741,평택,평택고덕,838,18,206,22,10,78,1172,774,17,170,20,20,72,1073,
20221018,524,129,청통와촌,북대구,1141,74,36,19,15,43,1328,922,51,26,12,15,48,1074,
20221018,524,230,청통와촌,팔공산,1008,42,29,5,17,60,1161,1180,52,43,13,12,66,1366,
20221018,526,527,서포항,포항,871,14,20,6,34,68,1013,975,11,20,6,21,80,1113,
20221018,527,129,포항,북대구,1971,56,25,28,83,88,2251,1605,33,21,28,43,75,1805,
20221018,527,230,포항,팔공산,1267,29,13,12,19,56,1396,1446,37,26,11,14,62,1596,
20221018,527,526,포항,서포항,975,11,20,6,21,80,1113,871,14,20,6,34,68,1013,
20221018,528,101,기흥동탄,서울,7207,56,1289,130,18,334,9034,7036,76,1165,127,13,338,8755,
20221018,528,103,기흥동탄,수원신갈,2061,19,157,2,1,118,2358,1451,15,189,3,2,101,1761,
20221018,528,106,기흥동탄,오산,1033,32,53,16,11,74,1219,927,32,36,17,13,86,1111,
20221018,528,107,기흥동탄,안성,1143,21,29,5,14,93,1305,992,14,27,2,3,96,1134,
20221018,528,108,기흥동탄,천안,1144,19,125,1,8,68,1365,1080,12,97,5,11,65,1270,
20221018,540,253,청북,서서울,813,66,50,110,91,33,1163,793,52,53,98,59,41,1096,
20221018,540,520,청북,평택,840,102,148,155,111,40,1396,1087,99,156,148,104,57,1651,
20221018,540,741,청북,평택고덕,904,27,36,70,13,82,1132,977,35,57,87,39,100,1295,
20221018,542,101,서안성,서울,1711,49,70,161,64,75,2130,1250,46,82,97,38,53,1566,
20221018,542,543,서안성,남안성,1063,48,89,118,102,95,1515,1128,54,92,128,91,98,1591,
20221018,543,101,남안성,서울,1290,97,92,85,101,56,1721,1072,70,44,73,71,39,1369,
20221018,543,542,남안성,서안성,1128,54,92,128,91,98,1591,1063,48,89,118,102,95,1515,
20221018,543,555,남안성,북진천,811,108,160,191,156,39,1465,803,112,149,169,181,39,1453,
20221018,548,553,북무안,동광산,1148,27,33,34,22,33,1297,1388,26,37,29,24,41,1545,
20221018,549,553,동함평,동광산,3141,52,73,36,76,112,3490,3204,52,78,39,67,109,3549,
20221018,551,553,나주,동광산,1236,21,34,90,38,63,1482,1259,12,38,77,38,53,1477,
20221018,552,553,서광산,동광산,4320,185,177,228,209,181,5300,5884,204,212,241,155,251,6947,
20221018,553,508,동광산,무안,1535,26,29,23,35,62,1710,1452,28,26,19,27,53,1605,
20221018,553,509,동광산,목포,6712,170,225,215,452,244,8018,6451,182,198,172,413,255,7671,
20221018,553,548,동광산,북무안,1388,26,37,29,24,41,1545,1148,27,33,34,22,33,1297,
20221018,553,549,동광산,동함평,3204,52,78,39,67,109,3549,3141,52,73,36,76,112,3490,
20221018,553,551,동광산,나주,1259,12,38,77,38,53,1477,1236,21,34,90,38,63,1482,
20221018,553,552,동광산,서광산,5884,204,212,241,155,251,6947,4320,185,177,228,209,181,5300,
20221018,554,174,동홍천,춘천,1240,22,18,8,15,93,1396,1170,22,22,15,15,86,1330,
20221018,555,543,북진천,남안성,803,112,149,169,181,39,1453,811,108,160,191,156,39,1465,
20221018,567,167,남고창,광주,1356,27,55,18,28,53,1537,1209,31,52,19,28,48,1387,
20221018,569,271,북광주,순천,831,55,64,34,131,25,1140,837,59,53,22,159,25,1155,
20221018,579,115,남세종,대전,1157,11,28,6,22,86,1310,1004,16,24,8,15,88,1155,
20221018,579,153,남세종,서대전,992,17,21,14,26,78,1148,1213,17,23,9,13,95,1370,
20221018,587,589,오수,상관,1052,21,56,29,58,38,1254,1152,22,52,37,144,47,1454,
20221018,589,587,상관,오수,1152,22,52,37,144,47,1454,1052,21,56,29,58,38,1254,
20221018,597,598,서여주,북여주,1107,43,130,37,52,55,1424,928,39,69,37,49,55,1177,
20221018,598,597,북여주,서여주,928,39,69,37,49,55,1177,1107,43,130,37,52,55,1424,
20221018,621,127,동대구,서대구,1311,49,41,32,17,95,1545,1838,51,80,33,26,125,2153,
20221018,621,131,동대구,경산,2416,72,61,235,61,129,2974,2300,72,41,226,72,142,2853,
20221018,621,132,동대구,영천,1145,15,19,3,45,47,1274,1124,11,23,5,43,47,1253,
20221018,625,626,밀양,남밀양,1175,68,68,53,50,68,1482,1063,57,77,36,65,62,1360,
20221018,626,625,남밀양,밀양,1063,57,77,36,65,62,1360,1175,68,68,53,50,68,1482,
20221018,626,627,남밀양,삼랑진,980,27,30,16,58,115,1226,976,31,27,18,50,100,1202,
20221018,627,626,삼랑진,남밀양,976,31,27,18,50,100,1202,980,27,30,16,58,115,1226,
20221018,641,139,울산,서울산,944,18,47,22,26,68,1125,1128,38,56,33,42,94,1391,
20221018,641,252,울산,대동,1272,63,95,30,60,62,1582,1587,67,89,36,36,87,1902,
20221018,641,643,울산,청량,1198,11,15,18,78,99,1419,1294,9,17,11,33,122,1486,
20221018,641,706,울산,남경주,1092,8,24,11,25,63,1223,1124,10,21,12,25,68,1260,
20221018,641,707,울산,남포항,1073,12,28,20,123,53,1309,1119,21,26,34,100,59,1359,
20221018,643,641,청량,울산,1294,9,17,11,33,122,1486,1198,11,15,18,78,99,1419,
20221018,643,648,청량,해운대,2937,12,57,18,93,182,3299,3209,25,87,40,450,179,3990,
20221018,645,648,장안,해운대,1601,12,13,4,19,121,1770,2932,35,30,249,145,194,3585,
20221018,646,648,기장일광,해운대,4748,30,36,104,55,271,5244,5390,48,43,16,176,320,5993,
20221018,648,643,해운대,청량,3209,25,87,40,450,179,3990,2937,12,57,18,93,182,3299,
20221018,648,645,해운대,장안,2932,35,30,249,145,194,3585,1601,12,13,4,19,121,1770,
20221018,648,646,해운대,기장일광,5390,48,43,16,176,320,5993,4748,30,36,104,55,271,5244,
20221018,651,652,남양주,화도,14451,577,583,502,313,1115,17541,16085,568,628,533,258,1223,19295,
20221018,651,653,남양주,서종,1802,20,16,4,65,84,1991,1888,22,17,6,53,83,2069,
20221018,651,654,남양주,설악,3495,47,73,23,24,124,3786,3429,35,75,16,14,129,3698,
20221018,651,655,남양주,강촌,2405,45,111,26,32,74,2693,2317,39,116,25,26,72,2595,
20221018,651,656,남양주,남춘천,2590,33,54,39,56,88,2860,2052,22,33,15,52,51,2225,
20221018,652,651,화도,남양주,16085,568,628,533,258,1223,19295,14451,577,583,502,313,1115,17541,
20221018,652,653,화도,서종,1445,32,17,41,15,113,1663,1543,36,24,36,11,115,1765,
20221018,652,654,화도,설악,1151,17,16,7,28,70,1289,1248,21,9,8,30,64,1380,
20221018,653,651,서종,남양주,1888,22,17,6,53,83,2069,1802,20,16,4,65,84,1991,
20221018,653,652,서종,화도,1543,36,24,36,11,115,1765,1445,32,17,41,15,113,1663,
20221018,654,651,설악,남양주,3429,35,75,16,14,129,3698,3495,47,73,23,24,124,3786,
20221018,654,652,설악,화도,1248,21,9,8,30,64,1380,1151,17,16,7,28,70,1289,
20221018,655,651,강촌,남양주,2317,39,116,25,26,72,2595,2405,45,111,26,32,74,2693,
20221018,656,651,남춘천,남양주,2052,22,33,15,52,51,2225,2590,33,54,39,56,88,2860,
20221018,671,672,봉담,정남,3628,159,107,72,127,236,4329,3868,154,92,68,179,279,4640,
20221018,671,673,봉담,북오산,1943,56,53,17,25,149,2243,1888,49,41,23,20,172,2193,
20221018,671,676,봉담,향남,1244,102,40,38,25,84,1533,1293,102,41,27,21,103,1587,
20221018,671,677,봉담,북평택,6856,191,253,174,308,410,8192,7445,179,214,151,228,429,8646,
20221018,672,671,정남,봉담,3868,154,92,68,179,279,4640,3628,159,107,72,127,236,4329,
20221018,673,101,북오산,서울,1485,39,130,25,9,85,1773,1546,49,127,23,13,108,1866,
20221018,673,671,북오산,봉담,1888,49,41,23,20,172,2193,1943,56,53,17,25,149,2243,
20221018,673,677,북오산,북평택,1654,31,71,22,25,126,1929,1994,32,50,31,21,132,2260,
20221018,675,676,서오산,향남,3317,111,80,48,34,239,3829,3316,96,65,28,27,212,3744,
20221018,675,677,서오산,북평택,11125,203,411,185,192,687,12803,11240,238,370,197,187,734,12966,
20221018,675,876,서오산,양감,1699,63,32,63,24,118,1999,2146,67,36,52,33,162,2496,
20221018,676,671,향남,봉담,1293,102,41,27,21,103,1587,1244,102,40,38,25,84,1533,
20221018,676,675,향남,서오산,3316,96,65,28,27,212,3744,3317,111,80,48,34,239,3829,
20221018,676,677,향남,북평택,1773,167,190,220,162,105,2617,1483,148,167,203,140,87,2228,
20221018,677,101,북평택,서울,1406,55,282,90,129,57,2019,1484,54,249,78,114,62,2041,
20221018,677,671,북평택,봉담,7445,179,214,151,228,429,8646,6856,191,253,174,308,410,8192,
20221018,677,673,북평택,북오산,1994,32,50,31,21,132,2260,1654,31,71,22,25,126,1929,
20221018,677,675,북평택,서오산,11240,238,370,197,187,734,12966,11125,203,411,185,192,687,12803,
20221018,677,676,북평택,향남,1483,148,167,203,140,87,2228,1773,167,190,220,162,105,2617,
20221018,677,876,북평택,양감,2205,139,186,373,189,145,3237,2206,158,212,420,181,169,3346,
20221018,682,683,조암,송산마도,809,89,84,104,66,33,1185,1058,111,111,109,70,43,1502,
20221018,682,684,조암,남안산,1038,176,197,115,105,43,1674,1083,172,165,119,84,37,1660,
20221018,682,685,조암,서시흥,1822,210,171,176,281,92,2752,1849,176,183,189,319,105,2821,
20221018,683,682,송산마도,조암,1058,111,111,109,70,43,1502,809,89,84,104,66,33,1185,
20221018,683,684,송산마도,남안산,2604,231,175,141,242,147,3540,2189,191,139,114,145,133,2911,
20221018,683,685,송산마도,서시흥,5201,331,221,215,939,260,7167,4415,264,215,196,901,224,6215,
20221018,684,682,남안산,조암,1083,172,165,119,84,37,1660,1038,176,197,115,105,43,1674,
20221018,684,683,남안산,송산마도,2189,191,139,114,145,133,2911,2604,231,175,141,242,147,3540,
20221018,684,685,남안산,서시흥,5655,513,279,450,568,422,7887,4728,368,294,392,433,322,6537,
20221018,685,682,서시흥,조암,1849,176,183,189,319,105,2821,1822,210,171,176,281,92,2752,
20221018,685,683,서시흥,송산마도,4415,264,215,196,901,224,6215,5201,331,221,215,939,260,7167,
20221018,685,684,서시흥,남안산,4728,368,294,392,433,322,6537,5655,513,279,450,568,422,7887,
20221018,705,190,남이천,동서울,1612,102,53,146,98,53,2064,1284,75,58,131,134,32,1714,
20221018,706,641,남경주,울산,1124,10,21,12,25,68,1260,1092,8,24,11,25,63,1223,
20221018,706,707,남경주,남포항,961,29,71,42,251,56,1410,1059,28,78,38,201,59,1463,
20221018,707,641,남포항,울산,1119,21,26,34,100,59,1359,1073,12,28,20,123,53,1309,
20221018,707,706,남포항,남경주,1059,28,78,38,201,59,1463,961,29,71,42,251,56,1410,
20221018,707,708,남포항,동경주,1287,21,22,26,266,85,1707,1354,23,30,23,320,88,1838,
20221018,708,707,동경주,남포항,1354,23,30,23,320,88,1838,1287,21,22,26,266,85,1707,
20221018,715,716,동안동,청송,1149,21,19,17,11,58,1275,1121,16,13,15,14,64,1243,
20221018,716,715,청송,동안동,1121,16,13,15,14,64,1243,1149,21,19,17,11,58,1275,
20221018,730,519,유천,남대구,2908,59,12,0,0,212,3191,2397,61,19,2,14,174,2667,
20221018,731,519,북현풍,남대구,1447,22,6,0,0,107,1582,1908,32,32,0,0,118,2090,
20221018,741,253,평택고덕,서서울,933,32,17,26,10,64,1082,975,32,18,17,12,82,1136,
20221018,741,520,평택고덕,평택,774,17,170,20,20,72,1073,838,18,206,22,10,78,1172,
20221018,741,540,평택고덕,청북,977,35,57,87,39,100,1295,904,27,36,70,13,82,1132,
20221018,742,107,남사진위,안성,1491,57,58,25,10,124,1765,1204,34,53,22,8,96,1417,
20221018,742,108,남사진위,천안,1094,29,32,26,10,73,1264,1014,30,35,18,4,72,1173,
20221018,752,252,기장철마,대동,1798,60,61,31,56,148,2154,1692,56,42,38,104,123,2055,
20221018,753,252,금정,대동,1053,73,55,67,97,80,1425,1831,114,110,104,183,125,2467,
20221018,755,140,광재,부산,962,22,14,11,41,64,1114,1101,23,18,7,29,64,1242,
20221018,755,252,광재,대동,2336,117,107,103,501,142,3306,2388,114,94,97,318,150,3161,
20221018,756,252,한림,대동,968,50,40,19,108,56,1241,915,42,37,28,84,46,1152,
20221018,772,774,북달성,남칠곡,2503,50,61,37,19,128,2798,2607,57,52,41,19,148,2924,
20221018,773,774,북다사,남칠곡,1341,24,16,12,25,84,1502,1289,26,17,16,14,82,1444,
20221018,774,772,남칠곡,북달성,2607,57,52,41,19,148,2924,2503,50,61,37,19,128,2798,
20221018,774,773,남칠곡,북다사,1289,26,17,16,14,82,1444,1341,24,16,12,25,84,1502,
20221018,775,203,동명동호,가산,1755,64,46,47,187,76,2175,1721,62,69,50,232,70,2204,
20221018,776,777,연경,파군재,3311,48,42,16,28,232,3677,2487,39,53,15,22,165,2781,
20221018,776,779,연경,율암,5686,106,79,76,117,419,6483,5967,105,80,71,131,446,6800,
20221018,777,776,파군재,연경,2487,39,53,15,22,165,2781,3311,48,42,16,28,232,3677,
20221018,777,779,파군재,율암,2503,18,20,6,5,213,2765,2469,13,24,5,3,209,2723,
20221018,779,776,율암,연경,5967,105,80,71,131,446,6800,5686,106,79,76,117,419,6483,
20221018,779,777,율암,파군재,2469,13,24,5,3,209,2723,2503,18,20,6,5,213,2765,
20221018,876,675,양감,서오산,2146,67,36,52,33,162,2496,1699,63,32,63,24,118,1999,
20221018,876,677,양감,북평택,2206,158,212,420,181,169,3346,2205,139,186,373,189,145,3237,
20221018,981,982,서영암,강진무위사,1846,40,102,61,62,71,2182,1689,40,95,78,62,73,2037,
20221018,981,987,서영암,남순천,1419,29,88,83,357,37,2013,1411,34,97,110,386,53,2091,
20221018,982,981,강진무위사,서영암,1689,40,95,78,62,73,2037,1846,40,102,61,62,71,2182,
20221018,984,985,보성,벌교,1383,53,47,48,62,40,1633,1337,53,54,33,50,42,1569,
20221018,984,987,보성,남순천,1773,40,91,69,321,45,2339,1850,39,87,64,279,55,2374,
20221018,985,984,벌교,보성,1337,53,54,33,50,42,1569,1383,53,47,48,62,40,1633,
20221018,986,987,고흥,남순천,3273,60,86,131,264,132,3946,3667,73,98,153,276,156,4423,
20221018,987,981,남순천,서영암,1411,34,97,110,386,53,2091,1419,29,88,83,357,37,2013,
20221018,987,984,남순천,보성,1850,39,87,64,279,55,2374,1773,40,91,69,321,45,2339,
20221018,987,986,남순천,고흥,3667,73,98,153,276,156,4423,3273,60,86,131,264,132,3946,
20221019,101,102,서울,동수원,3755,54,276,11,2,214,4312,5397,67,405,23,13,297,6202,
20221019,101,103,서울,수원신갈,15850,642,1718,422,128,823,19583,14932,677,1694,395,103,747,18548,
20221019,101,105,서울,기흥,7304,102,379,69,29,343,8226,6087,95,368,88,46,280,6964,
20221019,101,106,서울,오산,4390,367,447,170,65,305,5744,4447,451,481,195,93,293,5960,
20221019,101,107,서울,안성,3398,90,307,38,18,194,4045,2868,80,291,46,25,139,3449,
20221019,101,108,서울,천안,3594,66,360,35,17,164,4236,3506,57,352,35,19,141,4110,
20221019,101,111,서울,청주,986,20,182,28,25,43,1284,756,13,210,24,24,38,1065,
20221019,101,171,서울,마성,2180,32,258,45,2,120,2637,2561,19,292,51,5,139,3067,
20221019,101,172,서울,용인,3463,123,138,42,18,191,3975,3901,134,148,61,41,243,4528,
20221019,101,173,서울,양지,3649,233,144,112,88,138,4364,4464,402,150,157,100,192,5465,
20221019,101,175,서울,덕평,767,71,83,39,13,42,1015,816,126,85,33,25,34,1119,
20221019,101,229,서울,북천안,842,55,54,47,27,35,1060,917,58,42,58,27,40,1142,
20221019,101,528,서울,기흥동탄,7189,83,1206,136,19,345,8978,7603,78,1310,135,12,375,9513,
20221019,101,542,서울,서안성,1248,41,90,102,26,64,1571,1760,64,77,175,51,96,2223,
20221019,101,543,서울,남안성,1248,57,74,76,75,37,1567,1309,94,97,104,95,42,1741,
20221019,101,673,서울,북오산,1709,40,111,22,15,99,1996,1609,43,117,21,17,110,1917,
20221019,101,677,서울,북평택,1730,66,295,75,126,98,2390,1771,61,282,100,147,77,2438,
20221019,102,101,동수원,서울,5397,67,405,23,13,297,6202,3755,54,276,11,2,214,4312,
20221019,102,172,동수원,용인,1152,20,18,4,3,87,1284,1031,27,18,6,2,93,1177,
20221019,102,173,동수원,양지,1221,40,28,5,22,81,1397,1417,44,33,9,0,90,1593,
20221019,102,212,동수원,북수원,4444,31,233,70,46,256,5080,4668,39,237,71,20,257,5292,
20221019,102,213,동수원,부곡,1068,12,13,4,32,90,1219,1026,20,15,4,25,76,1166,
20221019,102,214,동수원,동군포,1549,25,19,7,6,106,1712,1594,24,20,12,8,116,1774,
20221019,102,215,동수원,군포,1648,22,21,5,19,109,1824,2273,23,47,5,13,170,2531,
20221019,102,253,동수원,서서울,5737,61,58,20,38,353,6267,4979,67,61,18,34,304,5463,
20221019,102,254,동수원,군자,3801,56,80,29,36,204,4206,3950,63,68,32,45,232,4390,
20221019,102,255,동수원,서안산,1742,37,15,11,6,109,1920,1968,35,21,11,7,111,2153,
20221019,103,101,수원신갈,서울,14932,677,1694,395,103,747,18548,15850,642,1718,422,128,823,19583,
20221019,103,105,수원신갈,기흥,1681,20,58,47,14,115,1935,2193,32,33,38,15,134,2445,
20221019,103,106,수원신갈,오산,1041,77,53,60,18,90,1339,1378,66,60,74,10,79,1667,
20221019,103,107,수원신갈,안성,973,22,43,5,2,65,1110,1045,16,46,10,6,68,1191,
20221019,103,108,수원신갈,천안,935,7,56,12,3,39,1052,1103,8,51,16,2,46,1226,
20221019,103,253,수원신갈,서서울,1987,139,82,63,24,136,2431,2048,145,86,84,32,127,2522,
20221019,103,254,수원신갈,군자,1477,97,71,77,84,86,1892,1699,114,95,135,124,102,2269,
20221019,103,528,수원신갈,기흥동탄,1529,19,198,7,1,89,1843,2300,25,166,8,2,123,2624,
20221019,105,101,기흥,서울,6087,95,368,88,46,280,6964,7304,102,379,69,29,343,8226,
20221019,105,103,기흥,수원신갈,2193,32,33,38,15,134,2445,1681,20,58,47,14,115,1935,
20221019,105,253,기흥,서서울,954,25,15,11,7,66,1078,887,30,14,9,10,58,1008,
20221019,106,101,오산,서울,4447,451,481,195,93,293,5960,4390,367,447,170,65,305,5744,
20221019,106,103,오산,수원신갈,1378,66,60,74,10,79,1667,1041,77,53,60,18,90,1339,
20221019,106,107,오산,안성,1772,47,33,26,9,138,2025,1467,54,23,18,11,132,1705,
20221019,106,108,오산,천안,1001,27,16,16,8,71,1139,972,30,21,15,8,59,1105,
20221019,106,528,오산,기흥동탄,894,32,57,12,13,69,1077,973,37,64,16,15,83,1188,
20221019,107,101,안성,서울,2868,80,291,46,25,139,3449,3398,90,307,38,18,194,4045,
20221019,107,103,안성,수원신갈,1045,16,46,10,6,68,1191,973,22,43,5,2,65,1110,
20221019,107,106,안성,오산,1467,54,23,18,11,132,1705,1772,47,33,26,9,138,2025,
20221019,107,108,안성,천안,1499,27,37,5,5,133,1706,1451,31,38,10,6,139,1675,
20221019,107,528,안성,기흥동탄,989,20,30,5,3,89,1136,1182,20,37,12,6,99,1356,
20221019,107,742,안성,남사진위,1295,49,52,27,8,111,1542,1341,41,52,30,12,118,1594,
20221019,108,101,천안,서울,3506,57,352,35,19,141,4110,3594,66,360,35,17,164,4236,
20221019,108,103,천안,수원신갈,1103,8,51,16,2,46,1226,935,7,56,12,3,39,1052,
20221019,108,106,천안,오산,972,30,21,15,8,59,1105,1001,27,16,16,8,71,1139,
20221019,108,107,천안,안성,1451,31,38,10,6,139,1675,1499,27,37,5,5,133,1706,
20221019,108,111,천안,청주,1141,38,68,20,40,72,1379,1090,30,60,26,37,73,1316,
20221019,108,229,천안,북천안,3419,76,126,53,35,191,3900,3868,82,128,55,70,237,4440,
20221019,108,528,천안,기흥동탄,1030,10,95,2,15,57,1209,1094,15,123,3,14,59,1308,
20221019,108,742,천안,남사진위,1102,22,35,25,6,82,1272,985,27,44,33,10,70,1169,
20221019,111,101,청주,서울,756,13,210,24,24,38,1065,986,20,182,28,25,43,1284,
20221019,111,108,청주,천안,1090,30,60,26,37,73,1316,1141,38,68,20,40,72,1379,
20221019,112,115,남청주,대전,1654,88,58,9,17,102,1928,1615,115,60,11,4,125,1930,
20221019,113,115,신탄진,대전,987,19,10,8,16,123,1163,1134,25,13,12,3,110,1297,
20221019,114,153,남대전,서대전,1905,47,71,56,42,131,2252,1765,41,81,69,39,127,2122,
20221019,115,112,대전,남청주,1615,115,60,11,4,125,1930,1654,88,58,9,17,102,1928,
20221019,115,113,대전,신탄진,1134,25,13,12,3,110,1297,987,19,10,8,16,123,1163,
20221019,115,116,대전,옥천,3212,176,66,27,30,219,3730,2070,67,42,32,26,150,2387,
20221019,115,151,대전,북대전,1138,9,15,5,5,130,1302,966,10,14,5,2,105,1102,
20221019,115,152,대전,유성,1010,7,9,3,1,77,1107,970,13,10,1,0,66,1060,
20221019,115,579,대전,남세종,1033,15,18,5,13,84,1168,1103,14,21,3,20,69,1230,
20221019,116,115,옥천,대전,2070,67,42,32,26,150,2387,3212,176,66,27,30,219,3730,
20221019,119,153,판암,서대전,1759,28,21,13,92,158,2071,1796,20,22,16,82,150,2086,
20221019,123,127,구미,서대구,1607,31,29,15,6,107,1795,1676,28,33,18,9,105,1869,
20221019,123,129,구미,북대구,1881,17,60,10,5,86,2059,1902,14,67,12,3,104,2102,
20221019,123,130,구미,동김천,1201,24,41,36,32,71,1405,1160,32,34,23,17,74,1340,
20221019,125,127,남구미,서대구,1827,51,110,48,20,110,2166,2045,60,143,38,23,115,2424,
20221019,125,129,남구미,북대구,1869,25,75,7,13,106,2095,2113,24,78,17,9,111,2352,
20221019,126,127,왜관,서대구,2492,112,61,48,127,140,2980,2882,119,66,42,76,162,3347,
20221019,126,129,왜관,북대구,2956,78,57,21,86,163,3361,3361,101,71,24,79,184,3820,
20221019,127,123,서대구,구미,1676,28,33,18,9,105,1869,1607,31,29,15,6,107,1795,
20221019,127,125,서대구,남구미,2045,60,143,38,23,115,2424,1827,51,110,48,20,110,2166,
20221019,127,126,서대구,왜관,2882,119,66,42,76,162,3347,2492,112,61,48,127,140,2980,
20221019,127,131,서대구,경산,2538,193,130,113,70,152,3196,1850,136,101,60,56,123,2326,
20221019,127,201,서대구,칠곡,1428,26,30,8,23,104,1619,877,18,20,3,11,77,1006,
20221019,127,203,서대구,가산,2133,70,70,43,112,101,2529,1940,69,50,35,136,100,2330,
20221019,127,230,서대구,팔공산,1453,46,52,11,1,108,1671,1062,40,33,14,7,82,1238,
20221019,127,518,서대구,칠곡물류,929,122,95,115,36,53,1350,744,94,78,91,35,51,1093,
20221019,127,621,서대구,동대구,1824,56,71,24,22,132,2129,1329,47,26,33,21,100,1556,
20221019,129,123,북대구,구미,1902,14,67,12,3,104,2102,1881,17,60,10,5,86,2059,
20221019,129,125,북대구,남구미,2113,24,78,17,9,111,2352,1869,25,75,7,13,106,2095,
20221019,129,126,북대구,왜관,3361,101,71,24,79,184,3820,2956,78,57,21,86,163,3361,
20221019,129,131,북대구,경산,2309,140,84,61,31,111,2736,2973,212,115,89,35,156,3580,
20221019,129,524,북대구,청통와촌,908,47,24,11,21,47,1058,1106,78,38,18,27,57,1324,
20221019,129,527,북대구,포항,1472,37,23,18,65,82,1697,1908,54,47,22,86,91,2208,
20221019,130,123,동김천,구미,1160,32,34,23,17,74,1340,1201,24,41,36,32,71,1405,
20221019,131,127,경산,서대구,1850,136,101,60,56,123,2326,2538,193,130,113,70,152,3196,
20221019,131,129,경산,북대구,2973,212,115,89,35,156,3580,2309,140,84,61,31,111,2736,
20221019,131,132,경산,영천,879,46,49,43,63,51,1131,889,59,65,47,45,45,1150,
20221019,131,230,경산,팔공산,1281,80,39,24,12,74,1510,1503,79,62,81,20,89,1834,
20221019,131,621,경산,동대구,2296,64,38,148,41,143,2730,2521,70,58,110,31,135,2925,
20221019,132,131,영천,경산,889,59,65,47,45,45,1150,879,46,49,43,63,51,1131,
20221019,132,621,영천,동대구,1081,10,26,4,36,50,1207,1139,12,24,4,35,49,1263,
20221019,135,140,경주,부산,1099,20,56,9,48,59,1291,1289,17,40,15,27,47,1435,
20221019,135,252,경주,대동,890,36,104,52,177,42,1301,1085,46,107,41,104,49,1432,
20221019,138,140,양산,부산,5141,256,188,226,238,291,6340,5276,274,187,241,226,276,6480,
20221019,138,252,양산,대동,2643,295,197,161,352,122,3770,3043,317,217,148,335,149,4209,
20221019,139,140,서울산,부산,1316,41,19,13,21,81,1491,1219,48,25,14,13,64,1383,
20221019,139,641,서울산,울산,1102,42,54,32,39,89,1358,1008,24,45,16,32,52,1177,
20221019,140,135,부산,경주,1289,17,40,15,27,47,1435,1099,20,56,9,48,59,1291,
20221019,140,138,부산,양산,5276,274,187,241,226,276,6480,5141,256,188,226,238,291,6340,
20221019,140,139,부산,서울산,1219,48,25,14,13,64,1383,1316,41,19,13,21,81,1491,
20221019,140,250,부산,남양산,7996,133,219,42,39,631,9060,7723,136,208,36,36,628,8767,
20221019,140,251,부산,물금,1035,104,26,32,73,78,1348,1050,85,25,38,55,66,1319,
20221019,140,252,부산,대동,1703,39,56,54,80,99,2031,1523,45,45,43,115,91,1862,
20221019,140,755,부산,광재,1105,10,24,10,47,75,1271,949,14,18,7,38,64,1090,
20221019,142,145,군북,산인,3960,60,126,54,58,294,4552,3802,63,113,49,59,273,4359,
20221019,143,145,장지,산인,1221,17,27,34,52,81,1432,1227,20,37,21,54,81,1440,
20221019,144,145,함안,산인,1998,51,45,28,82,164,2368,1941,48,35,39,66,162,2291,
20221019,145,142,산인,군북,3802,63,113,49,59,273,4359,3960,60,126,54,58,294,4552,
20221019,145,143,산인,장지,1227,20,37,21,54,81,1440,1221,17,27,34,52,81,1432,
20221019,145,144,산인,함안,1941,48,35,39,66,162,2291,1998,51,45,28,82,164,2368,
20221019,145,291,산인,사천,1109,42,49,14,13,58,1285,1382,64,56,23,19,76,1620,
20221019,145,292,산인,진주,1375,24,146,10,15,81,1651,1512,32,134,24,14,99,1815,
20221019,145,293,산인,문산,1150,27,22,7,1,84,1291,1083,21,20,13,10,64,1211,
20221019,146,150,동창원,북부산,1003,25,20,2,26,62,1138,941,18,23,3,19,71,1075,
20221019,146,244,동창원,서부산,1192,35,50,22,26,72,1397,1270,35,45,24,46,73,1493,
20221019,146,245,동창원,장유,957,14,12,2,17,94,1096,983,11,14,4,18,91,1121,
20221019,146,289,동창원,마산,2594,79,80,43,76,252,3124,2517,93,84,44,64,223,3025,
20221019,147,150,진례,북부산,1388,37,29,24,27,86,1591,1609,50,32,19,27,87,1824,
20221019,147,244,진례,서부산,1731,104,80,60,98,98,2171,1858,118,77,50,95,111,2309,
20221019,147,245,진례,장유,1075,77,98,57,19,99,1425,1403,59,100,52,29,137,1780,
20221019,147,289,진례,마산,1264,96,68,48,63,74,1613,1311,92,81,42,75,78,1679,
20221019,148,150,서김해,북부산,6357,138,92,54,100,484,7225,6442,114,79,40,85,490,7250,
20221019,148,251,서김해,물금,894,41,17,25,10,85,1072,854,43,22,22,13,103,1057,
20221019,148,289,서김해,마산,1318,31,55,8,15,99,1526,1460,24,58,15,5,103,1665,
20221019,149,150,동김해,북부산,10711,188,194,52,80,936,12161,9294,164,140,23,61,784,10466,
20221019,149,250,동김해,남양산,1121,22,51,6,5,99,1304,999,18,49,10,6,82,1164,
20221019,149,251,동김해,물금,1136,48,15,14,4,111,1328,1118,38,17,7,3,110,1293,
20221019,150,146,북부산,동창원,941,18,23,3,19,71,1075,1003,25,20,2,26,62,1138,
20221019,150,147,북부산,진례,1609,50,32,19,27,87,1824,1388,37,29,24,27,86,1591,
20221019,150,148,북부산,서김해,6442,114,79,40,85,490,7250,6357,138,92,54,100,484,7225,
20221019,150,149,북부산,동김해,9294,164,140,23,61,784,10466,10711,188,194,52,80,936,12161,
20221019,150,245,북부산,장유,3789,41,89,16,45,256,4236,3055,27,87,9,28,194,3400,
20221019,150,289,북부산,마산,2294,35,85,12,17,109,2552,2612,34,89,22,25,134,2916,
20221019,151,115,북대전,대전,966,10,14,5,2,105,1102,1138,9,15,5,5,130,1302,
20221019,151,153,북대전,서대전,1094,14,16,19,14,90,1247,1303,15,16,25,11,113,1483,
20221019,152,115,유성,대전,970,13,10,1,0,66,1060,1010,7,9,3,1,77,1107,
20221019,152,154,유성,안영,1042,20,33,5,20,67,1187,1142,22,21,7,12,69,1273,
20221019,153,114,서대전,남대전,1765,41,81,69,39,127,2122,1905,47,71,56,42,131,2252,
20221019,153,119,서대전,판암,1796,20,22,16,82,150,2086,1759,28,21,13,92,158,2071,
20221019,153,151,서대전,북대전,1303,15,16,25,11,113,1483,1094,14,16,19,14,90,1247,
20221019,153,154,서대전,안영,1091,29,36,31,118,68,1373,1113,26,39,39,104,66,1387,
20221019,153,579,서대전,남세종,1191,15,22,13,10,95,1346,1038,18,21,11,13,79,1180,
20221019,154,152,안영,유성,1142,22,21,7,12,69,1273,1042,20,33,5,20,67,1187,
20221019,154,153,안영,서대전,1113,26,39,39,104,66,1387,1091,29,36,31,118,68,1373,
20221019,159,167,서전주,광주,1457,55,78,58,56,46,1750,1249,68,56,50,32,45,1500,
20221019,163,167,정읍,광주,853,34,57,36,29,28,1037,824,36,58,35,29,26,1008,
20221019,166,167,장성,광주,2244,77,64,39,60,98,2582,2513,112,60,50,36,109,2880,
20221019,167,159,광주,서전주,1249,68,56,50,32,45,1500,1457,55,78,58,56,46,1750,
20221019,167,163,광주,정읍,824,36,58,35,29,26,1008,853,34,57,36,29,28,1037,
20221019,167,166,광주,장성,2513,112,60,50,36,109,2880,2244,77,64,39,60,98,2582,
20221019,167,567,광주,남고창,1191,22,51,19,29,37,1349,1309,29,48,10,34,36,1466,
20221019,171,101,마성,서울,2561,19,292,51,5,139,3067,2180,32,258,45,2,120,2637,
20221019,172,101,용인,서울,3901,134,148,61,41,243,4528,3463,123,138,42,18,191,3975,
20221019,172,102,용인,동수원,1031,27,18,6,2,93,1177,1152,20,18,4,3,87,1284,
20221019,172,173,용인,양지,1971,269,138,195,195,149,2917,1791,203,168,182,198,167,2709,
20221019,172,212,용인,북수원,939,26,17,23,19,58,1082,1050,46,19,18,24,77,1234,
20221019,172,253,용인,서서울,1017,53,27,32,16,60,1205,1009,52,13,36,19,49,1178,
20221019,173,101,양지,서울,4464,402,150,157,100,192,5465,3649,233,144,112,88,138,4364,
20221019,173,102,양지,동수원,1417,44,33,9,0,90,1593,1221,40,28,5,22,81,1397,
20221019,173,172,양지,용인,1791,203,168,182,198,167,2709,1971,269,138,195,195,149,2917,
20221019,173,190,양지,동서울,703,111,38,88,29,31,1000,725,97,49,77,37,38,1023,
20221019,173,212,양지,북수원,1160,83,44,62,50,68,1467,1231,93,52,58,95,57,1586,
20221019,173,253,양지,서서울,1253,150,73,127,57,55,1715,935,127,58,99,46,54,1319,
20221019,173,254,양지,군자,782,123,80,184,231,49,1449,665,100,89,159,202,34,1249,
20221019,174,179,춘천,홍천,3223,76,115,41,35,335,3825,3032,81,102,39,25,324,3603,
20221019,174,216,춘천,횡성,1099,38,52,34,41,61,1325,1074,50,40,22,23,61,1270,
20221019,174,218,춘천,남원주,1044,30,66,13,16,70,1239,1017,20,65,15,24,69,1210,
20221019,174,554,춘천,동홍천,1164,19,25,17,10,82,1317,1180,15,23,7,5,89,1319,
20221019,175,101,덕평,서울,816,126,85,33,25,34,1119,767,71,83,39,13,42,1015,
20221019,176,190,이천,동서울,1687,71,188,163,105,76,2290,1523,71,195,156,76,72,2093,
20221019,179,174,홍천,춘천,3032,81,102,39,25,324,3603,3223,76,115,41,35,335,3825,
20221019,184,189,대관령,강릉,1286,39,78,14,15,75,1507,1379,42,66,12,14,74,1587,
20221019,189,184,강릉,대관령,1379,42,66,12,14,74,1587,1286,39,78,14,15,75,1507,
20221019,190,173,동서울,양지,725,97,49,77,37,38,1023,703,111,38,88,29,31,1000,
20221019,190,176,동서울,이천,1523,71,195,156,76,72,2093,1687,71,188,163,105,76,2290,
20221019,190,191,동서울,경기광주,10650,696,474,346,240,697,13103,10395,662,420,311,270,718,12776,
20221019,190,192,동서울,곤지암,6276,518,255,196,109,387,7741,5719,463,178,196,83,357,6996,
20221019,190,193,동서울,일죽,2352,149,174,173,95,83,3026,2433,167,182,240,106,88,3216,
20221019,190,194,동서울,서이천,4100,575,325,266,163,239,5668,3189,436,271,231,129,167,4423,
20221019,190,198,동서울,서청주,826,25,52,34,35,37,1009,903,25,44,37,20,27,1056,
20221019,190,560,동서울,감곡,1047,25,43,39,73,25,1252,901,34,34,35,89,30,1123,
20221019,190,705,동서울,남이천,1463,92,72,122,86,48,1883,1925,106,68,118,60,64,2341,
20221019,191,190,경기광주,동서울,10395,662,420,311,270,718,12776,10650,696,474,346,240,697,13103,
20221019,192,190,곤지암,동서울,5719,463,178,196,83,357,6996,6276,518,255,196,109,387,7741,
20221019,192,194,곤지암,서이천,1330,264,115,143,102,99,2053,1100,166,96,120,119,83,1684,
20221019,193,190,일죽,동서울,2433,167,182,240,106,88,3216,2352,149,174,173,95,83,3026,
20221019,194,190,서이천,동서울,3189,436,271,231,129,167,4423,4100,575,325,266,163,239,5668,
20221019,194,192,서이천,곤지암,1100,166,96,120,119,83,1684,1330,264,115,143,102,99,2053,
20221019,196,198,진천,서청주,1309,42,71,42,37,75,1576,1384,44,85,37,32,83,1665,
20221019,198,190,서청주,동서울,903,25,44,37,20,27,1056,826,25,52,34,35,37,1009,
20221019,198,196,서청주,진천,1384,44,85,37,32,83,1665,1309,42,71,42,37,75,1576,
20221019,201,127,칠곡,서대구,877,18,20,3,11,77,1006,1428,26,30,8,23,104,1619,
20221019,201,203,칠곡,가산,843,40,29,80,138,48,1178,818,42,47,72,159,39,1177,
20221019,203,127,가산,서대구,1940,69,50,35,136,100,2330,2133,70,70,43,112,101,2529,
20221019,203,201,가산,칠곡,818,42,47,72,159,39,1177,843,40,29,80,138,48,1178,
20221019,203,775,가산,동명동호,1609,72,48,41,268,75,2113,1679,66,46,50,233,85,2159,
20221019,212,102,북수원,동수원,4668,39,237,71,20,257,5292,4444,31,233,70,46,256,5080,
20221019,212,172,북수원,용인,1050,46,19,18,24,77,1234,939,26,17,23,19,58,1082,
20221019,212,173,북수원,양지,1231,93,52,58,95,57,1586,1160,83,44,62,50,68,1467,
20221019,212,253,북수원,서서울,2707,57,35,13,17,171,3000,1100,28,9,9,7,72,1225,
20221019,212,254,북수원,군자,1691,33,35,22,36,112,1929,1156,37,26,15,26,66,1326,
20221019,213,102,부곡,동수원,1026,20,15,4,25,76,1166,1068,12,13,4,32,90,1219,
20221019,213,253,부곡,서서울,1393,64,40,31,185,82,1795,1027,43,21,48,150,67,1356,
20221019,213,254,부곡,군자,1003,37,28,47,477,65,1657,913,30,18,46,396,52,1455,
20221019,214,102,동군포,동수원,1594,24,20,12,8,116,1774,1549,25,19,7,6,106,1712,
20221019,215,102,군포,동수원,2273,23,47,5,13,170,2531,1648,22,21,5,19,109,1824,
20221019,215,253,군포,서서울,3213,85,65,38,68,226,3695,4528,209,220,202,176,301,5636,
20221019,215,254,군포,군자,2102,63,65,31,65,150,2476,2851,134,117,134,159,201,3596,
20221019,215,255,군포,서안산,1290,62,33,19,16,104,1524,1538,89,65,83,92,121,1988,
20221019,216,174,횡성,춘천,1074,50,40,22,23,61,1270,1099,38,52,34,41,61,1325,
20221019,218,174,남원주,춘천,1017,20,65,15,24,69,1210,1044,30,66,13,16,70,1239,
20221019,218,240,남원주,제천,2111,59,52,16,57,143,2438,2251,71,43,26,38,150,2579,
20221019,225,291,서진주,사천,953,29,27,13,35,73,1130,1067,20,30,16,34,78,1245,
20221019,229,101,북천안,서울,917,58,42,58,27,40,1142,842,55,54,47,27,35,1060,
20221019,229,108,북천안,천안,3868,82,128,55,70,237,4440,3419,76,126,53,35,191,3900,
20221019,230,127,팔공산,서대구,1062,40,33,14,7,82,1238,1453,46,52,11,1,108,1671,
20221019,230,131,팔공산,경산,1503,79,62,81,20,89,1834,1281,80,39,24,12,74,1510,
20221019,230,524,팔공산,청통와촌,1141,42,35,9,13,49,1289,992,36,29,10,30,51,1148,
20221019,230,527,팔공산,포항,1405,24,22,13,21,57,1542,1295,31,12,11,23,53,1425,
20221019,231,519,화원옥포,남대구,6338,180,98,203,193,497,7509,6117,172,114,185,104,481,7173,
20221019,232,519,달성,남대구,2876,133,156,55,48,198,3466,2913,139,132,49,34,204,3471,
20221019,233,519,현풍,남대구,4983,227,197,68,118,367,5960,4354,193,202,98,106,309,5262,
20221019,238,239,칠서,칠원,1619,85,105,194,440,97,2540,1681,103,105,150,442,110,2591,
20221019,239,238,칠원,칠서,1681,103,105,150,442,110,2591,1619,85,105,194,440,97,2540,
20221019,239,519,칠원,남대구,1060,48,91,29,100,52,1380,1183,50,92,43,58,53,1479,
20221019,240,218,제천,남원주,2251,71,43,26,38,150,2579,2111,59,52,16,57,143,2438,
20221019,241,519,동고령,남대구,3126,86,80,378,149,164,3983,3126,99,75,349,153,139,3941,
20221019,242,519,고령,남대구,1554,40,60,25,193,81,1953,1724,35,66,22,170,88,2105,
20221019,244,146,서부산,동창원,1270,35,45,24,46,73,1493,1192,35,50,22,26,72,1397,
20221019,244,147,서부산,진례,1858,118,77,50,95,111,2309,1731,104,80,60,98,98,2171,
20221019,244,245,서부산,장유,12886,245,403,168,305,919,14926,12638,231,365,184,358,896,14672,
20221019,244,289,서부산,마산,2662,58,229,45,67,130,3191,2841,57,235,41,62,149,3385,
20221019,245,146,장유,동창원,983,11,14,4,18,91,1121,957,14,12,2,17,94,1096,
20221019,245,147,장유,진례,1403,59,100,52,29,137,1780,1075,77,98,57,19,99,1425,
20221019,245,150,장유,북부산,3055,27,87,9,28,194,3400,3789,41,89,16,45,256,4236,
20221019,245,244,장유,서부산,12638,231,365,184,358,896,14672,12886,245,403,168,305,919,14926,
20221019,245,289,장유,마산,1326,29,25,8,24,105,1517,1395,30,35,15,12,101,1588,
20221019,249,261,담양,동광주,2149,34,112,23,50,96,2464,1801,31,126,19,23,90,2090,
20221019,250,140,남양산,부산,7723,136,208,36,36,628,8767,7996,133,219,42,39,631,9060,
20221019,250,149,남양산,동김해,999,18,49,10,6,82,1164,1121,22,51,6,5,99,1304,
20221019,250,252,남양산,대동,3331,145,91,176,137,224,4104,4046,169,101,159,148,283,4906,
20221019,251,140,물금,부산,1050,85,25,38,55,66,1319,1035,104,26,32,73,78,1348,
20221019,251,148,물금,서김해,854,43,22,22,13,103,1057,894,41,17,25,10,85,1072,
20221019,251,149,물금,동김해,1118,38,17,7,3,110,1293,1136,48,15,14,4,111,1328,
20221019,251,252,물금,대동,3033,215,92,147,490,248,4225,3664,217,83,138,564,279,4945,
20221019,252,135,대동,경주,1085,46,107,41,104,49,1432,890,36,104,52,177,42,1301,
20221019,252,138,대동,양산,3043,317,217,148,335,149,4209,2643,295,197,161,352,122,3770,
20221019,252,140,대동,부산,1523,45,45,43,115,91,1862,1703,39,56,54,80,99,2031,
20221019,252,250,대동,남양산,4046,169,101,159,148,283,4906,3331,145,91,176,137,224,4104,
20221019,252,251,대동,물금,3664,217,83,138,564,279,4945,3033,215,92,147,490,248,4225,
20221019,252,641,대동,울산,1560,81,88,32,51,100,1912,1295,63,98,29,69,71,1625,
20221019,252,752,대동,기장철마,1814,66,52,36,142,148,2258,1757,74,59,42,83,148,2163,
20221019,252,753,대동,금정,1844,100,93,96,178,118,2429,1111,63,67,69,85,74,1469,
20221019,252,755,대동,광재,2394,117,109,122,310,162,3214,2285,96,88,118,532,135,3254,
20221019,252,756,대동,한림,869,45,44,27,89,45,1119,949,59,53,32,151,38,1282,
20221019,253,102,서서울,동수원,4979,67,61,18,34,304,5463,5737,61,58,20,38,353,6267,
20221019,253,103,서서울,수원신갈,2048,145,86,84,32,127,2522,1987,139,82,63,24,136,2431,
20221019,253,105,서서울,기흥,887,30,14,9,10,58,1008,954,25,15,11,7,66,1078,
20221019,253,172,서서울,용인,1009,52,13,36,19,49,1178,1017,53,27,32,16,60,1205,
20221019,253,173,서서울,양지,935,127,58,99,46,54,1319,1253,150,73,127,57,55,1715,
20221019,253,212,서서울,북수원,1100,28,9,9,7,72,1225,2707,57,35,13,17,171,3000,
20221019,253,213,서서울,부곡,1027,43,21,48,150,67,1356,1393,64,40,31,185,82,1795,
20221019,253,215,서서울,군포,4528,209,220,202,176,301,5636,3213,85,65,38,68,226,3695,
20221019,253,255,서서울,서안산,15114,528,626,611,405,922,18206,14842,536,562,573,361,865,17739,
20221019,253,256,서서울,안산,8985,159,93,42,46,620,9945,5921,128,62,32,70,415,6628,
20221019,253,281,서서울,매송,3134,49,23,23,18,192,3439,3925,70,35,31,80,258,4399,
20221019,253,282,서서울,비봉,4613,198,216,138,329,237,5731,5554,281,261,185,438,355,7074,
20221019,253,283,서서울,발안,3095,137,141,176,139,153,3841,3502,190,163,194,126,187,4362,
20221019,253,285,서서울,서평택,1299,55,105,265,367,90,2181,1411,97,119,343,523,76,2569,
20221019,253,287,서서울,송악,1561,33,77,71,227,70,2039,1761,51,84,108,433,78,2515,
20221019,253,288,서서울,당진,1117,22,48,31,35,60,1313,1214,26,52,64,53,48,1457,
20221019,253,298,서서울,서산,1864,28,64,56,23,62,2097,1865,30,73,68,59,70,2165,
20221019,253,520,서서울,평택,1774,93,109,161,123,84,2344,2120,102,145,223,157,102,2849,
20221019,253,540,서서울,청북,758,43,44,94,55,38,1032,784,69,49,108,95,37,1142,
20221019,254,102,군자,동수원,3950,63,68,32,45,232,4390,3801,56,80,29,36,204,4206,
20221019,254,103,군자,수원신갈,1699,114,95,135,124,102,2269,1477,97,71,77,84,86,1892,
20221019,254,173,군자,양지,665,100,89,159,202,34,1249,782,123,80,184,231,49,1449,
20221019,254,212,군자,북수원,1156,37,26,15,26,66,1326,1691,33,35,22,36,112,1929,
20221019,254,213,군자,부곡,913,30,18,46,396,52,1455,1003,37,28,47,477,65,1657,
20221019,254,215,군자,군포,2851,134,117,134,159,201,3596,2102,63,65,31,65,150,2476,
20221019,254,255,군자,서안산,9713,400,215,222,302,702,11554,9396,397,196,232,271,624,11116,
20221019,254,256,군자,안산,4633,130,123,50,77,391,5404,4812,125,120,65,59,392,5573,
20221019,254,281,군자,매송,962,28,14,26,64,77,1171,947,27,18,30,46,55,1123,
20221019,254,282,군자,비봉,1203,95,74,80,205,78,1735,1103,97,78,65,169,78,1590,
20221019,254,283,군자,발안,1240,85,73,70,175,75,1718,963,91,57,56,137,67,1371,
20221019,255,102,서안산,동수원,1968,35,21,11,7,111,2153,1742,37,15,11,6,109,1920,
20221019,255,215,서안산,군포,1538,89,65,83,92,121,1988,1290,62,33,19,16,104,1524,
20221019,255,253,서안산,서서울,14842,536,562,573,361,865,17739,15114,528,626,611,405,922,18206,
20221019,255,254,서안산,군자,9396,397,196,232,271,624,11116,9713,400,215,222,302,702,11554,
20221019,256,253,안산,서서울,5921,128,62,32,70,415,6628,8985,159,93,42,46,620,9945,
20221019,256,254,안산,군자,4812,125,120,65,59,392,5573,4633,130,123,50,77,391,5404,
20221019,261,249,동광주,담양,1801,31,126,19,23,90,2090,2149,34,112,23,50,96,2464,
20221019,261,263,동광주,옥과,2684,31,124,16,84,105,3044,2401,28,112,10,86,83,2720,
20221019,261,265,동광주,곡성,1468,26,38,24,46,62,1664,1300,11,27,19,43,37,1437,
20221019,261,271,동광주,순천,2941,96,105,35,109,87,3373,2487,95,83,17,121,63,2866,
20221019,263,261,옥과,동광주,2401,28,112,10,86,83,2720,2684,31,124,16,84,105,3044,
20221019,265,261,곡성,동광주,1300,11,27,19,43,37,1437,1468,26,38,24,46,62,1664,
20221019,271,261,순천,동광주,2487,95,83,17,121,63,2866,2941,96,105,35,109,87,3373,
20221019,271,569,순천,북광주,835,71,40,29,128,18,1121,822,63,28,33,99,28,1073,
20221019,281,253,매송,서서울,3925,70,35,31,80,258,4399,3134,49,23,23,18,192,3439,
20221019,281,254,매송,군자,947,27,18,30,46,55,1123,962,28,14,26,64,77,1171,
20221019,282,253,비봉,서서울,5554,281,261,185,438,355,7074,4613,198,216,138,329,237,5731,
20221019,282,254,비봉,군자,1103,97,78,65,169,78,1590,1203,95,74,80,205,78,1735,
20221019,283,253,발안,서서울,3502,190,163,194,126,187,4362,3095,137,141,176,139,153,3841,
20221019,283,254,발안,군자,963,91,57,56,137,67,1371,1240,85,73,70,175,75,1718,
20221019,285,253,서평택,서서울,1411,97,119,343,523,76,2569,1299,55,105,265,367,90,2181,
20221019,285,287,서평택,송악,665,28,90,67,554,47,1451,708,50,88,87,493,58,1484,
20221019,285,520,서평택,평택,668,36,64,82,116,59,1025,765,38,61,76,132,65,1137,
20221019,287,253,송악,서서울,1761,51,84,108,433,78,2515,1561,33,77,71,227,70,2039,
20221019,287,285,송악,서평택,708,50,88,87,493,58,1484,665,28,90,67,554,47,1451,
20221019,288,253,당진,서서울,1214,26,52,64,53,48,1457,1117,22,48,31,35,60,1313,
20221019,289,146,마산,동창원,2517,93,84,44,64,223,3025,2594,79,80,43,76,252,3124,
20221019,289,147,마산,진례,1311,92,81,42,75,78,1679,1264,96,68,48,63,74,1613,
20221019,289,148,마산,서김해,1460,24,58,15,5,103,1665,1318,31,55,8,15,99,1526,
20221019,289,150,마산,북부산,2612,34,89,22,25,134,2916,2294,35,85,12,17,109,2552,
20221019,289,244,마산,서부산,2841,57,235,41,62,149,3385,2662,58,229,45,67,130,3191,
20221019,289,245,마산,장유,1395,30,35,15,12,101,1588,1326,29,25,8,24,105,1517,
20221019,289,757,마산,진영,733,44,58,39,107,45,1026,812,52,59,31,68,56,1078,
20221019,291,145,사천,산인,1382,64,56,23,19,76,1620,1109,42,49,14,13,58,1285,
20221019,291,225,사천,서진주,1067,20,30,16,34,78,1245,953,29,27,13,35,73,1130,
20221019,291,292,사천,진주,2858,75,87,47,49,279,3395,3455,86,104,55,57,300,4057,
20221019,292,145,진주,산인,1512,32,134,24,14,99,1815,1375,24,146,10,15,81,1651,
20221019,292,291,진주,사천,3455,86,104,55,57,300,4057,2858,75,87,47,49,279,3395,
20221019,293,145,문산,산인,1083,21,20,13,10,64,1211,1150,27,22,7,1,84,1291,
20221019,298,253,서산,서서울,1865,30,73,68,59,70,2165,1864,28,64,56,23,62,2097,
20221019,508,509,무안,목포,1385,46,48,38,83,62,1662,1674,51,57,29,86,79,1976,
20221019,508,553,무안,동광산,1474,18,50,26,27,54,1649,1499,27,53,37,30,62,1708,
20221019,509,508,목포,무안,1674,51,57,29,86,79,1976,1385,46,48,38,83,62,1662,
20221019,509,553,목포,동광산,6505,191,196,163,350,272,7677,6725,169,236,190,390,264,7974,
20221019,513,515,고성,북통영,1270,27,73,12,25,80,1487,1465,26,69,16,19,99,1694,
20221019,513,516,고성,통영,2829,76,130,84,156,215,3490,2710,71,128,82,148,204,3343,
20221019,514,516,동고성,통영,1194,24,56,37,121,139,1571,1144,12,59,28,125,150,1518,
20221019,515,513,북통영,고성,1465,26,69,16,19,99,1694,1270,27,73,12,25,80,1487,
20221019,516,513,통영,고성,2710,71,128,82,148,204,3343,2829,76,130,84,156,215,3490,
20221019,516,514,통영,동고성,1144,12,59,28,125,150,1518,1194,24,56,37,121,139,1571,
20221019,518,127,칠곡물류,서대구,744,94,78,91,35,51,1093,929,122,95,115,36,53,1350,
20221019,519,231,남대구,화원옥포,6117,172,114,185,104,481,7173,6338,180,98,203,193,497,7509,
20221019,519,232,남대구,달성,2913,139,132,49,34,204,3471,2876,133,156,55,48,198,3466,
20221019,519,233,남대구,현풍,4354,193,202,98,106,309,5262,4983,227,197,68,118,367,5960,
20221019,519,239,남대구,칠원,1183,50,92,43,58,53,1479,1060,48,91,29,100,52,1380,
20221019,519,241,남대구,동고령,3126,99,75,349,153,139,3941,3126,86,80,378,149,164,3983,
20221019,519,242,남대구,고령,1724,35,66,22,170,88,2105,1554,40,60,25,193,81,1953,
20221019,519,730,남대구,유천,2442,57,13,3,9,159,2683,2839,62,14,0,0,193,3108,
20221019,519,731,남대구,북현풍,1989,25,38,0,18,117,2187,1481,27,5,0,1,104,1618,
20221019,520,253,평택,서서울,2120,102,145,223,157,102,2849,1774,93,109,161,123,84,2344,
20221019,520,285,평택,서평택,765,38,61,76,132,65,1137,668,36,64,82,116,59,1025,
20221019,520,540,평택,청북,1073,108,155,160,89,70,1655,815,112,148,153,98,46,1372,
20221019,520,741,평택,평택고덕,883,14,218,27,20,72,1234,846,15,185,16,23,62,1147,
20221019,524,129,청통와촌,북대구,1106,78,38,18,27,57,1324,908,47,24,11,21,47,1058,
20221019,524,230,청통와촌,팔공산,992,36,29,10,30,51,1148,1141,42,35,9,13,49,1289,
20221019,526,527,서포항,포항,866,12,32,8,21,87,1026,968,11,26,11,18,89,1123,
20221019,527,129,포항,북대구,1908,54,47,22,86,91,2208,1472,37,23,18,65,82,1697,
20221019,527,230,포항,팔공산,1295,31,12,11,23,53,1425,1405,24,22,13,21,57,1542,
20221019,527,526,포항,서포항,968,11,26,11,18,89,1123,866,12,32,8,21,87,1026,
20221019,528,101,기흥동탄,서울,7603,78,1310,135,12,375,9513,7189,83,1206,136,19,345,8978,
20221019,528,103,기흥동탄,수원신갈,2300,25,166,8,2,123,2624,1529,19,198,7,1,89,1843,
20221019,528,106,기흥동탄,오산,973,37,64,16,15,83,1188,894,32,57,12,13,69,1077,
20221019,528,107,기흥동탄,안성,1182,20,37,12,6,99,1356,989,20,30,5,3,89,1136,
20221019,528,108,기흥동탄,천안,1094,15,123,3,14,59,1308,1030,10,95,2,15,57,1209,
20221019,540,253,청북,서서울,784,69,49,108,95,37,1142,758,43,44,94,55,38,1032,
20221019,540,520,청북,평택,815,112,148,153,98,46,1372,1073,108,155,160,89,70,1655,
20221019,540,741,청북,평택고덕,942,28,46,57,23,87,1183,944,38,53,79,26,101,1241,
20221019,542,101,서안성,서울,1760,64,77,175,51,96,2223,1248,41,90,102,26,64,1571,
20221019,542,543,서안성,남안성,1124,48,80,133,92,71,1548,1161,54,82,133,79,86,1595,
20221019,543,101,남안성,서울,1309,94,97,104,95,42,1741,1248,57,74,76,75,37,1567,
20221019,543,542,남안성,서안성,1161,54,82,133,79,86,1595,1124,48,80,133,92,71,1548,
20221019,543,555,남안성,북진천,797,98,166,183,155,33,1432,741,117,151,139,166,48,1362,
20221019,548,553,북무안,동광산,1277,27,50,35,65,33,1487,1453,24,51,28,89,44,1689,
20221019,549,553,동함평,동광산,3067,43,60,32,46,118,3366,3196,64,67,46,55,118,3546,
20221019,551,553,나주,동광산,1370,25,43,117,40,80,1675,1465,21,54,123,47,81,1791,
20221019,552,553,서광산,동광산,4320,188,195,203,237,182,5325,5913,227,217,216,160,232,6965,
20221019,553,508,동광산,무안,1499,27,53,37,30,62,1708,1474,18,50,26,27,54,1649,
20221019,553,509,동광산,목포,6725,169,236,190,390,264,7974,6505,191,196,163,350,272,7677,
20221019,553,548,동광산,북무안,1453,24,51,28,89,44,1689,1277,27,50,35,65,33,1487,
20221019,553,549,동광산,동함평,3196,64,67,46,55,118,3546,3067,43,60,32,46,118,3366,
20221019,553,551,동광산,나주,1465,21,54,123,47,81,1791,1370,25,43,117,40,80,1675,
20221019,553,552,동광산,서광산,5913,227,217,216,160,232,6965,4320,188,195,203,237,182,5325,
20221019,554,174,동홍천,춘천,1180,15,23,7,5,89,1319,1164,19,25,17,10,82,1317,
20221019,555,543,북진천,남안성,741,117,151,139,166,48,1362,797,98,166,183,155,33,1432,
20221019,560,190,감곡,동서울,901,34,34,35,89,30,1123,1047,25,43,39,73,25,1252,
20221019,567,167,남고창,광주,1309,29,48,10,34,36,1466,1191,22,51,19,29,37,1349,
20221019,569,271,북광주,순천,822,63,28,33,99,28,1073,835,71,40,29,128,18,1121,
20221019,579,115,남세종,대전,1103,14,21,3,20,69,1230,1033,15,18,5,13,84,1168,
20221019,579,153,남세종,서대전,1038,18,21,11,13,79,1180,1191,15,22,13,10,95,1346,
20221019,587,589,오수,상관,1087,25,50,28,64,42,1296,1222,26,44,22,129,48,1491,
20221019,589,587,상관,오수,1222,26,44,22,129,48,1491,1087,25,50,28,64,42,1296,
20221019,597,598,서여주,북여주,946,45,116,45,53,38,1243,1071,46,87,53,57,45,1359,
20221019,598,597,북여주,서여주,1071,46,87,53,57,45,1359,946,45,116,45,53,38,1243,
20221019,621,127,동대구,서대구,1329,47,26,33,21,100,1556,1824,56,71,24,22,132,2129,
20221019,621,131,동대구,경산,2521,70,58,110,31,135,2925,2296,64,38,148,41,143,2730,
20221019,621,132,동대구,영천,1139,12,24,4,35,49,1263,1081,10,26,4,36,50,1207,
20221019,625,626,밀양,남밀양,1253,75,42,47,85,69,1571,1208,54,44,42,86,62,1496,
20221019,626,625,남밀양,밀양,1208,54,44,42,86,62,1496,1253,75,42,47,85,69,1571,
20221019,626,627,남밀양,삼랑진,992,26,36,16,47,110,1227,998,27,25,17,43,102,1212,
20221019,627,626,삼랑진,남밀양,998,27,25,17,43,102,1212,992,26,36,16,47,110,1227,
20221019,641,139,울산,서울산,1008,24,45,16,32,52,1177,1102,42,54,32,39,89,1358,
20221019,641,252,울산,대동,1295,63,98,29,69,71,1625,1560,81,88,32,51,100,1912,
20221019,641,643,울산,청량,1143,13,19,14,36,114,1339,1297,13,14,11,14,136,1485,
20221019,641,648,울산,해운대,950,8,18,1,3,59,1039,1048,15,20,0,5,72,1160,
20221019,641,706,울산,남경주,1127,6,13,10,17,65,1238,1157,5,17,16,13,48,1256,
20221019,641,707,울산,남포항,1076,17,14,15,139,62,1323,1138,21,33,21,129,71,1413,
20221019,643,641,청량,울산,1297,13,14,11,14,136,1485,1143,13,19,14,36,114,1339,
20221019,643,648,청량,해운대,2821,19,29,25,57,179,3130,3194,43,73,28,391,196,3925,
20221019,645,648,장안,해운대,1608,15,13,4,8,102,1750,2895,33,25,143,68,173,3337,
20221019,646,648,기장일광,해운대,4761,25,27,54,59,264,5190,5302,36,35,35,189,291,5888,
20221019,648,641,해운대,울산,1048,15,20,0,5,72,1160,950,8,18,1,3,59,1039,
20221019,648,643,해운대,청량,3194,43,73,28,391,196,3925,2821,19,29,25,57,179,3130,
20221019,648,645,해운대,장안,2895,33,25,143,68,173,3337,1608,15,13,4,8,102,1750,
20221019,648,646,해운대,기장일광,5302,36,35,35,189,291,5888,4761,25,27,54,59,264,5190,
20221019,651,652,남양주,화도,14277,563,549,491,321,1137,17338,15764,605,629,492,298,1246,19034,
20221019,651,653,남양주,서종,1837,12,24,4,45,75,1997,1837,19,21,3,37,57,1974,
20221019,651,654,남양주,설악,3716,33,78,25,17,132,4001,3320,22,71,19,13,126,3571,
20221019,651,655,남양주,강촌,2415,49,118,30,21,71,2704,2382,39,122,33,26,75,2677,
20221019,651,656,남양주,남춘천,2613,37,45,39,81,78,2893,2148,27,42,14,64,49,2344,
20221019,652,651,화도,남양주,15764,605,629,492,298,1246,19034,14277,563,549,491,321,1137,17338,
20221019,652,653,화도,서종,1409,30,31,21,23,102,1616,1475,39,24,15,29,106,1688,
20221019,652,654,화도,설악,1230,20,17,4,14,83,1368,1243,22,18,9,14,86,1392,
20221019,653,651,서종,남양주,1837,19,21,3,37,57,1974,1837,12,24,4,45,75,1997,
20221019,653,652,서종,화도,1475,39,24,15,29,106,1688,1409,30,31,21,23,102,1616,
20221019,654,651,설악,남양주,3320,22,71,19,13,126,3571,3716,33,78,25,17,132,4001,
20221019,654,652,설악,화도,1243,22,18,9,14,86,1392,1230,20,17,4,14,83,1368,
20221019,655,651,강촌,남양주,2382,39,122,33,26,75,2677,2415,49,118,30,21,71,2704,
20221019,656,651,남춘천,남양주,2148,27,42,14,64,49,2344,2613,37,45,39,81,78,2893,
20221019,671,672,봉담,정남,3182,163,93,77,150,225,3890,3899,179,94,82,170,279,4703,
20221019,671,673,봉담,북오산,1860,53,44,26,17,133,2133,1956,53,35,25,18,147,2234,
20221019,671,676,봉담,향남,1426,107,51,41,41,114,1780,1234,97,44,26,37,98,1536,
20221019,671,677,봉담,북평택,7329,217,271,161,244,434,8656,7150,176,221,131,214,406,8298,
20221019,672,671,정남,봉담,3899,179,94,82,170,279,4703,3182,163,93,77,150,225,3890,
20221019,673,101,북오산,서울,1609,43,117,21,17,110,1917,1709,40,111,22,15,99,1996,
20221019,673,671,북오산,봉담,1956,53,35,25,18,147,2234,1860,53,44,26,17,133,2133,
20221019,673,677,북오산,북평택,1868,44,82,24,33,142,2193,1839,49,61,30,21,145,2145,
20221019,675,676,서오산,향남,3585,126,79,89,28,239,4146,3183,107,63,76,23,227,3679,
20221019,675,677,서오산,북평택,11356,251,439,168,222,738,13174,10909,241,392,191,200,711,12644,
20221019,675,876,서오산,양감,1823,55,48,46,70,123,2165,2150,72,35,35,72,165,2529,
20221019,676,671,향남,봉담,1234,97,44,26,37,98,1536,1426,107,51,41,41,114,1780,
20221019,676,675,향남,서오산,3183,107,63,76,23,227,3679,3585,126,79,89,28,239,4146,
20221019,676,677,향남,북평택,1703,160,169,199,184,122,2537,1517,163,141,179,159,107,2266,
20221019,677,101,북평택,서울,1771,61,282,100,147,77,2438,1730,66,295,75,126,98,2390,
20221019,677,671,북평택,봉담,7150,176,221,131,214,406,8298,7329,217,271,161,244,434,8656,
20221019,677,673,북평택,북오산,1839,49,61,30,21,145,2145,1868,44,82,24,33,142,2193,
20221019,677,675,북평택,서오산,10909,241,392,191,200,711,12644,11356,251,439,168,222,738,13174,
20221019,677,676,북평택,향남,1517,163,141,179,159,107,2266,1703,160,169,199,184,122,2537,
20221019,677,876,북평택,양감,2255,158,201,211,205,157,3187,2198,178,221,219,198,139,3153,
20221019,682,683,조암,송산마도,799,92,101,78,69,46,1185,948,104,121,79,55,52,1359,
20221019,682,684,조암,남안산,1077,171,193,101,128,38,1708,1133,154,186,105,119,48,1745,
20221019,682,685,조암,서시흥,1697,186,165,175,279,90,2592,1875,172,177,183,329,100,2836,
20221019,683,682,송산마도,조암,948,104,121,79,55,52,1359,799,92,101,78,69,46,1185,
20221019,683,684,송산마도,남안산,2548,208,158,98,235,141,3388,2319,189,128,95,156,140,3027,
20221019,683,685,송산마도,서시흥,5092,293,235,219,1007,296,7142,4761,272,243,212,930,286,6704,
20221019,684,682,남안산,조암,1133,154,186,105,119,48,1745,1077,171,193,101,128,38,1708,
20221019,684,683,남안산,송산마도,2319,189,128,95,156,140,3027,2548,208,158,98,235,141,3388,
20221019,684,685,남안산,서시흥,5394,530,315,470,620,402,7731,5088,405,349,408,458,379,7087,
20221019,685,682,서시흥,조암,1875,172,177,183,329,100,2836,1697,186,165,175,279,90,2592,
20221019,685,683,서시흥,송산마도,4761,272,243,212,930,286,6704,5092,293,235,219,1007,296,7142,
20221019,685,684,서시흥,남안산,5088,405,349,408,458,379,7087,5394,530,315,470,620,402,7731,
20221019,705,190,남이천,동서울,1925,106,68,118,60,64,2341,1463,92,72,122,86,48,1883,
20221019,706,641,남경주,울산,1157,5,17,16,13,48,1256,1127,6,13,10,17,65,1238,
20221019,706,707,남경주,남포항,1001,29,69,29,229,57,1414,1114,29,68,34,218,66,1529,
20221019,707,641,남포항,울산,1138,21,33,21,129,71,1413,1076,17,14,15,139,62,1323,
20221019,707,706,남포항,남경주,1114,29,68,34,218,66,1529,1001,29,69,29,229,57,1414,
20221019,707,708,남포항,동경주,1323,25,27,29,280,81,1765,1398,28,25,23,322,77,1873,
20221019,708,707,동경주,남포항,1398,28,25,23,322,77,1873,1323,25,27,29,280,81,1765,
20221019,715,716,동안동,청송,1144,28,21,17,14,54,1278,1131,24,15,11,25,56,1262,
20221019,716,715,청송,동안동,1131,24,15,11,25,56,1262,1144,28,21,17,14,54,1278,
20221019,730,519,유천,남대구,2839,62,14,0,0,193,3108,2442,57,13,3,9,159,2683,
20221019,731,519,북현풍,남대구,1481,27,5,0,1,104,1618,1989,25,38,0,18,117,2187,
20221019,741,520,평택고덕,평택,846,15,185,16,23,62,1147,883,14,218,27,20,72,1234,
20221019,741,540,평택고덕,청북,944,38,53,79,26,101,1241,942,28,46,57,23,87,1183,
20221019,742,107,남사진위,안성,1341,41,52,30,12,118,1594,1295,49,52,27,8,111,1542,
20221019,742,108,남사진위,천안,985,27,44,33,10,70,1169,1102,22,35,25,6,82,1272,
20221019,752,252,기장철마,대동,1757,74,59,42,83,148,2163,1814,66,52,36,142,148,2258,
20221019,753,252,금정,대동,1111,63,67,69,85,74,1469,1844,100,93,96,178,118,2429,
20221019,755,140,광재,부산,949,14,18,7,38,64,1090,1105,10,24,10,47,75,1271,
20221019,755,252,광재,대동,2285,96,88,118,532,135,3254,2394,117,109,122,310,162,3214,
20221019,756,252,한림,대동,949,59,53,32,151,38,1282,869,45,44,27,89,45,1119,
20221019,757,289,진영,마산,812,52,59,31,68,56,1078,733,44,58,39,107,45,1026,
20221019,772,774,북달성,남칠곡,2522,54,60,40,41,153,2870,2509,49,62,37,32,156,2845,
20221019,773,774,북다사,남칠곡,1337,19,20,5,27,87,1495,1286,32,23,12,19,82,1454,
20221019,774,772,남칠곡,북달성,2509,49,62,37,32,156,2845,2522,54,60,40,41,153,2870,
20221019,774,773,남칠곡,북다사,1286,32,23,12,19,82,1454,1337,19,20,5,27,87,1495,
20221019,775,203,동명동호,가산,1679,66,46,50,233,85,2159,1609,72,48,41,268,75,2113,
20221019,776,777,연경,파군재,3252,47,34,21,25,276,3655,2360,38,35,20,22,202,2677,
20221019,776,779,연경,율암,5797,89,77,68,154,449,6634,5967,103,93,81,150,438,6832,
20221019,777,776,파군재,연경,2360,38,35,20,22,202,2677,3252,47,34,21,25,276,3655,
20221019,777,779,파군재,율암,2489,22,24,2,5,223,2765,2465,22,32,3,7,192,2721,
20221019,779,776,율암,연경,5967,103,93,81,150,438,6832,5797,89,77,68,154,449,6634,
20221019,779,777,율암,파군재,2465,22,32,3,7,192,2721,2489,22,24,2,5,223,2765,
20221019,876,675,양감,서오산,2150,72,35,35,72,165,2529,1823,55,48,46,70,123,2165,
20221019,876,677,양감,북평택,2198,178,221,219,198,139,3153,2255,158,201,211,205,157,3187,
20221019,981,982,서영암,강진무위사,1828,47,67,67,52,76,2137,1751,41,80,85,57,75,2089,
20221019,981,987,서영암,남순천,1515,24,102,65,326,37,2069,1481,28,104,97,350,38,2098,
20221019,982,981,강진무위사,서영암,1751,41,80,85,57,75,2089,1828,47,67,67,52,76,2137,
20221019,984,985,보성,벌교,1510,41,52,36,81,39,1759,1396,49,47,24,59,29,1604,
20221019,984,987,보성,남순천,1781,40,100,82,309,71,2383,1804,57,100,56,260,62,2339,
20221019,985,984,벌교,보성,1396,49,47,24,59,29,1604,1510,41,52,36,81,39,1759,
20221019,986,987,고흥,남순천,3403,66,111,134,259,144,4117,3835,87,105,159,278,158,4622,
20221019,987,981,남순천,서영암,1481,28,104,97,350,38,2098,1515,24,102,65,326,37,2069,
20221019,987,984,남순천,보성,1804,57,100,56,260,62,2339,1781,40,100,82,309,71,2383,
20221019,987,986,남순천,고흥,3835,87,105,159,278,158,4622,3403,66,111,134,259,144,4117,
20221020,101,102,서울,동수원,3947,58,268,12,12,230,4527,5481,58,389,18,24,295,6265,
20221020,101,103,서울,수원신갈,15813,659,1769,437,128,790,19596,15297,698,1750,384,112,743,18984,
20221020,101,105,서울,기흥,7339,98,408,82,38,316,8281,6132,90,368,100,46,283,7019,
20221020,101,106,서울,오산,4214,373,443,167,73,262,5532,4290,462,477,188,98,278,5793,
20221020,101,107,서울,안성,3249,87,316,45,24,184,3905,2899,69,310,48,26,130,3482,
20221020,101,108,서울,천안,3920,80,328,43,6,179,4556,3916,75,334,50,16,169,4560,
20221020,101,111,서울,청주,962,17,173,22,27,30,1231,825,16,207,27,21,28,1124,
20221020,101,171,서울,마성,2492,35,304,52,3,123,3009,2705,32,333,52,11,147,3280,
20221020,101,172,서울,용인,3461,162,131,47,20,237,4058,3989,172,134,64,33,243,4635,
20221020,101,173,서울,양지,3500,201,122,109,72,139,4143,4277,400,146,153,102,169,5247,
20221020,101,229,서울,북천안,798,52,48,62,27,36,1023,834,54,51,66,28,27,1060,
20221020,101,528,서울,기흥동탄,7189,77,1178,133,10,354,8941,7496,74,1305,135,19,346,9375,
20221020,101,542,서울,서안성,1339,45,84,87,32,77,1664,1798,49,75,183,55,87,2247,
20221020,101,543,서울,남안성,1140,76,51,57,81,55,1460,1213,97,71,94,78,52,1605,
20221020,101,673,서울,북오산,1608,30,130,16,11,116,1911,1612,44,130,22,12,104,1924,
20221020,101,677,서울,북평택,1444,58,273,79,110,69,2033,1597,70,259,94,120,66,2206,
20221020,102,101,동수원,서울,5481,58,389,18,24,295,6265,3947,58,268,12,12,230,4527,
20221020,102,172,동수원,용인,1080,27,23,5,9,97,1241,1086,29,21,7,3,90,1236,
20221020,102,173,동수원,양지,1206,49,28,3,14,74,1374,1343,49,35,7,9,91,1534,
20221020,102,212,동수원,북수원,4295,32,239,13,33,255,4867,4780,45,241,14,22,288,5390,
20221020,102,213,동수원,부곡,1054,16,16,2,30,91,1209,1024,16,15,3,24,87,1169,
20221020,102,214,동수원,동군포,1520,24,19,10,5,92,1670,1731,25,21,8,5,99,1889,
20221020,102,215,동수원,군포,1642,18,27,8,15,101,1811,2356,18,54,10,8,176,2622,
20221020,102,253,동수원,서서울,5896,69,69,17,31,352,6434,5224,67,79,22,22,363,5777,
20221020,102,254,동수원,군자,3914,61,74,20,28,219,4316,4337,70,85,26,34,231,4783,
20221020,102,255,동수원,서안산,1798,36,13,12,6,91,1956,1968,41,23,12,3,108,2155,
20221020,103,101,수원신갈,서울,15297,698,1750,384,112,743,18984,15813,659,1769,437,128,790,19596,
20221020,103,105,수원신갈,기흥,1716,31,47,36,24,114,1968,2178,25,35,28,26,132,2424,
20221020,103,106,수원신갈,오산,987,75,65,33,19,64,1243,1268,80,76,44,11,86,1565,
20221020,103,107,수원신갈,안성,914,19,45,4,4,60,1046,1015,18,53,6,3,65,1160,
20221020,103,108,수원신갈,천안,998,5,59,13,4,38,1117,1225,10,50,18,6,55,1364,
20221020,103,253,수원신갈,서서울,2108,140,71,64,24,130,2537,2144,140,94,71,35,133,2617,
20221020,103,254,수원신갈,군자,1507,94,66,89,78,87,1921,1841,131,75,126,105,110,2388,
20221020,103,528,수원신갈,기흥동탄,1454,20,206,7,0,98,1785,1995,23,180,7,3,110,2318,
20221020,105,101,기흥,서울,6132,90,368,100,46,283,7019,7339,98,408,82,38,316,8281,
20221020,105,103,기흥,수원신갈,2178,25,35,28,26,132,2424,1716,31,47,36,24,114,1968,
20221020,106,101,오산,서울,4290,462,477,188,98,278,5793,4214,373,443,167,73,262,5532,
20221020,106,103,오산,수원신갈,1268,80,76,44,11,86,1565,987,75,65,33,19,64,1243,
20221020,106,107,오산,안성,1705,59,44,21,10,129,1968,1433,50,21,18,5,119,1646,
20221020,106,108,오산,천안,1053,23,27,16,5,72,1196,1046,24,28,19,5,78,1200,
20221020,106,528,오산,기흥동탄,930,30,52,17,25,62,1116,1001,38,53,17,12,86,1207,
20221020,107,101,안성,서울,2899,69,310,48,26,130,3482,3249,87,316,45,24,184,3905,
20221020,107,103,안성,수원신갈,1015,18,53,6,3,65,1160,914,19,45,4,4,60,1046,
20221020,107,106,안성,오산,1433,50,21,18,5,119,1646,1705,59,44,21,10,129,1968,
20221020,107,108,안성,천안,1544,24,47,8,8,127,1758,1568,28,50,13,7,138,1804,
20221020,107,528,안성,기흥동탄,1043,12,28,3,7,105,1198,1259,23,32,5,9,103,1431,
20221020,107,742,안성,남사진위,1325,36,51,22,8,105,1547,1375,37,61,38,8,122,1641,
20221020,108,101,천안,서울,3916,75,334,50,16,169,4560,3920,80,328,43,6,179,4556,
20221020,108,103,천안,수원신갈,1225,10,50,18,6,55,1364,998,5,59,13,4,38,1117,
20221020,108,106,천안,오산,1046,24,28,19,5,78,1200,1053,23,27,16,5,72,1196,
20221020,108,107,천안,안성,1568,28,50,13,7,138,1804,1544,24,47,8,8,127,1758,
20221020,108,110,천안,목천,1200,32,57,26,25,69,1409,836,25,54,26,24,57,1022,
20221020,108,111,천안,청주,1095,36,59,17,41,77,1325,1074,28,58,31,37,82,1310,
20221020,108,229,천안,북천안,3414,74,129,60,35,215,3927,3840,88,143,70,80,236,4457,
20221020,108,528,천안,기흥동탄,1135,15,109,1,14,64,1338,1134,29,127,2,10,68,1370,
20221020,108,742,천안,남사진위,1292,27,26,20,7,76,1448,1103,37,36,23,5,63,1267,
20221020,110,108,목천,천안,836,25,54,26,24,57,1022,1200,32,57,26,25,69,1409,
20221020,111,101,청주,서울,825,16,207,27,21,28,1124,962,17,173,22,27,30,1231,
20221020,111,108,청주,천안,1074,28,58,31,37,82,1310,1095,36,59,17,41,77,1325,
20221020,112,115,남청주,대전,1630,83,61,5,17,128,1924,1612,86,56,8,3,130,1895,
20221020,113,115,신탄진,대전,935,23,11,7,17,121,1114,1084,24,11,6,9,126,1260,
20221020,114,153,남대전,서대전,1893,46,55,57,76,132,2259,1747,34,80,52,64,129,2106,
20221020,115,112,대전,남청주,1612,86,56,8,3,130,1895,1630,83,61,5,17,128,1924,
20221020,115,113,대전,신탄진,1084,24,11,6,9,126,1260,935,23,11,7,17,121,1114,
20221020,115,116,대전,옥천,2320,91,53,30,21,154,2669,2020,57,43,31,20,149,2320,
20221020,115,151,대전,북대전,1121,15,13,3,4,126,1282,893,8,17,5,4,110,1037,
20221020,115,152,대전,유성,957,7,16,0,1,86,1067,960,13,19,1,4,66,1063,
20221020,115,153,대전,서대전,994,26,8,1,2,87,1118,918,19,12,1,4,82,1036,
20221020,115,579,대전,남세종,1043,17,17,0,72,74,1223,1077,11,15,4,66,86,1259,
20221020,116,115,옥천,대전,2020,57,43,31,20,149,2320,2320,91,53,30,21,154,2669,
20221020,119,153,판암,서대전,1763,29,23,13,58,140,2026,1847,24,28,10,60,131,2100,
20221020,123,127,구미,서대구,1686,39,23,19,6,98,1871,1740,34,44,14,8,88,1928,
20221020,123,129,구미,북대구,1793,14,70,11,2,88,1978,1961,13,68,9,4,103,2158,
20221020,123,130,구미,동김천,1253,22,45,35,20,74,1449,1119,28,42,29,22,82,1322,
20221020,125,127,남구미,서대구,1833,50,103,45,16,117,2164,2105,67,126,47,21,136,2502,
20221020,125,129,남구미,북대구,1906,32,75,8,9,102,2132,2103,19,85,27,11,114,2359,
20221020,126,127,왜관,서대구,2501,116,76,44,118,132,2987,2853,108,76,43,84,151,3315,
20221020,126,129,왜관,북대구,2978,98,58,21,93,141,3389,3311,103,77,23,83,176,3773,
20221020,127,123,서대구,구미,1740,34,44,14,8,88,1928,1686,39,23,19,6,98,1871,
20221020,127,125,서대구,남구미,2105,67,126,47,21,136,2502,1833,50,103,45,16,117,2164,
20221020,127,126,서대구,왜관,2853,108,76,43,84,151,3315,2501,116,76,44,118,132,2987,
20221020,127,131,서대구,경산,2562,189,155,106,67,167,3246,1828,143,98,73,63,127,2332,
20221020,127,203,서대구,가산,2135,77,84,35,117,110,2558,1937,60,62,28,145,108,2340,
20221020,127,230,서대구,팔공산,1507,42,53,15,3,84,1704,1100,32,40,13,2,79,1266,
20221020,127,518,서대구,칠곡물류,850,111,85,100,26,51,1223,706,93,78,72,21,50,1020,
20221020,127,621,서대구,동대구,1843,58,64,26,23,107,2121,1312,48,29,24,16,87,1516,
20221020,129,123,북대구,구미,1961,13,68,9,4,103,2158,1793,14,70,11,2,88,1978,
20221020,129,125,북대구,남구미,2103,19,85,27,11,114,2359,1906,32,75,8,9,102,2132,
20221020,129,126,북대구,왜관,3311,103,77,23,83,176,3773,2978,98,58,21,93,141,3389,
20221020,129,131,북대구,경산,2260,165,74,56,35,134,2724,2901,200,119,79,49,164,3512,
20221020,129,524,북대구,청통와촌,934,47,27,10,21,40,1079,1198,83,34,17,28,58,1418,
20221020,129,527,북대구,포항,1508,32,38,28,67,67,1740,1859,51,49,32,76,101,2168,
20221020,130,123,동김천,구미,1119,28,42,29,22,82,1322,1253,22,45,35,20,74,1449,
20221020,131,127,경산,서대구,1828,143,98,73,63,127,2332,2562,189,155,106,67,167,3246,
20221020,131,129,경산,북대구,2901,200,119,79,49,164,3512,2260,165,74,56,35,134,2724,
20221020,131,132,경산,영천,894,43,37,47,54,51,1126,841,53,67,34,41,51,1087,
20221020,131,230,경산,팔공산,1278,80,42,17,21,98,1536,1545,76,62,81,21,102,1887,
20221020,131,621,경산,동대구,2261,61,44,310,52,140,2868,2427,65,53,260,45,146,2996,
20221020,132,131,영천,경산,841,53,67,34,41,51,1087,894,43,37,47,54,51,1126,
20221020,132,621,영천,동대구,1109,7,24,5,39,45,1229,1152,19,23,6,34,51,1285,
20221020,135,140,경주,부산,1179,18,34,6,42,57,1336,1219,19,33,7,33,53,1364,
20221020,135,252,경주,대동,975,40,95,62,191,53,1416,1145,42,104,44,104,56,1495,
20221020,138,140,양산,부산,5037,266,174,237,236,285,6235,5320,303,202,254,248,298,6625,
20221020,138,252,양산,대동,2676,317,209,177,366,127,3872,2978,321,212,203,355,156,4225,
20221020,139,140,서울산,부산,1324,40,19,8,15,79,1485,1242,41,28,8,18,74,1411,
20221020,139,252,서울산,대동,854,42,56,36,44,36,1068,856,33,34,40,36,40,1039,
20221020,139,641,서울산,울산,1166,32,81,32,37,97,1445,1030,21,58,14,27,71,1221,
20221020,140,135,부산,경주,1219,19,33,7,33,53,1364,1179,18,34,6,42,57,1336,
20221020,140,138,부산,양산,5320,303,202,254,248,298,6625,5037,266,174,237,236,285,6235,
20221020,140,139,부산,서울산,1242,41,28,8,18,74,1411,1324,40,19,8,15,79,1485,
20221020,140,250,부산,남양산,7989,155,226,30,41,649,9090,7999,142,208,25,44,627,9045,
20221020,140,251,부산,물금,1030,142,19,30,52,76,1349,1055,96,34,26,53,66,1330,
20221020,140,252,부산,대동,1734,58,52,44,57,103,2048,1586,46,42,43,102,67,1886,
20221020,140,755,부산,광재,1046,14,24,6,32,71,1193,974,17,17,5,53,63,1129,
20221020,142,145,군북,산인,3926,77,126,41,83,275,4528,3971,81,118,56,86,287,4599,
20221020,143,145,장지,산인,1227,29,28,27,62,89,1462,1219,25,24,27,72,88,1455,
20221020,144,145,함안,산인,2034,49,47,21,119,146,2416,2015,51,37,33,113,142,2391,
20221020,145,142,산인,군북,3971,81,118,56,86,287,4599,3926,77,126,41,83,275,4528,
20221020,145,143,산인,장지,1219,25,24,27,72,88,1455,1227,29,28,27,62,89,1462,
20221020,145,144,산인,함안,2015,51,37,33,113,142,2391,2034,49,47,21,119,146,2416,
20221020,145,291,산인,사천,1575,43,51,18,20,71,1778,1548,60,60,20,17,67,1772,
20221020,145,292,산인,진주,1385,25,151,14,15,77,1667,1626,33,138,23,9,101,1930,
20221020,145,293,산인,문산,1217,26,24,11,5,79,1362,1152,22,22,18,6,87,1307,
20221020,146,150,동창원,북부산,1057,27,13,5,25,69,1196,978,15,14,1,17,55,1080,
20221020,146,244,동창원,서부산,1257,20,41,18,32,76,1444,1259,35,52,20,42,82,1490,
20221020,146,245,동창원,장유,947,18,10,8,4,101,1088,990,13,21,9,9,92,1134,
20221020,146,289,동창원,마산,2636,73,73,39,84,237,3142,2411,79,75,37,62,214,2878,
20221020,147,150,진례,북부산,1391,38,22,14,29,80,1574,1656,57,23,16,20,91,1863,
20221020,147,244,진례,서부산,1737,98,76,73,96,96,2176,1880,96,94,58,95,89,2312,
20221020,147,245,진례,장유,1072,65,81,57,22,111,1408,1404,54,90,50,26,138,1762,
20221020,147,289,진례,마산,1317,112,78,63,88,84,1742,1277,95,77,48,66,87,1650,
20221020,148,150,서김해,북부산,6552,133,74,82,102,511,7454,6509,132,88,76,74,515,7394,
20221020,148,251,서김해,물금,889,35,14,29,8,79,1054,904,45,17,28,6,93,1093,
20221020,148,289,서김해,마산,1439,29,55,12,9,107,1651,1471,30,63,15,12,109,1700,
20221020,149,150,동김해,북부산,10823,187,191,42,63,906,12212,9240,162,137,35,62,794,10430,
20221020,149,250,동김해,남양산,1125,25,48,7,8,84,1297,974,18,47,6,9,75,1129,
20221020,149,251,동김해,물금,1148,40,12,8,6,118,1332,1101,32,12,9,4,115,1273,
20221020,150,146,북부산,동창원,978,15,14,1,17,55,1080,1057,27,13,5,25,69,1196,
20221020,150,147,북부산,진례,1656,57,23,16,20,91,1863,1391,38,22,14,29,80,1574,
20221020,150,148,북부산,서김해,6509,132,88,76,74,515,7394,6552,133,74,82,102,511,7454,
20221020,150,149,북부산,동김해,9240,162,137,35,62,794,10430,10823,187,191,42,63,906,12212,
20221020,150,245,북부산,장유,3717,36,75,11,39,261,4139,3214,37,79,9,25,229,3593,
20221020,150,289,북부산,마산,2488,30,72,7,28,138,2763,2833,46,70,16,32,169,3166,
20221020,151,115,북대전,대전,893,8,17,5,4,110,1037,1121,15,13,3,4,126,1282,
20221020,151,153,북대전,서대전,1090,17,18,16,24,85,1250,1306,12,30,23,13,101,1485,
20221020,152,115,유성,대전,960,13,19,1,4,66,1063,957,7,16,0,1,86,1067,
20221020,152,154,유성,안영,909,26,34,10,45,57,1081,1065,28,19,8,33,59,1212,
20221020,153,114,서대전,남대전,1747,34,80,52,64,129,2106,1893,46,55,57,76,132,2259,
20221020,153,115,서대전,대전,918,19,12,1,4,82,1036,994,26,8,1,2,87,1118,
20221020,153,119,서대전,판암,1847,24,28,10,60,131,2100,1763,29,23,13,58,140,2026,
20221020,153,151,서대전,북대전,1306,12,30,23,13,101,1485,1090,17,18,16,24,85,1250,
20221020,153,154,서대전,안영,1099,31,43,35,84,69,1361,1097,40,39,35,69,77,1357,
20221020,153,579,서대전,남세종,1218,18,13,10,11,105,1375,1029,22,17,9,7,86,1170,
20221020,154,152,안영,유성,1065,28,19,8,33,59,1212,909,26,34,10,45,57,1081,
20221020,154,153,안영,서대전,1097,40,39,35,69,77,1357,1099,31,43,35,84,69,1361,
20221020,159,167,서전주,광주,1466,63,73,43,54,51,1750,1424,73,65,36,55,57,1710,
20221020,163,167,정읍,광주,845,41,50,31,27,31,1025,832,42,58,32,31,22,1017,
20221020,166,167,장성,광주,2249,82,69,37,68,91,2596,2688,110,75,44,50,113,3080,
20221020,167,159,광주,서전주,1424,73,65,36,55,57,1710,1466,63,73,43,54,51,1750,
20221020,167,163,광주,정읍,832,42,58,32,31,22,1017,845,41,50,31,27,31,1025,
20221020,167,166,광주,장성,2688,110,75,44,50,113,3080,2249,82,69,37,68,91,2596,
20221020,167,567,광주,남고창,1234,25,50,15,25,44,1393,1250,25,52,11,35,45,1418,
20221020,171,101,마성,서울,2705,32,333,52,11,147,3280,2492,35,304,52,3,123,3009,
20221020,172,101,용인,서울,3989,172,134,64,33,243,4635,3461,162,131,47,20,237,4058,
20221020,172,102,용인,동수원,1086,29,21,7,3,90,1236,1080,27,23,5,9,97,1241,
20221020,172,173,용인,양지,2032,242,132,143,108,147,2804,1813,195,154,160,98,145,2565,
20221020,172,212,용인,북수원,865,39,17,17,28,65,1031,1142,51,17,21,21,74,1326,
20221020,172,253,용인,서서울,1120,55,21,26,15,58,1295,1054,71,26,35,13,65,1264,
20221020,173,101,양지,서울,4277,400,146,153,102,169,5247,3500,201,122,109,72,139,4143,
20221020,173,102,양지,동수원,1343,49,35,7,9,91,1534,1206,49,28,3,14,74,1374,
20221020,173,172,양지,용인,1813,195,154,160,98,145,2565,2032,242,132,143,108,147,2804,
20221020,173,212,양지,북수원,1191,87,50,64,20,59,1471,1171,96,54,54,44,63,1482,
20221020,173,253,양지,서서울,1202,121,82,124,49,53,1631,914,133,55,75,34,46,1257,
20221020,173,254,양지,군자,786,115,80,166,213,36,1396,687,112,91,154,197,33,1274,
20221020,174,179,춘천,홍천,3115,85,87,44,27,344,3702,2922,71,76,35,25,340,3469,
20221020,174,216,춘천,횡성,1060,46,49,17,47,59,1278,1073,51,38,11,25,63,1261,
20221020,174,218,춘천,남원주,1090,38,73,13,29,66,1309,1089,25,65,17,31,65,1292,
20221020,174,554,춘천,동홍천,1194,16,17,18,12,91,1348,1243,16,17,8,5,102,1391,
20221020,176,190,이천,동서울,1607,64,217,148,100,76,2212,1465,60,218,140,68,71,2022,
20221020,179,174,홍천,춘천,2922,71,76,35,25,340,3469,3115,85,87,44,27,344,3702,
20221020,184,189,대관령,강릉,1294,36,62,6,12,73,1483,1377,34,52,7,10,82,1562,
20221020,189,184,강릉,대관령,1377,34,52,7,10,82,1562,1294,36,62,6,12,73,1483,
20221020,190,176,동서울,이천,1465,60,218,140,68,71,2022,1607,64,217,148,100,76,2212,
20221020,190,191,동서울,경기광주,10638,726,470,342,258,702,13136,10532,667,451,296,273,733,12952,
20221020,190,192,동서울,곤지암,6306,511,261,194,94,388,7754,5640,444,198,186,70,372,6910,
20221020,190,193,동서울,일죽,2438,155,206,175,115,88,3177,2407,173,186,265,111,93,3235,
20221020,190,194,동서울,서이천,4281,607,312,256,179,230,5865,3301,446,269,237,118,190,4561,
20221020,190,560,동서울,감곡,1001,22,30,44,49,38,1184,830,27,36,39,78,26,1036,
20221020,190,705,동서울,남이천,1531,87,80,118,128,47,1991,1703,104,65,105,102,61,2140,
20221020,191,190,경기광주,동서울,10532,667,451,296,273,733,12952,10638,726,470,342,258,702,13136,
20221020,192,190,곤지암,동서울,5640,444,198,186,70,372,6910,6306,511,261,194,94,388,7754,
20221020,192,194,곤지암,서이천,1344,272,115,166,91,102,2090,1091,163,99,138,120,80,1691,
20221020,193,190,일죽,동서울,2407,173,186,265,111,93,3235,2438,155,206,175,115,88,3177,
20221020,194,190,서이천,동서울,3301,446,269,237,118,190,4561,4281,607,312,256,179,230,5865,
20221020,194,192,서이천,곤지암,1091,163,99,138,120,80,1691,1344,272,115,166,91,102,2090,
20221020,196,198,진천,서청주,1208,45,91,37,36,75,1492,1290,42,81,31,25,76,1545,
20221020,198,196,서청주,진천,1290,42,81,31,25,76,1545,1208,45,91,37,36,75,1492,
20221020,201,203,칠곡,가산,885,39,35,36,141,65,1201,904,38,44,35,172,45,1238,
20221020,203,127,가산,서대구,1937,60,62,28,145,108,2340,2135,77,84,35,117,110,2558,
20221020,203,201,가산,칠곡,904,38,44,35,172,45,1238,885,39,35,36,141,65,1201,
20221020,203,775,가산,동명동호,1683,62,43,53,286,75,2202,1745,62,51,50,259,68,2235,
20221020,212,102,북수원,동수원,4780,45,241,14,22,288,5390,4295,32,239,13,33,255,4867,
20221020,212,172,북수원,용인,1142,51,17,21,21,74,1326,865,39,17,17,28,65,1031,
20221020,212,173,북수원,양지,1171,96,54,54,44,63,1482,1191,87,50,64,20,59,1471,
20221020,212,253,북수원,서서울,2958,52,34,16,21,173,3254,1007,26,24,4,5,58,1124,
20221020,212,254,북수원,군자,1784,31,31,21,31,108,2006,1157,31,28,12,29,82,1339,
20221020,213,102,부곡,동수원,1024,16,15,3,24,87,1169,1054,16,16,2,30,91,1209,
20221020,213,253,부곡,서서울,1551,69,40,42,187,103,1992,969,46,38,40,136,67,1296,
20221020,213,254,부곡,군자,984,24,27,44,443,70,1592,837,30,27,36,330,65,1325,
20221020,214,102,동군포,동수원,1731,25,21,8,5,99,1889,1520,24,19,10,5,92,1670,
20221020,215,102,군포,동수원,2356,18,54,10,8,176,2622,1642,18,27,8,15,101,1811,
20221020,215,253,군포,서서울,3410,90,70,31,68,221,3890,3815,143,137,177,88,230,4590,
20221020,215,254,군포,군자,2137,71,62,41,79,164,2554,3007,155,88,139,127,202,3718,
20221020,215,255,군포,서안산,1343,58,37,19,25,93,1575,1484,71,58,72,91,125,1901,
20221020,216,174,횡성,춘천,1073,51,38,11,25,63,1261,1060,46,49,17,47,59,1278,
20221020,218,174,남원주,춘천,1089,25,65,17,31,65,1292,1090,38,73,13,29,66,1309,
20221020,218,240,남원주,제천,2017,55,48,17,60,128,2325,2107,47,40,24,50,131,2399,
20221020,225,291,서진주,사천,1047,24,31,15,26,86,1229,1140,26,30,12,29,81,1318,
20221020,229,101,북천안,서울,834,54,51,66,28,27,1060,798,52,48,62,27,36,1023,
20221020,229,108,북천안,천안,3840,88,143,70,80,236,4457,3414,74,129,60,35,215,3927,
20221020,230,127,팔공산,서대구,1100,32,40,13,2,79,1266,1507,42,53,15,3,84,1704,
20221020,230,131,팔공산,경산,1545,76,62,81,21,102,1887,1278,80,42,17,21,98,1536,
20221020,230,524,팔공산,청통와촌,1220,41,30,8,8,59,1366,1034,37,24,12,12,52,1171,
20221020,230,527,팔공산,포항,1472,25,25,19,18,70,1629,1324,23,22,10,26,66,1471,
20221020,231,519,화원옥포,남대구,6324,182,112,132,228,512,7490,6171,160,120,128,113,444,7136,
20221020,232,519,달성,남대구,2840,124,162,57,29,200,3412,2994,125,144,53,28,192,3536,
20221020,233,519,현풍,남대구,4952,231,213,77,148,315,5936,4398,212,213,98,126,303,5350,
20221020,238,239,칠서,칠원,1617,97,134,151,428,81,2508,1664,92,121,135,469,99,2580,
20221020,239,238,칠원,칠서,1664,92,121,135,469,99,2580,1617,97,134,151,428,81,2508,
20221020,239,519,칠원,남대구,1104,52,74,37,100,38,1405,1154,67,89,47,73,41,1471,
20221020,240,218,제천,남원주,2107,47,40,24,50,131,2399,2017,55,48,17,60,128,2325,
20221020,241,519,동고령,남대구,3147,98,83,310,179,155,3972,2989,109,75,293,198,150,3814,
20221020,242,519,고령,남대구,1629,41,62,20,177,91,2020,1722,31,56,20,173,72,2074,
20221020,244,146,서부산,동창원,1259,35,52,20,42,82,1490,1257,20,41,18,32,76,1444,
20221020,244,147,서부산,진례,1880,96,94,58,95,89,2312,1737,98,76,73,96,96,2176,
20221020,244,245,서부산,장유,12859,264,403,155,374,958,15013,12578,260,391,136,405,921,14691,
20221020,244,289,서부산,마산,3026,60,261,43,72,177,3639,2850,64,239,48,67,142,3410,
20221020,245,146,장유,동창원,990,13,21,9,9,92,1134,947,18,10,8,4,101,1088,
20221020,245,147,장유,진례,1404,54,90,50,26,138,1762,1072,65,81,57,22,111,1408,
20221020,245,150,장유,북부산,3214,37,79,9,25,229,3593,3717,36,75,11,39,261,4139,
20221020,245,244,장유,서부산,12578,260,391,136,405,921,14691,12859,264,403,155,374,958,15013,
20221020,245,289,장유,마산,1510,36,49,20,34,132,1781,1423,19,37,16,10,109,1614,
20221020,250,140,남양산,부산,7999,142,208,25,44,627,9045,7989,155,226,30,41,649,9090,
20221020,250,149,남양산,동김해,974,18,47,6,9,75,1129,1125,25,48,7,8,84,1297,
20221020,250,252,남양산,대동,3285,152,92,143,107,234,4013,4051,176,125,129,127,308,4916,
20221020,251,140,물금,부산,1055,96,34,26,53,66,1330,1030,142,19,30,52,76,1349,
20221020,251,148,물금,서김해,904,45,17,28,6,93,1093,889,35,14,29,8,79,1054,
20221020,251,149,물금,동김해,1101,32,12,9,4,115,1273,1148,40,12,8,6,118,1332,
20221020,251,252,물금,대동,3125,219,108,143,532,263,4390,3830,218,97,164,556,291,5156,
20221020,252,135,대동,경주,1145,42,104,44,104,56,1495,975,40,95,62,191,53,1416,
20221020,252,138,대동,양산,2978,321,212,203,355,156,4225,2676,317,209,177,366,127,3872,
20221020,252,139,대동,서울산,856,33,34,40,36,40,1039,854,42,56,36,44,36,1068,
20221020,252,140,대동,부산,1586,46,42,43,102,67,1886,1734,58,52,44,57,103,2048,
20221020,252,250,대동,남양산,4051,176,125,129,127,308,4916,3285,152,92,143,107,234,4013,
20221020,252,251,대동,물금,3830,218,97,164,556,291,5156,3125,219,108,143,532,263,4390,
20221020,252,641,대동,울산,1685,66,89,36,41,87,2004,1412,73,88,38,67,75,1753,
20221020,252,752,대동,기장철마,1842,68,57,36,141,159,2303,1896,70,68,34,73,139,2280,
20221020,252,753,대동,금정,1848,98,77,81,170,111,2385,1144,75,62,58,91,62,1492,
20221020,252,755,대동,광재,2393,85,89,176,293,155,3191,2306,76,94,187,565,135,3363,
20221020,252,756,대동,한림,897,43,38,31,90,42,1141,967,56,34,43,144,39,1283,
20221020,253,102,서서울,동수원,5224,67,79,22,22,363,5777,5896,69,69,17,31,352,6434,
20221020,253,103,서서울,수원신갈,2144,140,94,71,35,133,2617,2108,140,71,64,24,130,2537,
20221020,253,172,서서울,용인,1054,71,26,35,13,65,1264,1120,55,21,26,15,58,1295,
20221020,253,173,서서울,양지,914,133,55,75,34,46,1257,1202,121,82,124,49,53,1631,
20221020,253,212,서서울,북수원,1007,26,24,4,5,58,1124,2958,52,34,16,21,173,3254,
20221020,253,213,서서울,부곡,969,46,38,40,136,67,1296,1551,69,40,42,187,103,1992,
20221020,253,215,서서울,군포,3815,143,137,177,88,230,4590,3410,90,70,31,68,221,3890,
20221020,253,255,서서울,서안산,15114,544,675,623,349,916,18221,14614,517,612,564,336,907,17550,
20221020,253,256,서서울,안산,9065,183,115,65,32,683,10143,6184,110,79,44,66,444,6927,
20221020,253,281,서서울,매송,3530,71,34,14,20,219,3888,3839,65,36,27,55,228,4250,
20221020,253,282,서서울,비봉,5320,256,244,136,396,293,6645,5558,294,279,168,437,351,7087,
20221020,253,283,서서울,발안,3244,159,174,166,125,186,4054,3650,204,183,183,149,221,4590,
20221020,253,285,서서울,서평택,1350,59,103,263,389,84,2248,1455,98,128,344,503,92,2620,
20221020,253,287,서서울,송악,1776,29,67,75,244,77,2268,1944,43,66,93,444,85,2675,
20221020,253,288,서서울,당진,1247,21,36,29,32,49,1414,1315,25,37,58,61,53,1549,
20221020,253,298,서서울,서산,2182,35,68,57,22,84,2448,2198,41,74,69,48,76,2506,
20221020,253,520,서서울,평택,2033,123,108,160,134,87,2645,2103,108,122,225,155,100,2813,
20221020,253,540,서서울,청북,755,51,58,110,61,47,1082,951,70,60,109,96,53,1339,
20221020,253,741,서서울,평택고덕,987,42,15,17,4,62,1127,942,32,30,36,14,63,1117,
20221020,254,102,군자,동수원,4337,70,85,26,34,231,4783,3914,61,74,20,28,219,4316,
20221020,254,103,군자,수원신갈,1841,131,75,126,105,110,2388,1507,94,66,89,78,87,1921,
20221020,254,173,군자,양지,687,112,91,154,197,33,1274,786,115,80,166,213,36,1396,
20221020,254,212,군자,북수원,1157,31,28,12,29,82,1339,1784,31,31,21,31,108,2006,
20221020,254,213,군자,부곡,837,30,27,36,330,65,1325,984,24,27,44,443,70,1592,
20221020,254,215,군자,군포,3007,155,88,139,127,202,3718,2137,71,62,41,79,164,2554,
20221020,254,255,군자,서안산,9899,428,231,238,316,667,11779,9542,436,200,204,273,647,11302,
20221020,254,256,군자,안산,4700,121,122,38,58,374,5413,4909,111,123,51,57,411,5662,
20221020,254,281,군자,매송,1029,39,22,23,80,72,1265,881,34,22,17,64,64,1082,
20221020,254,282,군자,비봉,1253,111,87,76,178,84,1789,1043,96,72,55,150,85,1501,
20221020,254,283,군자,발안,1155,86,68,72,171,73,1625,995,83,74,58,128,61,1399,
20221020,255,102,서안산,동수원,1968,41,23,12,3,108,2155,1798,36,13,12,6,91,1956,
20221020,255,215,서안산,군포,1484,71,58,72,91,125,1901,1343,58,37,19,25,93,1575,
20221020,255,253,서안산,서서울,14614,517,612,564,336,907,17550,15114,544,675,623,349,916,18221,
20221020,255,254,서안산,군자,9542,436,200,204,273,647,11302,9899,428,231,238,316,667,11779,
20221020,256,253,안산,서서울,6184,110,79,44,66,444,6927,9065,183,115,65,32,683,10143,
20221020,256,254,안산,군자,4909,111,123,51,57,411,5662,4700,121,122,38,58,374,5413,
20221020,261,263,동광주,옥과,2715,26,119,20,78,132,3090,2439,15,110,15,82,95,2756,
20221020,263,261,옥과,동광주,2439,15,110,15,82,95,2756,2715,26,119,20,78,132,3090,
20221020,271,569,순천,북광주,835,63,52,27,124,29,1130,830,63,53,33,104,35,1118,
20221020,281,253,매송,서서울,3839,65,36,27,55,228,4250,3530,71,34,14,20,219,3888,
20221020,281,254,매송,군자,881,34,22,17,64,64,1082,1029,39,22,23,80,72,1265,
20221020,282,253,비봉,서서울,5558,294,279,168,437,351,7087,5320,256,244,136,396,293,6645,
20221020,282,254,비봉,군자,1043,96,72,55,150,85,1501,1253,111,87,76,178,84,1789,
20221020,283,253,발안,서서울,3650,204,183,183,149,221,4590,3244,159,174,166,125,186,4054,
20221020,283,254,발안,군자,995,83,74,58,128,61,1399,1155,86,68,72,171,73,1625,
20221020,285,253,서평택,서서울,1455,98,128,344,503,92,2620,1350,59,103,263,389,84,2248,
20221020,285,287,서평택,송악,718,35,102,68,625,46,1594,738,39,92,78,480,58,1485,
20221020,285,520,서평택,평택,705,47,82,72,105,61,1072,750,40,77,85,112,66,1130,
20221020,287,253,송악,서서울,1944,43,66,93,444,85,2675,1776,29,67,75,244,77,2268,
20221020,287,285,송악,서평택,738,39,92,78,480,58,1485,718,35,102,68,625,46,1594,
20221020,288,253,당진,서서울,1315,25,37,58,61,53,1549,1247,21,36,29,32,49,1414,
20221020,289,146,마산,동창원,2411,79,75,37,62,214,2878,2636,73,73,39,84,237,3142,
20221020,289,147,마산,진례,1277,95,77,48,66,87,1650,1317,112,78,63,88,84,1742,
20221020,289,148,마산,서김해,1471,30,63,15,12,109,1700,1439,29,55,12,9,107,1651,
20221020,289,150,마산,북부산,2833,46,70,16,32,169,3166,2488,30,72,7,28,138,2763,
20221020,289,244,마산,서부산,2850,64,239,48,67,142,3410,3026,60,261,43,72,177,3639,
20221020,289,245,마산,장유,1423,19,37,16,10,109,1614,1510,36,49,20,34,132,1781,
20221020,291,145,사천,산인,1548,60,60,20,17,67,1772,1575,43,51,18,20,71,1778,
20221020,291,225,사천,서진주,1140,26,30,12,29,81,1318,1047,24,31,15,26,86,1229,
20221020,291,292,사천,진주,2902,79,93,40,56,260,3430,3723,94,104,57,61,289,4328,
20221020,292,145,진주,산인,1626,33,138,23,9,101,1930,1385,25,151,14,15,77,1667,
20221020,292,291,진주,사천,3723,94,104,57,61,289,4328,2902,79,93,40,56,260,3430,
20221020,293,145,문산,산인,1152,22,22,18,6,87,1307,1217,26,24,11,5,79,1362,
20221020,298,253,서산,서서울,2198,41,74,69,48,76,2506,2182,35,68,57,22,84,2448,
20221020,508,509,무안,목포,1352,52,31,37,69,61,1602,1725,54,46,33,72,79,2009,
20221020,508,553,무안,동광산,1402,32,50,20,29,61,1594,1515,38,47,27,22,61,1710,
20221020,509,508,목포,무안,1725,54,46,33,72,79,2009,1352,52,31,37,69,61,1602,
20221020,509,553,목포,동광산,6878,186,216,148,382,269,8079,7055,162,224,180,442,266,8329,
20221020,513,515,고성,북통영,1446,23,88,10,29,108,1704,1568,37,98,15,27,107,1852,
20221020,513,516,고성,통영,3025,97,167,77,141,210,3717,2748,88,155,76,138,198,3403,
20221020,514,516,동고성,통영,1257,22,60,75,139,165,1718,1201,18,65,85,157,154,1680,
20221020,515,513,북통영,고성,1568,37,98,15,27,107,1852,1446,23,88,10,29,108,1704,
20221020,516,513,통영,고성,2748,88,155,76,138,198,3403,3025,97,167,77,141,210,3717,
20221020,516,514,통영,동고성,1201,18,65,85,157,154,1680,1257,22,60,75,139,165,1718,
20221020,518,127,칠곡물류,서대구,706,93,78,72,21,50,1020,850,111,85,100,26,51,1223,
20221020,519,231,남대구,화원옥포,6171,160,120,128,113,444,7136,6324,182,112,132,228,512,7490,
20221020,519,232,남대구,달성,2994,125,144,53,28,192,3536,2840,124,162,57,29,200,3412,
20221020,519,233,남대구,현풍,4398,212,213,98,126,303,5350,4952,231,213,77,148,315,5936,
20221020,519,239,남대구,칠원,1154,67,89,47,73,41,1471,1104,52,74,37,100,38,1405,
20221020,519,241,남대구,동고령,2989,109,75,293,198,150,3814,3147,98,83,310,179,155,3972,
20221020,519,242,남대구,고령,1722,31,56,20,173,72,2074,1629,41,62,20,177,91,2020,
20221020,519,730,남대구,유천,2498,53,16,2,25,168,2762,2952,61,12,0,0,194,3219,
20221020,519,731,남대구,북현풍,2027,31,28,0,2,136,2224,1564,34,9,0,0,122,1729,
20221020,520,253,평택,서서울,2103,108,122,225,155,100,2813,2033,123,108,160,134,87,2645,
20221020,520,285,평택,서평택,750,40,77,85,112,66,1130,705,47,82,72,105,61,1072,
20221020,520,540,평택,청북,1061,79,155,144,90,69,1598,856,94,157,147,87,43,1384,
20221020,520,741,평택,평택고덕,895,13,214,18,19,71,1230,844,15,180,10,15,70,1134,
20221020,524,129,청통와촌,북대구,1198,83,34,17,28,58,1418,934,47,27,10,21,40,1079,
20221020,524,230,청통와촌,팔공산,1034,37,24,12,12,52,1171,1220,41,30,8,8,59,1366,
20221020,526,527,서포항,포항,877,15,23,5,24,72,1016,1015,12,24,2,26,81,1160,
20221020,527,129,포항,북대구,1859,51,49,32,76,101,2168,1508,32,38,28,67,67,1740,
20221020,527,230,포항,팔공산,1324,23,22,10,26,66,1471,1472,25,25,19,18,70,1629,
20221020,527,526,포항,서포항,1015,12,24,2,26,81,1160,877,15,23,5,24,72,1016,
20221020,528,101,기흥동탄,서울,7496,74,1305,135,19,346,9375,7189,77,1178,133,10,354,8941,
20221020,528,103,기흥동탄,수원신갈,1995,23,180,7,3,110,2318,1454,20,206,7,0,98,1785,
20221020,528,106,기흥동탄,오산,1001,38,53,17,12,86,1207,930,30,52,17,25,62,1116,
20221020,528,107,기흥동탄,안성,1259,23,32,5,9,103,1431,1043,12,28,3,7,105,1198,
20221020,528,108,기흥동탄,천안,1134,29,127,2,10,68,1370,1135,15,109,1,14,64,1338,
20221020,540,253,청북,서서울,951,70,60,109,96,53,1339,755,51,58,110,61,47,1082,
20221020,540,520,청북,평택,856,94,157,147,87,43,1384,1061,79,155,144,90,69,1598,
20221020,540,741,청북,평택고덕,874,25,48,57,45,95,1144,979,29,59,65,55,108,1295,
20221020,542,101,서안성,서울,1798,49,75,183,55,87,2247,1339,45,84,87,32,77,1664,
20221020,542,543,서안성,남안성,1116,51,96,110,128,90,1591,1145,56,89,104,101,97,1592,
20221020,543,101,남안성,서울,1213,97,71,94,78,52,1605,1140,76,51,57,81,55,1460,
20221020,543,542,남안성,서안성,1145,56,89,104,101,97,1592,1116,51,96,110,128,90,1591,
20221020,543,555,남안성,북진천,792,103,154,173,142,41,1405,805,110,155,164,165,49,1448,
20221020,548,553,북무안,동광산,1284,20,42,35,39,32,1452,1487,22,51,48,53,36,1697,
20221020,549,553,동함평,동광산,3278,51,58,37,53,125,3602,3397,47,64,40,62,120,3730,
20221020,551,553,나주,동광산,1320,30,38,84,54,79,1605,1384,27,35,80,48,70,1644,
20221020,552,553,서광산,동광산,4429,189,185,223,185,193,5404,5902,225,199,233,179,230,6968,
20221020,553,508,동광산,무안,1515,38,47,27,22,61,1710,1402,32,50,20,29,61,1594,
20221020,553,509,동광산,목포,7055,162,224,180,442,266,8329,6878,186,216,148,382,269,8079,
20221020,553,548,동광산,북무안,1487,22,51,48,53,36,1697,1284,20,42,35,39,32,1452,
20221020,553,549,동광산,동함평,3397,47,64,40,62,120,3730,3278,51,58,37,53,125,3602,
20221020,553,551,동광산,나주,1384,27,35,80,48,70,1644,1320,30,38,84,54,79,1605,
20221020,553,552,동광산,서광산,5902,225,199,233,179,230,6968,4429,189,185,223,185,193,5404,
20221020,554,174,동홍천,춘천,1243,16,17,8,5,102,1391,1194,16,17,18,12,91,1348,
20221020,555,543,북진천,남안성,805,110,155,164,165,49,1448,792,103,154,173,142,41,1405,
20221020,560,190,감곡,동서울,830,27,36,39,78,26,1036,1001,22,30,44,49,38,1184,
20221020,567,167,남고창,광주,1250,25,52,11,35,45,1418,1234,25,50,15,25,44,1393,
20221020,569,271,북광주,순천,830,63,53,33,104,35,1118,835,63,52,27,124,29,1130,
20221020,579,115,남세종,대전,1077,11,15,4,66,86,1259,1043,17,17,0,72,74,1223,
20221020,579,153,남세종,서대전,1029,22,17,9,7,86,1170,1218,18,13,10,11,105,1375,
20221020,587,589,오수,상관,1113,19,42,21,57,37,1289,1269,20,52,19,156,47,1563,
20221020,589,587,상관,오수,1269,20,52,19,156,47,1563,1113,19,42,21,57,37,1289,
20221020,597,598,서여주,북여주,1040,40,136,34,57,39,1346,1115,31,90,37,61,46,1380,
20221020,598,597,북여주,서여주,1115,31,90,37,61,46,1380,1040,40,136,34,57,39,1346,
20221020,621,127,동대구,서대구,1312,48,29,24,16,87,1516,1843,58,64,26,23,107,2121,
20221020,621,131,동대구,경산,2427,65,53,260,45,146,2996,2261,61,44,310,52,140,2868,
20221020,621,132,동대구,영천,1152,19,23,6,34,51,1285,1109,7,24,5,39,45,1229,
20221020,625,626,밀양,남밀양,1121,69,57,48,60,52,1407,1111,47,61,57,51,56,1383,
20221020,626,625,남밀양,밀양,1111,47,61,57,51,56,1383,1121,69,57,48,60,52,1407,
20221020,626,627,남밀양,삼랑진,993,31,35,10,62,110,1241,996,32,29,13,48,112,1230,
20221020,627,626,삼랑진,남밀양,996,32,29,13,48,112,1230,993,31,35,10,62,110,1241,
20221020,641,139,울산,서울산,1030,21,58,14,27,71,1221,1166,32,81,32,37,97,1445,
20221020,641,252,울산,대동,1412,73,88,38,67,75,1753,1685,66,89,36,41,87,2004,
20221020,641,643,울산,청량,1175,7,20,13,57,105,1377,1328,9,15,10,26,130,1518,
20221020,641,648,울산,해운대,976,5,18,2,7,64,1072,1114,14,20,1,6,75,1230,
20221020,641,706,울산,남경주,1153,14,19,7,18,66,1277,1142,8,20,13,22,63,1268,
20221020,641,707,울산,남포항,1079,17,26,15,141,55,1333,1079,14,23,37,141,51,1345,
20221020,643,641,청량,울산,1328,9,15,10,26,130,1518,1175,7,20,13,57,105,1377,
20221020,643,648,청량,해운대,2938,17,46,20,65,211,3297,3217,24,63,43,487,209,4043,
20221020,645,648,장안,해운대,1550,11,26,1,12,102,1702,2947,33,34,261,69,175,3519,
20221020,646,648,기장일광,해운대,4900,31,30,55,44,251,5311,5636,48,34,27,186,319,6250,
20221020,648,641,해운대,울산,1114,14,20,1,6,75,1230,976,5,18,2,7,64,1072,
20221020,648,643,해운대,청량,3217,24,63,43,487,209,4043,2938,17,46,20,65,211,3297,
20221020,648,645,해운대,장안,2947,33,34,261,69,175,3519,1550,11,26,1,12,102,1702,
20221020,648,646,해운대,기장일광,5636,48,34,27,186,319,6250,4900,31,30,55,44,251,5311,
20221020,651,652,남양주,화도,13774,562,542,460,240,1034,16612,16317,609,643,531,245,1233,19578,
20221020,651,653,남양주,서종,1791,18,14,3,46,80,1952,2068,23,17,4,36,86,2234,
20221020,651,654,남양주,설악,3832,34,70,15,23,143,4117,3373,26,68,18,14,136,3635,
20221020,651,655,남양주,강촌,2408,41,110,24,35,75,2693,2349,30,101,30,37,82,2629,
20221020,651,656,남양주,남춘천,2728,37,46,26,71,86,2994,2164,21,23,11,47,59,2325,
20221020,652,651,화도,남양주,16317,609,643,531,245,1233,19578,13774,562,542,460,240,1034,16612,
20221020,652,653,화도,서종,1464,25,17,31,13,99,1649,1611,29,27,21,20,119,1827,
20221020,652,654,화도,설악,1448,22,17,5,6,77,1575,1142,20,12,9,9,62,1254,
20221020,653,651,서종,남양주,2068,23,17,4,36,86,2234,1791,18,14,3,46,80,1952,
20221020,653,652,서종,화도,1611,29,27,21,20,119,1827,1464,25,17,31,13,99,1649,
20221020,654,651,설악,남양주,3373,26,68,18,14,136,3635,3832,34,70,15,23,143,4117,
20221020,654,652,설악,화도,1142,20,12,9,9,62,1254,1448,22,17,5,6,77,1575,
20221020,655,651,강촌,남양주,2349,30,101,30,37,82,2629,2408,41,110,24,35,75,2693,
20221020,656,651,남춘천,남양주,2164,21,23,11,47,59,2325,2728,37,46,26,71,86,2994,
20221020,671,672,봉담,정남,3351,173,104,68,181,218,4095,3905,163,115,74,225,287,4769,
20221020,671,673,봉담,북오산,1909,56,49,20,18,138,2190,2043,50,47,20,17,160,2337,
20221020,671,675,봉담,서오산,929,22,15,4,5,55,1030,970,26,23,6,13,79,1117,
20221020,671,676,봉담,향남,1415,110,57,59,34,107,1782,1292,109,65,48,29,113,1656,
20221020,671,677,봉담,북평택,7646,204,256,133,306,421,8966,7162,195,250,135,245,413,8400,
20221020,672,671,정남,봉담,3905,163,115,74,225,287,4769,3351,173,104,68,181,218,4095,
20221020,673,101,북오산,서울,1612,44,130,22,12,104,1924,1608,30,130,16,11,116,1911,
20221020,673,671,북오산,봉담,2043,50,47,20,17,160,2337,1909,56,49,20,18,138,2190,
20221020,673,677,북오산,북평택,1903,34,91,34,39,127,2228,1920,44,65,36,32,130,2227,
20221020,675,671,서오산,봉담,970,26,23,6,13,79,1117,929,22,15,4,5,55,1030,
20221020,675,676,서오산,향남,3663,128,85,56,27,254,4213,3250,105,72,50,25,216,3718,
20221020,675,677,서오산,북평택,11497,226,401,174,173,803,13274,11279,251,380,163,181,768,13022,
20221020,675,876,서오산,양감,1795,71,30,53,129,121,2199,2250,59,31,43,124,156,2663,
20221020,676,671,향남,봉담,1292,109,65,48,29,113,1656,1415,110,57,59,34,107,1782,
20221020,676,675,향남,서오산,3250,105,72,50,25,216,3718,3663,128,85,56,27,254,4213,
20221020,676,677,향남,북평택,1777,179,191,213,176,91,2627,1423,143,151,202,160,81,2160,
20221020,677,101,북평택,서울,1597,70,259,94,120,66,2206,1444,58,273,79,110,69,2033,
20221020,677,671,북평택,봉담,7162,195,250,135,245,413,8400,7646,204,256,133,306,421,8966,
20221020,677,673,북평택,북오산,1920,44,65,36,32,130,2227,1903,34,91,34,39,127,2228,
20221020,677,675,북평택,서오산,11279,251,380,163,181,768,13022,11497,226,401,174,173,803,13274,
20221020,677,676,북평택,향남,1423,143,151,202,160,81,2160,1777,179,191,213,176,91,2627,
20221020,677,876,북평택,양감,2258,145,184,243,233,152,3215,2095,151,187,282,222,146,3083,
20221020,682,683,조암,송산마도,810,90,102,102,59,36,1199,986,116,129,112,65,55,1463,
20221020,682,684,조암,남안산,996,159,189,133,149,37,1663,1092,157,178,111,144,46,1728,
20221020,682,685,조암,서시흥,1676,213,170,171,266,100,2596,1858,179,173,178,286,114,2788,
20221020,683,682,송산마도,조암,986,116,129,112,65,55,1463,810,90,102,102,59,36,1199,
20221020,683,684,송산마도,남안산,2605,204,158,133,217,147,3464,2281,178,134,98,154,135,2980,
20221020,683,685,송산마도,서시흥,5378,320,241,212,966,287,7404,4654,275,242,214,925,250,6560,
20221020,684,682,남안산,조암,1092,157,178,111,144,46,1728,996,159,189,133,149,37,1663,
20221020,684,683,남안산,송산마도,2281,178,134,98,154,135,2980,2605,204,158,133,217,147,3464,
20221020,684,685,남안산,서시흥,5603,550,328,413,569,403,7866,4825,385,343,366,422,339,6680,
20221020,685,682,서시흥,조암,1858,179,173,178,286,114,2788,1676,213,170,171,266,100,2596,
20221020,685,683,서시흥,송산마도,4654,275,242,214,925,250,6560,5378,320,241,212,966,287,7404,
20221020,685,684,서시흥,남안산,4825,385,343,366,422,339,6680,5603,550,328,413,569,403,7866,
20221020,705,190,남이천,동서울,1703,104,65,105,102,61,2140,1531,87,80,118,128,47,1991,
20221020,706,641,남경주,울산,1142,8,20,13,22,63,1268,1153,14,19,7,18,66,1277,
20221020,706,707,남경주,남포항,994,35,72,32,203,60,1396,1084,35,73,29,177,56,1454,
20221020,707,641,남포항,울산,1079,14,23,37,141,51,1345,1079,17,26,15,141,55,1333,
20221020,707,706,남포항,남경주,1084,35,73,29,177,56,1454,994,35,72,32,203,60,1396,
20221020,707,708,남포항,동경주,1306,27,33,22,243,71,1702,1356,21,40,25,299,73,1814,
20221020,708,707,동경주,남포항,1356,21,40,25,299,73,1814,1306,27,33,22,243,71,1702,
20221020,715,716,동안동,청송,1201,18,29,10,33,53,1344,1146,25,14,13,35,59,1292,
20221020,716,715,청송,동안동,1146,25,14,13,35,59,1292,1201,18,29,10,33,53,1344,
20221020,730,519,유천,남대구,2952,61,12,0,0,194,3219,2498,53,16,2,25,168,2762,
20221020,731,519,북현풍,남대구,1564,34,9,0,0,122,1729,2027,31,28,0,2,136,2224,
20221020,741,253,평택고덕,서서울,942,32,30,36,14,63,1117,987,42,15,17,4,62,1127,
20221020,741,520,평택고덕,평택,844,15,180,10,15,70,1134,895,13,214,18,19,71,1230,
20221020,741,540,평택고덕,청북,979,29,59,65,55,108,1295,874,25,48,57,45,95,1144,
20221020,742,107,남사진위,안성,1375,37,61,38,8,122,1641,1325,36,51,22,8,105,1547,
20221020,742,108,남사진위,천안,1103,37,36,23,5,63,1267,1292,27,26,20,7,76,1448,
20221020,752,252,기장철마,대동,1896,70,68,34,73,139,2280,1842,68,57,36,141,159,2303,
20221020,753,252,금정,대동,1144,75,62,58,91,62,1492,1848,98,77,81,170,111,2385,
20221020,755,140,광재,부산,974,17,17,5,53,63,1129,1046,14,24,6,32,71,1193,
20221020,755,252,광재,대동,2306,76,94,187,565,135,3363,2393,85,89,176,293,155,3191,
20221020,756,252,한림,대동,967,56,34,43,144,39,1283,897,43,38,31,90,42,1141,
20221020,772,774,북달성,남칠곡,2478,54,49,49,35,122,2787,2562,70,57,43,31,135,2898,
20221020,773,774,북다사,남칠곡,1396,39,29,21,23,89,1597,1303,46,18,21,13,102,1503,
20221020,774,772,남칠곡,북달성,2562,70,57,43,31,135,2898,2478,54,49,49,35,122,2787,
20221020,774,773,남칠곡,북다사,1303,46,18,21,13,102,1503,1396,39,29,21,23,89,1597,
20221020,775,203,동명동호,가산,1745,62,51,50,259,68,2235,1683,62,43,53,286,75,2202,
20221020,776,777,연경,파군재,3471,53,51,16,26,249,3866,2504,50,54,17,15,185,2825,
20221020,776,779,연경,율암,6043,90,79,78,190,451,6931,6203,118,88,78,177,463,7127,
20221020,777,776,파군재,연경,2504,50,54,17,15,185,2825,3471,53,51,16,26,249,3866,
20221020,777,779,파군재,율암,2478,38,25,29,5,225,2800,2433,36,25,29,2,212,2737,
20221020,779,776,율암,연경,6203,118,88,78,177,463,7127,6043,90,79,78,190,451,6931,
20221020,779,777,율암,파군재,2433,36,25,29,2,212,2737,2478,38,25,29,5,225,2800,
20221020,876,675,양감,서오산,2250,59,31,43,124,156,2663,1795,71,30,53,129,121,2199,
20221020,876,677,양감,북평택,2095,151,187,282,222,146,3083,2258,145,184,243,233,152,3215,
20221020,981,982,서영암,강진무위사,1857,34,71,55,50,74,2141,1846,38,65,93,50,73,2165,
20221020,981,987,서영암,남순천,1619,41,90,94,406,34,2284,1730,45,115,110,402,52,2454,
20221020,982,981,강진무위사,서영암,1846,38,65,93,50,73,2165,1857,34,71,55,50,74,2141,
20221020,984,985,보성,벌교,1584,51,48,46,56,49,1834,1509,39,49,29,43,47,1716,
20221020,984,987,보성,남순천,1744,37,81,72,336,63,2333,1780,33,73,61,305,66,2318,
20221020,985,984,벌교,보성,1509,39,49,29,43,47,1716,1584,51,48,46,56,49,1834,
20221020,986,987,고흥,남순천,3474,67,118,139,251,141,4190,3945,72,119,140,254,158,4688,
20221020,987,981,남순천,서영암,1730,45,115,110,402,52,2454,1619,41,90,94,406,34,2284,
20221020,987,984,남순천,보성,1780,33,73,61,305,66,2318,1744,37,81,72,336,63,2333,
20221020,987,986,남순천,고흥,3945,72,119,140,254,158,4688,3474,67,118,139,251,141,4190,
20221021,101,102,서울,동수원,3579,53,263,8,2,190,4095,4979,61,390,23,10,271,5734,
20221021,101,103,서울,수원신갈,15282,599,1732,407,123,732,18875,14889,676,1735,373,90,718,18481,
20221021,101,105,서울,기흥,6497,96,364,74,33,281,7345,5472,80,372,95,29,287,6335,
20221021,101,106,서울,오산,4101,366,423,162,74,280,5406,4465,469,441,196,96,309,5976,
20221021,101,107,서울,안성,3198,83,318,34,12,175,3820,3042,89,292,46,18,155,3642,
20221021,101,108,서울,천안,4255,70,384,47,15,190,4961,4368,40,380,43,13,184,5028,
20221021,101,111,서울,청주,1129,18,215,29,23,47,1461,896,15,259,27,19,37,1253,
20221021,101,171,서울,마성,2784,27,240,53,4,139,3247,2800,24,273,56,2,133,3288,
20221021,101,172,서울,용인,3534,168,117,35,10,199,4063,4033,169,133,51,20,239,4645,
20221021,101,173,서울,양지,3627,203,126,97,73,154,4280,4607,379,156,139,80,208,5569,
20221021,101,175,서울,덕평,774,57,90,41,16,35,1013,894,118,100,40,53,53,1258,
20221021,101,528,서울,기흥동탄,7396,77,1224,132,26,408,9263,7503,74,1351,128,18,372,9446,
20221021,101,542,서울,서안성,1283,32,81,84,24,66,1570,1866,53,70,144,47,89,2269,
20221021,101,543,서울,남안성,1210,65,71,63,42,43,1494,1164,95,74,89,85,39,1546,
20221021,101,673,서울,북오산,1432,34,126,20,13,91,1716,1328,30,118,22,12,87,1597,
20221021,101,677,서울,북평택,1571,47,266,74,103,59,2120,1675,57,223,94,120,81,2250,
20221021,102,101,동수원,서울,4979,61,390,23,10,271,5734,3579,53,263,8,2,190,4095,
20221021,102,172,동수원,용인,1135,25,20,8,4,91,1283,1059,37,24,2,3,90,1215,
20221021,102,173,동수원,양지,1338,42,30,6,28,79,1523,1434,39,35,12,7,94,1621,
20221021,102,212,동수원,북수원,4287,33,227,15,25,276,4863,4845,40,252,23,21,307,5488,
20221021,102,213,동수원,부곡,1087,16,17,6,26,87,1239,1086,21,19,2,21,89,1238,
20221021,102,214,동수원,동군포,1637,30,23,20,5,115,1830,1893,27,18,11,3,116,2068,
20221021,102,215,동수원,군포,1725,17,34,13,3,120,1912,2437,22,44,4,4,171,2682,
20221021,102,253,동수원,서서울,5796,51,76,19,29,342,6313,4933,63,78,20,22,300,5416,
20221021,102,254,동수원,군자,4056,57,71,27,36,224,4471,4068,70,74,18,39,235,4504,
20221021,102,255,동수원,서안산,1761,38,12,14,3,112,1940,1832,35,19,17,6,132,2041,
20221021,103,101,수원신갈,서울,14889,676,1735,373,90,718,18481,15282,599,1732,407,123,732,18875,
20221021,103,105,수원신갈,기흥,1654,24,50,87,20,119,1954,2172,32,41,82,22,115,2464,
20221021,103,106,수원신갈,오산,963,67,52,32,15,63,1192,1324,59,61,43,14,94,1595,
20221021,103,108,수원신갈,천안,973,13,52,8,0,43,1089,1225,13,47,9,0,58,1352,
20221021,103,253,수원신갈,서서울,1920,128,75,63,25,123,2334,2060,125,77,77,34,113,2486,
20221021,103,254,수원신갈,군자,1500,91,61,71,59,77,1859,1736,120,82,124,108,118,2288,
20221021,103,528,수원신갈,기흥동탄,1553,27,213,3,7,102,1905,2132,19,172,6,4,121,2454,
20221021,105,101,기흥,서울,5472,80,372,95,29,287,6335,6497,96,364,74,33,281,7345,
20221021,105,103,기흥,수원신갈,2172,32,41,82,22,115,2464,1654,24,50,87,20,119,1954,
20221021,106,101,오산,서울,4465,469,441,196,96,309,5976,4101,366,423,162,74,280,5406,
20221021,106,103,오산,수원신갈,1324,59,61,43,14,94,1595,963,67,52,32,15,63,1192,
20221021,106,107,오산,안성,1740,38,40,21,10,156,2005,1495,55,22,26,6,136,1740,
20221021,106,108,오산,천안,1161,27,27,17,9,66,1307,1180,27,25,19,8,67,1326,
20221021,106,528,오산,기흥동탄,904,22,46,18,12,77,1079,917,36,44,11,14,76,1098,
20221021,107,101,안성,서울,3042,89,292,46,18,155,3642,3198,83,318,34,12,175,3820,
20221021,107,106,안성,오산,1495,55,22,26,6,136,1740,1740,38,40,21,10,156,2005,
20221021,107,108,안성,천안,1664,29,41,11,5,135,1885,1646,34,48,13,5,142,1888,
20221021,107,528,안성,기흥동탄,1088,7,22,3,6,99,1225,1204,20,24,5,7,106,1366,
20221021,107,742,안성,남사진위,1396,43,62,26,6,119,1652,1530,36,67,31,9,128,1801,
20221021,108,101,천안,서울,4368,40,380,43,13,184,5028,4255,70,384,47,15,190,4961,
20221021,108,103,천안,수원신갈,1225,13,47,9,0,58,1352,973,13,52,8,0,43,1089,
20221021,108,106,천안,오산,1180,27,25,19,8,67,1326,1161,27,27,17,9,66,1307,
20221021,108,107,천안,안성,1646,34,48,13,5,142,1888,1664,29,41,11,5,135,1885,
20221021,108,110,천안,목천,1225,30,62,25,31,91,1464,945,13,57,33,24,65,1137,
20221021,108,111,천안,청주,1184,35,62,17,35,80,1413,1131,29,53,32,36,60,1341,
20221021,108,229,천안,북천안,3522,81,114,50,39,201,4007,3861,95,137,58,62,210,4423,
20221021,108,528,천안,기흥동탄,1183,21,99,4,14,67,1388,1242,23,124,3,10,83,1485,
20221021,108,541,천안,송탄,865,40,28,18,8,57,1016,886,39,30,12,19,65,1051,
20221021,108,742,천안,남사진위,1281,28,31,25,10,92,1467,1250,31,36,30,11,80,1438,
20221021,110,108,목천,천안,945,13,57,33,24,65,1137,1225,30,62,25,31,91,1464,
20221021,111,101,청주,서울,896,15,259,27,19,37,1253,1129,18,215,29,23,47,1461,
20221021,111,108,청주,천안,1131,29,53,32,36,60,1341,1184,35,62,17,35,80,1413,
20221021,112,115,남청주,대전,1559,70,66,4,30,111,1840,1684,89,63,11,8,119,1974,
20221021,113,115,신탄진,대전,1006,24,13,4,18,107,1172,1190,20,9,9,3,132,1363,
20221021,114,153,남대전,서대전,1954,41,60,45,74,150,2324,1723,33,85,69,58,126,2094,
20221021,115,112,대전,남청주,1684,89,63,11,8,119,1974,1559,70,66,4,30,111,1840,
20221021,115,113,대전,신탄진,1190,20,9,9,3,132,1363,1006,24,13,4,18,107,1172,
20221021,115,116,대전,옥천,2527,107,52,31,20,167,2904,2221,71,48,32,16,151,2539,
20221021,115,153,대전,서대전,1020,26,9,2,0,69,1126,975,23,10,2,1,81,1092,
20221021,115,198,대전,서청주,908,12,8,5,1,70,1004,928,15,7,5,3,86,1044,
20221021,115,579,대전,남세종,1058,14,26,16,41,92,1247,1068,10,24,9,50,87,1248,
20221021,116,115,옥천,대전,2221,71,48,32,16,151,2539,2527,107,52,31,20,167,2904,
20221021,119,153,판암,서대전,1859,23,22,52,32,144,2132,2019,25,36,51,30,154,2315,
20221021,123,127,구미,서대구,1673,30,30,17,16,97,1863,1713,30,43,12,6,101,1905,
20221021,123,129,구미,북대구,1917,14,62,9,3,93,2098,1997,15,72,7,1,105,2197,
20221021,123,130,구미,동김천,1332,25,31,31,29,94,1542,1230,22,35,26,22,81,1416,
20221021,125,127,남구미,서대구,1978,64,132,33,22,107,2336,2197,74,136,42,30,138,2617,
20221021,125,129,남구미,북대구,1923,28,77,13,10,115,2166,2117,31,85,18,6,116,2373,
20221021,126,127,왜관,서대구,2287,100,75,40,133,118,2753,2862,126,74,48,81,143,3334,
20221021,126,129,왜관,북대구,2778,77,47,17,73,131,3123,3518,93,76,25,66,172,3950,
20221021,127,123,서대구,구미,1713,30,43,12,6,101,1905,1673,30,30,17,16,97,1863,
20221021,127,125,서대구,남구미,2197,74,136,42,30,138,2617,1978,64,132,33,22,107,2336,
20221021,127,126,서대구,왜관,2862,126,74,48,81,143,3334,2287,100,75,40,133,118,2753,
20221021,127,131,서대구,경산,2479,210,163,126,76,147,3201,1745,147,100,69,52,118,2231,
20221021,127,201,서대구,칠곡,1451,37,29,14,35,87,1653,900,27,18,8,8,52,1013,
20221021,127,203,서대구,가산,2241,56,71,47,99,97,2611,2023,40,63,35,126,96,2383,
20221021,127,230,서대구,팔공산,1516,37,29,14,1,95,1692,1069,21,23,15,5,65,1198,
20221021,127,518,서대구,칠곡물류,877,119,88,96,31,50,1261,817,88,62,85,28,53,1133,
20221021,127,527,서대구,포항,1288,34,43,19,78,58,1520,915,37,39,16,69,49,1125,
20221021,127,621,서대구,동대구,1870,55,78,33,43,126,2205,1320,36,36,27,25,83,1527,
20221021,129,123,북대구,구미,1997,15,72,7,1,105,2197,1917,14,62,9,3,93,2098,
20221021,129,125,북대구,남구미,2117,31,85,18,6,116,2373,1923,28,77,13,10,115,2166,
20221021,129,126,북대구,왜관,3518,93,76,25,66,172,3950,2778,77,47,17,73,131,3123,
20221021,129,131,북대구,경산,2277,145,90,55,28,119,2714,2854,201,134,92,36,146,3463,
20221021,129,524,북대구,청통와촌,980,44,29,15,15,45,1128,1213,63,38,14,33,49,1410,
20221021,129,527,북대구,포항,1661,32,28,26,58,81,1886,2269,51,40,28,95,106,2589,
20221021,130,123,동김천,구미,1230,22,35,26,22,81,1416,1332,25,31,31,29,94,1542,
20221021,131,127,경산,서대구,1745,147,100,69,52,118,2231,2479,210,163,126,76,147,3201,
20221021,131,129,경산,북대구,2854,201,134,92,36,146,3463,2277,145,90,55,28,119,2714,
20221021,131,132,경산,영천,795,47,41,26,54,55,1018,861,54,55,42,43,56,1111,
20221021,131,230,경산,팔공산,1267,81,37,12,20,82,1499,1482,84,56,44,20,99,1785,
20221021,131,621,경산,동대구,2245,58,41,169,36,109,2658,2355,65,61,147,21,123,2772,
20221021,132,131,영천,경산,861,54,55,42,43,56,1111,795,47,41,26,54,55,1018,
20221021,132,621,영천,동대구,1256,14,24,3,14,51,1362,1253,20,22,1,12,58,1366,
20221021,135,140,경주,부산,1379,10,47,10,58,65,1569,1659,12,39,5,32,74,1821,
20221021,135,252,경주,대동,1099,31,89,56,192,49,1516,1487,43,82,42,105,58,1817,
20221021,137,140,통도사,부산,808,42,37,12,59,59,1017,860,24,35,18,70,63,1070,
20221021,138,140,양산,부산,5030,252,176,302,263,271,6294,5230,286,181,315,272,277,6561,
20221021,138,252,양산,대동,2603,296,196,366,309,133,3903,2807,297,196,336,352,123,4111,
20221021,139,140,서울산,부산,1473,48,27,10,24,68,1650,1525,52,22,11,15,72,1697,
20221021,139,252,서울산,대동,885,46,44,33,64,49,1121,1047,43,33,35,47,58,1263,
20221021,139,641,서울산,울산,1358,44,61,31,33,103,1630,1319,27,62,22,29,95,1554,
20221021,140,135,부산,경주,1659,12,39,5,32,74,1821,1379,10,47,10,58,65,1569,
20221021,140,137,부산,통도사,860,24,35,18,70,63,1070,808,42,37,12,59,59,1017,
20221021,140,138,부산,양산,5230,286,181,315,272,277,6561,5030,252,176,302,263,271,6294,
20221021,140,139,부산,서울산,1525,52,22,11,15,72,1697,1473,48,27,10,24,68,1650,
20221021,140,250,부산,남양산,8223,160,219,52,32,679,9365,8007,145,217,44,38,680,9131,
20221021,140,251,부산,물금,1051,118,19,41,59,75,1363,1050,102,30,31,69,67,1349,
20221021,140,252,부산,대동,1745,45,64,31,50,105,2040,1445,41,49,45,123,87,1790,
20221021,140,289,부산,마산,1157,12,15,6,8,47,1245,1220,13,9,5,8,45,1300,
20221021,140,755,부산,광재,1084,13,22,10,46,73,1248,958,17,20,11,49,63,1118,
20221021,142,145,군북,산인,4764,77,127,59,108,328,5463,4676,66,139,57,97,295,5330,
20221021,143,145,장지,산인,1270,32,41,36,77,100,1556,1247,24,37,37,72,91,1508,
20221021,144,145,함안,산인,2255,46,52,34,73,145,2605,2343,47,55,25,54,151,2675,
20221021,145,142,산인,군북,4676,66,139,57,97,295,5330,4764,77,127,59,108,328,5463,
20221021,145,143,산인,장지,1247,24,37,37,72,91,1508,1270,32,41,36,77,100,1556,
20221021,145,144,산인,함안,2343,47,55,25,54,151,2675,2255,46,52,34,73,145,2605,
20221021,145,272,산인,광양,950,16,50,21,34,25,1096,1104,17,55,33,33,27,1269,
20221021,145,291,산인,사천,2022,44,66,15,37,82,2266,2156,67,85,27,35,99,2469,
20221021,145,292,산인,진주,1936,39,159,16,28,118,2296,2056,40,153,18,33,127,2427,
20221021,145,293,산인,문산,1509,37,26,11,10,83,1676,1539,27,33,15,7,81,1702,
20221021,145,295,산인,진성,984,26,29,12,15,46,1112,1072,25,36,5,12,31,1181,
20221021,146,150,동창원,북부산,1139,23,17,5,18,76,1278,1000,20,20,1,15,65,1121,
20221021,146,244,동창원,서부산,1298,32,37,15,32,80,1494,1309,24,47,15,38,76,1509,
20221021,146,245,동창원,장유,964,13,15,11,6,86,1095,1026,20,12,11,9,90,1168,
20221021,146,289,동창원,마산,2964,86,80,50,98,234,3512,2794,99,81,49,83,216,3322,
20221021,147,150,진례,북부산,1448,49,28,17,51,77,1670,1642,59,27,22,29,87,1866,
20221021,147,244,진례,서부산,1773,95,73,60,122,92,2215,1899,102,77,63,139,103,2383,
20221021,147,245,진례,장유,1111,39,31,48,19,115,1363,1397,48,37,36,23,151,1692,
20221021,147,289,진례,마산,1431,93,71,56,84,83,1818,1453,105,80,51,80,85,1854,
20221021,148,150,서김해,북부산,6605,112,79,110,104,512,7522,6479,129,84,98,76,520,7386,
20221021,148,251,서김해,물금,947,34,20,28,14,89,1132,928,38,13,22,13,93,1107,
20221021,148,289,서김해,마산,1678,28,75,16,9,98,1904,1697,30,76,23,17,109,1952,
20221021,149,150,동김해,북부산,10669,179,207,43,103,866,12067,9215,153,160,42,55,706,10331,
20221021,149,250,동김해,남양산,1140,20,53,6,7,82,1308,1051,15,49,6,5,79,1205,
20221021,149,251,동김해,물금,1154,44,10,9,8,122,1347,1096,32,12,10,11,116,1277,
20221021,149,289,동김해,마산,968,35,43,21,15,73,1155,1177,45,45,16,18,66,1367,
20221021,150,146,북부산,동창원,1000,20,20,1,15,65,1121,1139,23,17,5,18,76,1278,
20221021,150,147,북부산,진례,1642,59,27,22,29,87,1866,1448,49,28,17,51,77,1670,
20221021,150,148,북부산,서김해,6479,129,84,98,76,520,7386,6605,112,79,110,104,512,7522,
20221021,150,149,북부산,동김해,9215,153,160,42,55,706,10331,10669,179,207,43,103,866,12067,
20221021,150,245,북부산,장유,3834,28,82,16,30,278,4268,3504,37,86,13,28,238,3906,
20221021,150,289,북부산,마산,3099,36,97,16,38,160,3446,3590,33,95,22,75,177,3992,
20221021,151,153,북대전,서대전,1155,16,18,18,15,93,1315,1264,19,22,23,14,86,1428,
20221021,152,154,유성,안영,1058,19,42,10,36,73,1238,1123,22,38,15,27,73,1298,
20221021,153,114,서대전,남대전,1723,33,85,69,58,126,2094,1954,41,60,45,74,150,2324,
20221021,153,115,서대전,대전,975,23,10,2,1,81,1092,1020,26,9,2,0,69,1126,
20221021,153,119,서대전,판암,2019,25,36,51,30,154,2315,1859,23,22,52,32,144,2132,
20221021,153,151,서대전,북대전,1264,19,22,23,14,86,1428,1155,16,18,18,15,93,1315,
20221021,153,154,서대전,안영,1163,31,29,26,78,73,1400,1132,31,45,31,65,70,1374,
20221021,153,579,서대전,남세종,1249,19,9,3,9,103,1392,1034,19,15,5,13,73,1159,
20221021,154,152,안영,유성,1123,22,38,15,27,73,1298,1058,19,42,10,36,73,1238,
20221021,154,153,안영,서대전,1132,31,45,31,65,70,1374,1163,31,29,26,78,73,1400,
20221021,159,167,서전주,광주,1653,56,70,60,53,58,1950,1579,69,70,41,47,58,1864,
20221021,163,167,정읍,광주,912,30,52,30,16,44,1084,876,37,58,31,22,35,1059,
20221021,166,167,장성,광주,2390,72,58,23,56,109,2708,2821,127,90,45,22,129,3234,
20221021,167,159,광주,서전주,1579,69,70,41,47,58,1864,1653,56,70,60,53,58,1950,
20221021,167,163,광주,정읍,876,37,58,31,22,35,1059,912,30,52,30,16,44,1084,
20221021,167,166,광주,장성,2821,127,90,45,22,129,3234,2390,72,58,23,56,109,2708,
20221021,167,567,광주,남고창,1380,34,60,10,19,61,1564,1432,29,46,9,25,61,1602,
20221021,171,101,마성,서울,2800,24,273,56,2,133,3288,2784,27,240,53,4,139,3247,
20221021,172,101,용인,서울,4033,169,133,51,20,239,4645,3534,168,117,35,10,199,4063,
20221021,172,102,용인,동수원,1059,37,24,2,3,90,1215,1135,25,20,8,4,91,1283,
20221021,172,173,용인,양지,1958,230,146,144,114,123,2715,1852,196,140,152,107,141,2588,
20221021,172,212,용인,북수원,988,32,15,12,13,63,1123,1241,58,21,19,10,82,1431,
20221021,172,253,용인,서서울,1122,72,24,31,16,75,1340,1128,52,22,29,18,60,1309,
20221021,173,101,양지,서울,4607,379,156,139,80,208,5569,3627,203,126,97,73,154,4280,
20221021,173,102,양지,동수원,1434,39,35,12,7,94,1621,1338,42,30,6,28,79,1523,
20221021,173,172,양지,용인,1852,196,140,152,107,141,2588,1958,230,146,144,114,123,2715,
20221021,173,212,양지,북수원,1267,99,45,50,27,69,1557,1307,93,50,56,54,64,1624,
20221021,173,253,양지,서서울,1335,162,61,118,56,82,1814,988,132,49,92,40,51,1352,
20221021,173,254,양지,군자,945,108,81,188,195,49,1566,734,96,90,153,181,30,1284,
20221021,174,179,춘천,홍천,3468,84,99,37,32,314,4034,3351,63,96,35,24,336,3905,
20221021,174,216,춘천,횡성,1114,49,29,29,32,76,1329,1190,49,52,15,32,84,1422,
20221021,174,218,춘천,남원주,1284,33,73,18,21,92,1521,1403,25,74,17,17,92,1628,
20221021,174,554,춘천,동홍천,1256,27,27,16,22,88,1436,1412,15,24,11,5,99,1566,
20221021,175,101,덕평,서울,894,118,100,40,53,53,1258,774,57,90,41,16,35,1013,
20221021,176,190,이천,동서울,1835,83,180,153,110,95,2456,1399,65,194,146,68,86,1958,
20221021,177,190,여주,동서울,914,19,33,39,25,39,1069,962,18,47,36,28,27,1118,
20221021,179,174,홍천,춘천,3351,63,96,35,24,336,3905,3468,84,99,37,32,314,4034,
20221021,184,189,대관령,강릉,1432,48,65,4,27,84,1660,1531,45,57,3,18,90,1744,
20221021,189,184,강릉,대관령,1531,45,57,3,18,90,1744,1432,48,65,4,27,84,1660,
20221021,190,176,동서울,이천,1399,65,194,146,68,86,1958,1835,83,180,153,110,95,2456,
20221021,190,177,동서울,여주,962,18,47,36,28,27,1118,914,19,33,39,25,39,1069,
20221021,190,191,동서울,경기광주,10621,635,483,442,242,700,13123,10833,669,492,398,289,753,13434,
20221021,190,192,동서울,곤지암,6089,453,246,179,73,360,7400,5090,430,155,173,47,331,6226,
20221021,190,193,동서울,일죽,2679,152,205,165,114,95,3410,2421,164,166,202,95,100,3148,
20221021,190,194,동서울,서이천,4186,556,287,270,144,238,5681,3304,413,233,197,104,189,4440,
20221021,190,198,동서울,서청주,949,29,49,23,35,37,1122,1243,22,37,33,21,37,1393,
20221021,190,560,동서울,감곡,1239,22,30,33,44,45,1413,1134,31,27,25,78,40,1335,
20221021,190,705,동서울,남이천,1521,92,74,119,147,45,1998,2326,101,63,105,93,67,2755,
20221021,191,190,경기광주,동서울,10833,669,492,398,289,753,13434,10621,635,483,442,242,700,13123,
20221021,192,190,곤지암,동서울,5090,430,155,173,47,331,6226,6089,453,246,179,73,360,7400,
20221021,192,194,곤지암,서이천,1335,261,123,207,105,106,2137,1171,167,89,184,136,96,1843,
20221021,193,190,일죽,동서울,2421,164,166,202,95,100,3148,2679,152,205,165,114,95,3410,
20221021,194,190,서이천,동서울,3304,413,233,197,104,189,4440,4186,556,287,270,144,238,5681,
20221021,194,192,서이천,곤지암,1171,167,89,184,136,96,1843,1335,261,123,207,105,106,2137,
20221021,196,198,진천,서청주,1235,33,73,38,32,83,1494,1378,34,75,25,26,77,1615,
20221021,198,115,서청주,대전,928,15,7,5,3,86,1044,908,12,8,5,1,70,1004,
20221021,198,190,서청주,동서울,1243,22,37,33,21,37,1393,949,29,49,23,35,37,1122,
20221021,198,196,서청주,진천,1378,34,75,25,26,77,1615,1235,33,73,38,32,83,1494,
20221021,201,127,칠곡,서대구,900,27,18,8,8,52,1013,1451,37,29,14,35,87,1653,
20221021,201,203,칠곡,가산,917,41,41,42,135,52,1228,889,46,46,31,178,46,1236,
20221021,203,127,가산,서대구,2023,40,63,35,126,96,2383,2241,56,71,47,99,97,2611,
20221021,203,201,가산,칠곡,889,46,46,31,178,46,1236,917,41,41,42,135,52,1228,
20221021,203,775,가산,동명동호,1761,71,47,47,287,75,2288,1866,70,45,41,255,68,2345,
20221021,212,102,북수원,동수원,4845,40,252,23,21,307,5488,4287,33,227,15,25,276,4863,
20221021,212,172,북수원,용인,1241,58,21,19,10,82,1431,988,32,15,12,13,63,1123,
20221021,212,173,북수원,양지,1307,93,50,56,54,64,1624,1267,99,45,50,27,69,1557,
20221021,212,254,북수원,군자,1782,32,30,19,18,100,1981,1037,25,34,13,17,54,1180,
20221021,213,102,부곡,동수원,1086,21,19,2,21,89,1238,1087,16,17,6,26,87,1239,
20221021,213,253,부곡,서서울,1401,76,41,37,220,86,1861,943,49,28,37,177,48,1282,
20221021,213,254,부곡,군자,965,36,28,43,518,64,1654,770,30,18,31,397,45,1291,
20221021,214,102,동군포,동수원,1893,27,18,11,3,116,2068,1637,30,23,20,5,115,1830,
20221021,215,102,군포,동수원,2437,22,44,4,4,171,2682,1725,17,34,13,3,120,1912,
20221021,215,253,군포,서서울,3821,91,65,39,65,245,4326,4126,142,121,152,85,256,4882,
20221021,215,254,군포,군자,2485,79,67,37,72,161,2901,3092,126,104,134,148,225,3829,
20221021,215,255,군포,서안산,1390,47,27,16,20,82,1582,1425,72,57,72,90,109,1825,
20221021,216,174,횡성,춘천,1190,49,52,15,32,84,1422,1114,49,29,29,32,76,1329,
20221021,218,174,남원주,춘천,1403,25,74,17,17,92,1628,1284,33,73,18,21,92,1521,
20221021,218,240,남원주,제천,2120,55,59,23,58,142,2457,2354,58,48,17,36,157,2670,
20221021,225,291,서진주,사천,1128,29,28,9,35,81,1310,1167,27,45,9,34,83,1365,
20221021,229,108,북천안,천안,3861,95,137,58,62,210,4423,3522,81,114,50,39,201,4007,
20221021,230,127,팔공산,서대구,1069,21,23,15,5,65,1198,1516,37,29,14,1,95,1692,
20221021,230,131,팔공산,경산,1482,84,56,44,20,99,1785,1267,81,37,12,20,82,1499,
20221021,230,524,팔공산,청통와촌,1155,46,36,11,19,63,1330,1001,37,31,16,21,57,1163,
20221021,230,527,팔공산,포항,1590,32,22,10,19,74,1747,1572,29,16,8,18,62,1705,
20221021,231,519,화원옥포,남대구,6533,167,107,82,199,501,7589,6316,150,110,70,66,469,7181,
20221021,232,519,달성,남대구,2842,124,131,45,38,192,3372,2955,131,147,49,25,198,3505,
20221021,233,519,현풍,남대구,5147,217,210,87,130,362,6153,4491,205,208,99,87,304,5394,
20221021,237,239,남지,칠원,917,24,59,14,95,82,1191,783,23,56,20,91,72,1045,
20221021,238,239,칠서,칠원,1808,92,100,147,463,118,2728,1937,99,115,124,458,124,2857,
20221021,239,237,칠원,남지,783,23,56,20,91,72,1045,917,24,59,14,95,82,1191,
20221021,239,238,칠원,칠서,1937,99,115,124,458,124,2857,1808,92,100,147,463,118,2728,
20221021,239,519,칠원,남대구,1393,53,100,36,90,51,1723,1554,64,104,46,65,52,1885,
20221021,240,218,제천,남원주,2354,58,48,17,36,157,2670,2120,55,59,23,58,142,2457,
20221021,241,519,동고령,남대구,3145,103,92,301,103,152,3896,3244,90,91,289,101,153,3968,
20221021,242,519,고령,남대구,1816,40,69,26,206,100,2257,1948,44,54,16,190,84,2336,
20221021,244,146,서부산,동창원,1309,24,47,15,38,76,1509,1298,32,37,15,32,80,1494,
20221021,244,147,서부산,진례,1899,102,77,63,139,103,2383,1773,95,73,60,122,92,2215,
20221021,244,245,서부산,장유,13609,261,405,135,324,936,15670,13674,208,391,134,401,1007,15815,
20221021,244,289,서부산,마산,3784,78,274,51,102,170,4459,4214,82,304,53,132,182,4967,
20221021,245,146,장유,동창원,1026,20,12,11,9,90,1168,964,13,15,11,6,86,1095,
20221021,245,147,장유,진례,1397,48,37,36,23,151,1692,1111,39,31,48,19,115,1363,
20221021,245,150,장유,북부산,3504,37,86,13,28,238,3906,3834,28,82,16,30,278,4268,
20221021,245,244,장유,서부산,13674,208,391,134,401,1007,15815,13609,261,405,135,324,936,15670,
20221021,245,289,장유,마산,1741,33,44,9,30,143,2000,1918,36,49,21,19,130,2173,
20221021,248,261,순창,동광주,1225,16,19,10,22,39,1331,1410,28,30,9,8,52,1537,
20221021,249,261,담양,동광주,2245,39,121,35,43,84,2567,2051,33,105,42,38,75,2344,
20221021,250,140,남양산,부산,8007,145,217,44,38,680,9131,8223,160,219,52,32,679,9365,
20221021,250,149,남양산,동김해,1051,15,49,6,5,79,1205,1140,20,53,6,7,82,1308,
20221021,250,252,남양산,대동,3285,145,96,90,82,234,3932,4198,184,123,107,136,277,5025,
20221021,251,140,물금,부산,1050,102,30,31,69,67,1349,1051,118,19,41,59,75,1363,
20221021,251,148,물금,서김해,928,38,13,22,13,93,1107,947,34,20,28,14,89,1132,
20221021,251,149,물금,동김해,1096,32,12,10,11,116,1277,1154,44,10,9,8,122,1347,
20221021,251,252,물금,대동,3174,213,88,137,476,244,4332,3766,202,95,154,645,289,5151,
20221021,252,135,대동,경주,1487,43,82,42,105,58,1817,1099,31,89,56,192,49,1516,
20221021,252,138,대동,양산,2807,297,196,336,352,123,4111,2603,296,196,366,309,133,3903,
20221021,252,139,대동,서울산,1047,43,33,35,47,58,1263,885,46,44,33,64,49,1121,
20221021,252,140,대동,부산,1445,41,49,45,123,87,1790,1745,45,64,31,50,105,2040,
20221021,252,250,대동,남양산,4198,184,123,107,136,277,5025,3285,145,96,90,82,234,3932,
20221021,252,251,대동,물금,3766,202,95,154,645,289,5151,3174,213,88,137,476,244,4332,
20221021,252,641,대동,울산,1813,76,86,54,55,109,2193,1560,73,88,35,71,78,1905,
20221021,252,752,대동,기장철마,1999,62,42,40,133,143,2419,2015,60,57,31,60,156,2379,
20221021,252,753,대동,금정,1962,103,96,92,215,121,2589,1177,71,68,50,105,80,1551,
20221021,252,755,대동,광재,2343,88,100,73,294,155,3053,2220,100,88,87,508,144,3147,
20221021,252,756,대동,한림,871,39,37,17,92,42,1098,976,56,45,26,148,49,1300,
20221021,253,102,서서울,동수원,4933,63,78,20,22,300,5416,5796,51,76,19,29,342,6313,
20221021,253,103,서서울,수원신갈,2060,125,77,77,34,113,2486,1920,128,75,63,25,123,2334,
20221021,253,172,서서울,용인,1128,52,22,29,18,60,1309,1122,72,24,31,16,75,1340,
20221021,253,173,서서울,양지,988,132,49,92,40,51,1352,1335,162,61,118,56,82,1814,
20221021,253,213,서서울,부곡,943,49,28,37,177,48,1282,1401,76,41,37,220,86,1861,
20221021,253,215,서서울,군포,4126,142,121,152,85,256,4882,3821,91,65,39,65,245,4326,
20221021,253,255,서서울,서안산,14948,525,652,594,295,910,17924,14399,529,554,534,286,859,17161,
20221021,253,256,서서울,안산,9235,178,88,47,22,671,10241,6262,117,67,34,54,450,6984,
20221021,253,281,서서울,매송,3574,59,48,20,25,212,3938,4637,74,51,19,95,288,5164,
20221021,253,282,서서울,비봉,5452,233,248,164,481,316,6894,5983,297,270,183,531,380,7644,
20221021,253,283,서서울,발안,3072,159,167,162,106,198,3864,4348,226,204,218,117,230,5343,
20221021,253,285,서서울,서평택,1458,71,103,271,390,107,2400,1714,84,120,360,557,110,2945,
20221021,253,287,서서울,송악,2251,23,59,67,202,88,2690,2504,43,60,98,398,108,3211,
20221021,253,288,서서울,당진,1556,17,40,29,32,75,1749,1520,28,44,33,52,88,1765,
20221021,253,298,서서울,서산,3548,30,65,31,23,127,3824,2411,23,60,53,65,96,2708,
20221021,253,520,서서울,평택,2235,104,93,151,133,102,2818,2705,110,102,210,137,108,3372,
20221021,253,540,서서울,청북,739,37,52,108,66,37,1039,942,56,52,111,89,47,1297,
20221021,253,741,서서울,평택고덕,940,20,27,23,11,63,1084,1243,21,25,28,9,90,1416,
20221021,254,102,군자,동수원,4068,70,74,18,39,235,4504,4056,57,71,27,36,224,4471,
20221021,254,103,군자,수원신갈,1736,120,82,124,108,118,2288,1500,91,61,71,59,77,1859,
20221021,254,173,군자,양지,734,96,90,153,181,30,1284,945,108,81,188,195,49,1566,
20221021,254,212,군자,북수원,1037,25,34,13,17,54,1180,1782,32,30,19,18,100,1981,
20221021,254,213,군자,부곡,770,30,18,31,397,45,1291,965,36,28,43,518,64,1654,
20221021,254,215,군자,군포,3092,126,104,134,148,225,3829,2485,79,67,37,72,161,2901,
20221021,254,255,군자,서안산,10372,418,223,219,280,689,12201,9618,411,215,218,254,656,11372,
20221021,254,256,군자,안산,4676,121,116,42,53,361,5369,5283,112,125,57,74,398,6049,
20221021,254,281,군자,매송,851,25,18,25,57,62,1038,998,30,18,21,49,53,1169,
20221021,254,282,군자,비봉,1175,102,67,78,185,83,1690,1081,105,74,59,154,56,1529,
20221021,254,283,군자,발안,1006,78,58,68,127,68,1405,1127,74,61,66,104,75,1507,
20221021,255,102,서안산,동수원,1832,35,19,17,6,132,2041,1761,38,12,14,3,112,1940,
20221021,255,215,서안산,군포,1425,72,57,72,90,109,1825,1390,47,27,16,20,82,1582,
20221021,255,253,서안산,서서울,14399,529,554,534,286,859,17161,14948,525,652,594,295,910,17924,
20221021,255,254,서안산,군자,9618,411,215,218,254,656,11372,10372,418,223,219,280,689,12201,
20221021,256,253,안산,서서울,6262,117,67,34,54,450,6984,9235,178,88,47,22,671,10241,
20221021,256,254,안산,군자,5283,112,125,57,74,398,6049,4676,121,116,42,53,361,5369,
20221021,261,248,동광주,순창,1410,28,30,9,8,52,1537,1225,16,19,10,22,39,1331,
20221021,261,249,동광주,담양,2051,33,105,42,38,75,2344,2245,39,121,35,43,84,2567,
20221021,261,263,동광주,옥과,2772,34,121,15,34,140,3116,2449,24,110,11,39,107,2740,
20221021,261,265,동광주,곡성,1630,26,39,27,57,56,1835,1388,13,32,9,27,40,1509,
20221021,263,261,옥과,동광주,2449,24,110,11,39,107,2740,2772,34,121,15,34,140,3116,
20221021,265,261,곡성,동광주,1388,13,32,9,27,40,1509,1630,26,39,27,57,56,1835,
20221021,271,569,순천,북광주,1091,78,52,25,131,38,1415,1024,62,41,31,97,23,1278,
20221021,272,145,광양,산인,1104,17,55,33,33,27,1269,950,16,50,21,34,25,1096,
20221021,280,519,거창,남대구,1024,22,49,10,6,67,1178,1053,26,56,10,6,55,1206,
20221021,281,253,매송,서서울,4637,74,51,19,95,288,5164,3574,59,48,20,25,212,3938,
20221021,281,254,매송,군자,998,30,18,21,49,53,1169,851,25,18,25,57,62,1038,
20221021,282,253,비봉,서서울,5983,297,270,183,531,380,7644,5452,233,248,164,481,316,6894,
20221021,282,254,비봉,군자,1081,105,74,59,154,56,1529,1175,102,67,78,185,83,1690,
20221021,283,253,발안,서서울,4348,226,204,218,117,230,5343,3072,159,167,162,106,198,3864,
20221021,283,254,발안,군자,1127,74,61,66,104,75,1507,1006,78,58,68,127,68,1405,
20221021,285,253,서평택,서서울,1714,84,120,360,557,110,2945,1458,71,103,271,390,107,2400,
20221021,285,287,서평택,송악,730,33,91,83,567,54,1558,948,41,97,93,476,65,1720,
20221021,285,520,서평택,평택,670,38,67,67,109,56,1007,681,40,56,79,123,71,1050,
20221021,287,253,송악,서서울,2504,43,60,98,398,108,3211,2251,23,59,67,202,88,2690,
20221021,287,285,송악,서평택,948,41,97,93,476,65,1720,730,33,91,83,567,54,1558,
20221021,288,253,당진,서서울,1520,28,44,33,52,88,1765,1556,17,40,29,32,75,1749,
20221021,289,140,마산,부산,1220,13,9,5,8,45,1300,1157,12,15,6,8,47,1245,
20221021,289,146,마산,동창원,2794,99,81,49,83,216,3322,2964,86,80,50,98,234,3512,
20221021,289,147,마산,진례,1453,105,80,51,80,85,1854,1431,93,71,56,84,83,1818,
20221021,289,148,마산,서김해,1697,30,76,23,17,109,1952,1678,28,75,16,9,98,1904,
20221021,289,149,마산,동김해,1177,45,45,16,18,66,1367,968,35,43,21,15,73,1155,
20221021,289,150,마산,북부산,3590,33,95,22,75,177,3992,3099,36,97,16,38,160,3446,
20221021,289,244,마산,서부산,4214,82,304,53,132,182,4967,3784,78,274,51,102,170,4459,
20221021,289,245,마산,장유,1918,36,49,21,19,130,2173,1741,33,44,9,30,143,2000,
20221021,289,757,마산,진영,790,43,64,52,115,54,1118,977,53,58,52,94,56,1290,
20221021,291,145,사천,산인,2156,67,85,27,35,99,2469,2022,44,66,15,37,82,2266,
20221021,291,225,사천,서진주,1167,27,45,9,34,83,1365,1128,29,28,9,35,81,1310,
20221021,291,292,사천,진주,2846,80,94,37,55,240,3352,3738,102,106,54,61,287,4348,
20221021,292,145,진주,산인,2056,40,153,18,33,127,2427,1936,39,159,16,28,118,2296,
20221021,292,291,진주,사천,3738,102,106,54,61,287,4348,2846,80,94,37,55,240,3352,
20221021,293,145,문산,산인,1539,27,33,15,7,81,1702,1509,37,26,11,10,83,1676,
20221021,295,145,진성,산인,1072,25,36,5,12,31,1181,984,26,29,12,15,46,1112,
20221021,298,253,서산,서서울,2411,23,60,53,65,96,2708,3548,30,65,31,23,127,3824,
20221021,508,509,무안,목포,1442,46,41,31,77,67,1704,1759,39,49,26,67,76,2016,
20221021,508,553,무안,동광산,1440,19,32,26,42,49,1608,1503,31,43,27,33,54,1691,
20221021,509,508,목포,무안,1759,39,49,26,67,76,2016,1442,46,41,31,77,67,1704,
20221021,509,553,목포,동광산,7986,168,215,151,414,295,9229,7714,155,237,189,504,302,9101,
20221021,513,515,고성,북통영,1778,37,71,9,14,113,2022,2028,35,90,7,11,149,2320,
20221021,513,516,고성,통영,3841,88,137,93,162,285,4606,3694,94,160,86,170,245,4449,
20221021,514,516,동고성,통영,1338,30,49,51,113,177,1758,1285,19,56,64,127,179,1730,
20221021,515,513,북통영,고성,2028,35,90,7,11,149,2320,1778,37,71,9,14,113,2022,
20221021,516,513,통영,고성,3694,94,160,86,170,245,4449,3841,88,137,93,162,285,4606,
20221021,516,514,통영,동고성,1285,19,56,64,127,179,1730,1338,30,49,51,113,177,1758,
20221021,517,597,양평,서여주,820,27,68,49,42,48,1054,1000,20,31,31,25,50,1157,
20221021,517,598,양평,북여주,1433,18,28,23,89,46,1637,1586,22,23,22,37,64,1754,
20221021,518,127,칠곡물류,서대구,817,88,62,85,28,53,1133,877,119,88,96,31,50,1261,
20221021,519,231,남대구,화원옥포,6316,150,110,70,66,469,7181,6533,167,107,82,199,501,7589,
20221021,519,232,남대구,달성,2955,131,147,49,25,198,3505,2842,124,131,45,38,192,3372,
20221021,519,233,남대구,현풍,4491,205,208,99,87,304,5394,5147,217,210,87,130,362,6153,
20221021,519,239,남대구,칠원,1554,64,104,46,65,52,1885,1393,53,100,36,90,51,1723,
20221021,519,241,남대구,동고령,3244,90,91,289,101,153,3968,3145,103,92,301,103,152,3896,
20221021,519,242,남대구,고령,1948,44,54,16,190,84,2336,1816,40,69,26,206,100,2257,
20221021,519,280,남대구,거창,1053,26,56,10,6,55,1206,1024,22,49,10,6,67,1178,
20221021,519,730,남대구,유천,2613,59,32,0,9,172,2885,2958,58,21,0,0,202,3239,
20221021,519,731,남대구,북현풍,2121,28,25,0,8,130,2312,1693,35,8,0,0,116,1852,
20221021,520,253,평택,서서울,2705,110,102,210,137,108,3372,2235,104,93,151,133,102,2818,
20221021,520,285,평택,서평택,681,40,56,79,123,71,1050,670,38,67,67,109,56,1007,
20221021,520,540,평택,청북,1443,96,141,148,92,77,1997,840,91,139,142,110,48,1370,
20221021,520,741,평택,평택고덕,1105,10,192,8,21,80,1416,845,17,159,13,20,76,1130,
20221021,524,129,청통와촌,북대구,1213,63,38,14,33,49,1410,980,44,29,15,15,45,1128,
20221021,524,230,청통와촌,팔공산,1001,37,31,16,21,57,1163,1155,46,36,11,19,63,1330,
20221021,526,527,서포항,포항,948,12,16,8,50,57,1091,1234,16,12,6,38,77,1383,
20221021,527,127,포항,서대구,915,37,39,16,69,49,1125,1288,34,43,19,78,58,1520,
20221021,527,129,포항,북대구,2269,51,40,28,95,106,2589,1661,32,28,26,58,81,1886,
20221021,527,230,포항,팔공산,1572,29,16,8,18,62,1705,1590,32,22,10,19,74,1747,
20221021,527,526,포항,서포항,1234,16,12,6,38,77,1383,948,12,16,8,50,57,1091,
20221021,528,101,기흥동탄,서울,7503,74,1351,128,18,372,9446,7396,77,1224,132,26,408,9263,
20221021,528,103,기흥동탄,수원신갈,2132,19,172,6,4,121,2454,1553,27,213,3,7,102,1905,
20221021,528,106,기흥동탄,오산,917,36,44,11,14,76,1098,904,22,46,18,12,77,1079,
20221021,528,107,기흥동탄,안성,1204,20,24,5,7,106,1366,1088,7,22,3,6,99,1225,
20221021,528,108,기흥동탄,천안,1242,23,124,3,10,83,1485,1183,21,99,4,14,67,1388,
20221021,540,253,청북,서서울,942,56,52,111,89,47,1297,739,37,52,108,66,37,1039,
20221021,540,520,청북,평택,840,91,139,142,110,48,1370,1443,96,141,148,92,77,1997,
20221021,540,741,청북,평택고덕,968,18,40,79,91,93,1289,1132,35,45,89,108,102,1511,
20221021,541,108,송탄,천안,886,39,30,12,19,65,1051,865,40,28,18,8,57,1016,
20221021,542,101,서안성,서울,1866,53,70,144,47,89,2269,1283,32,81,84,24,66,1570,
20221021,542,543,서안성,남안성,1119,50,92,127,156,82,1626,1244,48,84,123,134,118,1751,
20221021,543,101,남안성,서울,1164,95,74,89,85,39,1546,1210,65,71,63,42,43,1494,
20221021,543,542,남안성,서안성,1244,48,84,123,134,118,1751,1119,50,92,127,156,82,1626,
20221021,543,555,남안성,북진천,885,99,153,180,151,47,1515,904,112,170,157,177,50,1570,
20221021,548,553,북무안,동광산,1513,39,31,36,89,44,1752,1822,36,35,34,122,56,2105,
20221021,549,553,동함평,동광산,3403,42,54,29,49,124,3701,3735,45,67,35,54,126,4062,
20221021,551,553,나주,동광산,1355,19,31,36,40,66,1547,1415,21,38,42,43,67,1626,
20221021,552,553,서광산,동광산,4770,175,173,214,212,154,5698,6295,219,215,221,187,215,7352,
20221021,553,508,동광산,무안,1503,31,43,27,33,54,1691,1440,19,32,26,42,49,1608,
20221021,553,509,동광산,목포,7714,155,237,189,504,302,9101,7986,168,215,151,414,295,9229,
20221021,553,548,동광산,북무안,1822,36,35,34,122,56,2105,1513,39,31,36,89,44,1752,
20221021,553,549,동광산,동함평,3735,45,67,35,54,126,4062,3403,42,54,29,49,124,3701,
20221021,553,551,동광산,나주,1415,21,38,42,43,67,1626,1355,19,31,36,40,66,1547,
20221021,553,552,동광산,서광산,6295,219,215,221,187,215,7352,4770,175,173,214,212,154,5698,
20221021,554,174,동홍천,춘천,1412,15,24,11,5,99,1566,1256,27,27,16,22,88,1436,
20221021,555,543,북진천,남안성,904,112,170,157,177,50,1570,885,99,153,180,151,47,1515,
20221021,560,190,감곡,동서울,1134,31,27,25,78,40,1335,1239,22,30,33,44,45,1413,
20221021,567,167,남고창,광주,1432,29,46,9,25,61,1602,1380,34,60,10,19,61,1564,
20221021,569,271,북광주,순천,1024,62,41,31,97,23,1278,1091,78,52,25,131,38,1415,
20221021,579,115,남세종,대전,1068,10,24,9,50,87,1248,1058,14,26,16,41,92,1247,
20221021,579,153,남세종,서대전,1034,19,15,5,13,73,1159,1249,19,9,3,9,103,1392,
20221021,583,704,동해,근덕,855,8,25,8,98,60,1054,915,9,27,8,55,69,1083,
20221021,587,589,오수,상관,1280,21,56,33,51,33,1474,1321,26,74,21,124,37,1603,
20221021,589,587,상관,오수,1321,26,74,21,124,37,1603,1280,21,56,33,51,33,1474,
20221021,597,517,서여주,양평,1000,20,31,31,25,50,1157,820,27,68,49,42,48,1054,
20221021,597,598,서여주,북여주,904,41,121,36,52,59,1213,1009,39,76,52,63,61,1300,
20221021,598,517,북여주,양평,1586,22,23,22,37,64,1754,1433,18,28,23,89,46,1637,
20221021,598,597,북여주,서여주,1009,39,76,52,63,61,1300,904,41,121,36,52,59,1213,
20221021,621,127,동대구,서대구,1320,36,36,27,25,83,1527,1870,55,78,33,43,126,2205,
20221021,621,131,동대구,경산,2355,65,61,147,21,123,2772,2245,58,41,169,36,109,2658,
20221021,621,132,동대구,영천,1253,20,22,1,12,58,1366,1256,14,24,3,14,51,1362,
20221021,625,626,밀양,남밀양,1408,64,63,50,54,72,1711,1643,46,48,49,44,84,1914,
20221021,626,625,남밀양,밀양,1643,46,48,49,44,84,1914,1408,64,63,50,54,72,1711,
20221021,626,627,남밀양,삼랑진,1035,28,35,21,44,110,1273,1034,26,33,26,35,117,1271,
20221021,627,626,삼랑진,남밀양,1034,26,33,26,35,117,1271,1035,28,35,21,44,110,1273,
20221021,641,139,울산,서울산,1319,27,62,22,29,95,1554,1358,44,61,31,33,103,1630,
20221021,641,252,울산,대동,1560,73,88,35,71,78,1905,1813,76,86,54,55,109,2193,
20221021,641,643,울산,청량,1151,11,19,13,40,106,1340,1332,14,15,8,13,131,1513,
20221021,641,648,울산,해운대,1028,4,13,2,4,69,1120,1151,12,20,1,6,76,1266,
20221021,641,706,울산,남경주,1234,13,34,11,16,71,1379,1259,5,30,12,21,67,1394,
20221021,641,707,울산,남포항,1332,20,27,16,183,61,1639,1355,23,24,28,161,68,1659,
20221021,643,641,청량,울산,1332,14,15,8,13,131,1513,1151,11,19,13,40,106,1340,
20221021,643,648,청량,해운대,3320,13,24,15,55,204,3631,3318,31,61,56,571,215,4252,
20221021,645,648,장안,해운대,1675,7,16,7,3,99,1807,2930,30,38,67,88,191,3344,
20221021,646,648,기장일광,해운대,4715,26,39,53,22,304,5159,5391,48,42,24,202,341,6048,
20221021,648,641,해운대,울산,1151,12,20,1,6,76,1266,1028,4,13,2,4,69,1120,
20221021,648,643,해운대,청량,3318,31,61,56,571,215,4252,3320,13,24,15,55,204,3631,
20221021,648,645,해운대,장안,2930,30,38,67,88,191,3344,1675,7,16,7,3,99,1807,
20221021,648,646,해운대,기장일광,5391,48,42,24,202,341,6048,4715,26,39,53,22,304,5159,
20221021,648,707,해운대,남포항,931,13,38,11,214,43,1250,1062,7,15,8,17,52,1161,
20221021,651,652,남양주,화도,13130,383,443,406,222,940,15524,16220,521,574,499,239,1226,19279,
20221021,651,653,남양주,서종,1870,14,10,2,31,74,2001,1740,22,19,3,39,75,1898,
20221021,651,654,남양주,설악,4767,47,101,12,11,145,5083,3558,29,99,16,13,122,3837,
20221021,651,655,남양주,강촌,3136,37,123,25,25,109,3455,2644,34,119,26,35,97,2955,
20221021,651,656,남양주,남춘천,3300,27,51,30,56,89,3553,2403,18,37,10,48,71,2587,
20221021,652,651,화도,남양주,16220,521,574,499,239,1226,19279,13130,383,443,406,222,940,15524,
20221021,652,653,화도,서종,1543,31,17,28,14,117,1750,1565,38,15,16,17,109,1760,
20221021,652,654,화도,설악,1906,30,21,5,9,106,2077,1247,23,18,9,9,74,1380,
20221021,653,651,서종,남양주,1740,22,19,3,39,75,1898,1870,14,10,2,31,74,2001,
20221021,653,652,서종,화도,1565,38,15,16,17,109,1760,1543,31,17,28,14,117,1750,
20221021,654,651,설악,남양주,3558,29,99,16,13,122,3837,4767,47,101,12,11,145,5083,
20221021,654,652,설악,화도,1247,23,18,9,9,74,1380,1906,30,21,5,9,106,2077,
20221021,655,651,강촌,남양주,2644,34,119,26,35,97,2955,3136,37,123,25,25,109,3455,
20221021,656,651,남춘천,남양주,2403,18,37,10,48,71,2587,3300,27,51,30,56,89,3553,
20221021,671,672,봉담,정남,3229,178,100,80,139,204,3930,4015,162,116,74,192,291,4850,
20221021,671,673,봉담,북오산,2157,53,55,18,22,163,2468,2099,39,58,25,23,137,2381,
20221021,671,675,봉담,서오산,886,34,17,5,14,75,1031,898,27,18,5,12,75,1035,
20221021,671,676,봉담,향남,1420,111,62,92,37,112,1834,1315,109,50,99,27,92,1692,
20221021,671,677,봉담,북평택,9052,180,256,146,322,470,10426,8629,166,225,137,232,459,9848,
20221021,672,671,정남,봉담,4015,162,116,74,192,291,4850,3229,178,100,80,139,204,3930,
20221021,673,101,북오산,서울,1328,30,118,22,12,87,1597,1432,34,126,20,13,91,1716,
20221021,673,671,북오산,봉담,2099,39,58,25,23,137,2381,2157,53,55,18,22,163,2468,
20221021,673,677,북오산,북평택,2188,31,100,25,75,156,2575,1988,36,61,28,77,124,2314,
20221021,675,671,서오산,봉담,898,27,18,5,12,75,1035,886,34,17,5,14,75,1031,
20221021,675,676,서오산,향남,3570,127,76,32,35,238,4078,3284,95,76,35,25,203,3718,
20221021,675,677,서오산,북평택,12933,237,438,166,208,771,14753,13148,248,400,186,179,808,14969,
20221021,675,876,서오산,양감,2079,81,44,46,124,129,2503,2244,69,32,38,95,152,2630,
20221021,676,671,향남,봉담,1315,109,50,99,27,92,1692,1420,111,62,92,37,112,1834,
20221021,676,675,향남,서오산,3284,95,76,35,25,203,3718,3570,127,76,32,35,238,4078,
20221021,676,677,향남,북평택,2009,189,193,232,152,124,2899,1563,140,136,200,122,91,2252,
20221021,677,101,북평택,서울,1675,57,223,94,120,81,2250,1571,47,266,74,103,59,2120,
20221021,677,671,북평택,봉담,8629,166,225,137,232,459,9848,9052,180,256,146,322,470,10426,
20221021,677,673,북평택,북오산,1988,36,61,28,77,124,2314,2188,31,100,25,75,156,2575,
20221021,677,675,북평택,서오산,13148,248,400,186,179,808,14969,12933,237,438,166,208,771,14753,
20221021,677,676,북평택,향남,1563,140,136,200,122,91,2252,2009,189,193,232,152,124,2899,
20221021,677,876,북평택,양감,2697,151,148,135,193,176,3500,2256,153,152,142,193,157,3053,
20221021,682,683,조암,송산마도,753,87,90,48,46,35,1059,905,106,107,61,66,46,1291,
20221021,682,684,조암,남안산,860,162,163,117,81,47,1430,1063,165,172,110,80,42,1632,
20221021,682,685,조암,서시흥,1802,177,131,153,221,79,2563,1843,194,166,159,296,102,2760,
20221021,683,682,송산마도,조암,905,106,107,61,66,46,1291,753,87,90,48,46,35,1059,
20221021,683,684,송산마도,남안산,2645,227,176,118,261,160,3587,2380,190,105,115,130,143,3063,
20221021,683,685,송산마도,서시흥,5635,302,218,191,920,321,7587,4823,274,225,165,931,269,6687,
20221021,684,682,남안산,조암,1063,165,172,110,80,42,1632,860,162,163,117,81,47,1430,
20221021,684,683,남안산,송산마도,2380,190,105,115,130,143,3063,2645,227,176,118,261,160,3587,
20221021,684,685,남안산,서시흥,5410,558,330,474,619,419,7810,5045,416,345,358,450,377,6991,
20221021,685,682,서시흥,조암,1843,194,166,159,296,102,2760,1802,177,131,153,221,79,2563,
20221021,685,683,서시흥,송산마도,4823,274,225,165,931,269,6687,5635,302,218,191,920,321,7587,
20221021,685,684,서시흥,남안산,5045,416,345,358,450,377,6991,5410,558,330,474,619,419,7810,
20221021,704,583,근덕,동해,915,9,27,8,55,69,1083,855,8,25,8,98,60,1054,
20221021,705,190,남이천,동서울,2326,101,63,105,93,67,2755,1521,92,74,119,147,45,1998,
20221021,706,641,남경주,울산,1259,5,30,12,21,67,1394,1234,13,34,11,16,71,1379,
20221021,706,707,남경주,남포항,1155,31,69,39,219,65,1578,1232,35,74,38,176,72,1627,
20221021,707,641,남포항,울산,1355,23,24,28,161,68,1659,1332,20,27,16,183,61,1639,
20221021,707,648,남포항,해운대,1062,7,15,8,17,52,1161,931,13,38,11,214,43,1250,
20221021,707,706,남포항,남경주,1232,35,74,38,176,72,1627,1155,31,69,39,219,65,1578,
20221021,707,708,남포항,동경주,1566,28,40,24,244,95,1997,1663,32,44,20,314,87,2160,
20221021,708,707,동경주,남포항,1663,32,44,20,314,87,2160,1566,28,40,24,244,95,1997,
20221021,715,716,동안동,청송,1128,26,24,19,25,54,1276,1202,24,13,21,27,53,1340,
20221021,716,715,청송,동안동,1202,24,13,21,27,53,1340,1128,26,24,19,25,54,1276,
20221021,730,519,유천,남대구,2958,58,21,0,0,202,3239,2613,59,32,0,9,172,2885,
20221021,731,519,북현풍,남대구,1693,35,8,0,0,116,1852,2121,28,25,0,8,130,2312,
20221021,741,253,평택고덕,서서울,1243,21,25,28,9,90,1416,940,20,27,23,11,63,1084,
20221021,741,520,평택고덕,평택,845,17,159,13,20,76,1130,1105,10,192,8,21,80,1416,
20221021,741,540,평택고덕,청북,1132,35,45,89,108,102,1511,968,18,40,79,91,93,1289,
20221021,742,107,남사진위,안성,1530,36,67,31,9,128,1801,1396,43,62,26,6,119,1652,
20221021,742,108,남사진위,천안,1250,31,36,30,11,80,1438,1281,28,31,25,10,92,1467,
20221021,752,252,기장철마,대동,2015,60,57,31,60,156,2379,1999,62,42,40,133,143,2419,
20221021,753,252,금정,대동,1177,71,68,50,105,80,1551,1962,103,96,92,215,121,2589,
20221021,755,140,광재,부산,958,17,20,11,49,63,1118,1084,13,22,10,46,73,1248,
20221021,755,252,광재,대동,2220,100,88,87,508,144,3147,2343,88,100,73,294,155,3053,
20221021,756,252,한림,대동,976,56,45,26,148,49,1300,871,39,37,17,92,42,1098,
20221021,757,289,진영,마산,977,53,58,52,94,56,1290,790,43,64,52,115,54,1118,
20221021,772,774,북달성,남칠곡,2683,45,54,37,39,152,3010,2688,51,57,40,39,150,3025,
20221021,773,774,북다사,남칠곡,1479,19,23,10,14,82,1627,1337,26,24,12,12,87,1498,
20221021,774,772,남칠곡,북달성,2688,51,57,40,39,150,3025,2683,45,54,37,39,152,3010,
20221021,774,773,남칠곡,북다사,1337,26,24,12,12,87,1498,1479,19,23,10,14,82,1627,
20221021,775,203,동명동호,가산,1866,70,45,41,255,68,2345,1761,71,47,47,287,75,2288,
20221021,776,777,연경,파군재,3615,51,55,21,25,231,3998,2645,31,45,13,21,169,2924,
20221021,776,779,연경,율암,6363,103,89,73,229,451,7308,6486,98,93,72,196,461,7406,
20221021,777,776,파군재,연경,2645,31,45,13,21,169,2924,3615,51,55,21,25,231,3998,
20221021,777,779,파군재,율암,2816,22,28,3,3,247,3119,2571,26,29,7,5,225,2863,
20221021,779,776,율암,연경,6486,98,93,72,196,461,7406,6363,103,89,73,229,451,7308,
20221021,779,777,율암,파군재,2571,26,29,7,5,225,2863,2816,22,28,3,3,247,3119,
20221021,876,675,양감,서오산,2244,69,32,38,95,152,2630,2079,81,44,46,124,129,2503,
20221021,876,677,양감,북평택,2256,153,152,142,193,157,3053,2697,151,148,135,193,176,3500,
20221021,981,982,서영암,강진무위사,2228,32,73,48,63,73,2517,2180,45,61,85,77,83,2531,
20221021,981,987,서영암,남순천,2627,38,100,72,304,93,3234,2053,42,134,108,371,71,2779,
20221021,982,981,강진무위사,서영암,2180,45,61,85,77,83,2531,2228,32,73,48,63,73,2517,
20221021,982,987,강진무위사,남순천,1028,14,47,41,98,34,1262,816,19,54,31,84,16,1020,
20221021,984,985,보성,벌교,1920,49,58,41,67,58,2193,1901,54,62,31,51,55,2154,
20221021,984,987,보성,남순천,2316,43,97,69,297,60,2882,2253,42,80,62,304,68,2809,
20221021,985,984,벌교,보성,1901,54,62,31,51,55,2154,1920,49,58,41,67,58,2193,
20221021,986,987,고흥,남순천,4196,78,136,157,257,170,4994,4581,80,169,163,265,156,5414,
20221021,987,981,남순천,서영암,2053,42,134,108,371,71,2779,2627,38,100,72,304,93,3234,
20221021,987,982,남순천,강진무위사,816,19,54,31,84,16,1020,1028,14,47,41,98,34,1262,
20221021,987,984,남순천,보성,2253,42,80,62,304,68,2809,2316,43,97,69,297,60,2882,
20221021,987,986,남순천,고흥,4581,80,169,163,265,156,5414,4196,78,136,157,257,170,4994,
20221022,101,102,서울,동수원,4153,41,210,6,2,211,4623,5168,36,328,13,14,258,5817,
20221022,101,103,서울,수원신갈,14786,394,1008,280,70,627,17165,13905,438,995,267,77,621,16303,
20221022,101,105,서울,기흥,6353,59,148,50,30,243,6883,5428,63,176,73,22,237,5999,
20221022,101,106,서울,오산,4858,199,343,109,36,264,5809,5412,290,367,117,47,323,6556,
20221022,101,107,서울,안성,4177,48,303,19,24,194,4765,3664,38,267,22,19,161,4171,
20221022,101,108,서울,천안,5687,31,387,31,15,241,6392,5387,39,388,26,9,219,6068,
20221022,101,111,서울,청주,869,8,340,15,7,32,1271,833,9,341,17,18,28,1246,
20221022,101,171,서울,마성,3843,56,146,39,1,161,4246,3284,8,147,39,1,159,3638,
20221022,101,172,서울,용인,2707,66,76,23,7,154,3033,3695,103,84,35,17,197,4131,
20221022,101,173,서울,양지,2545,116,114,35,28,75,2913,4491,258,120,83,73,153,5178,
20221022,101,528,서울,기흥동탄,6933,38,528,96,9,276,7880,6424,43,531,97,5,256,7356,
20221022,101,542,서울,서안성,1274,18,58,72,14,58,1494,2293,26,53,142,29,120,2663,
20221022,101,543,서울,남안성,1048,42,29,37,39,43,1238,1130,65,60,55,44,60,1414,
20221022,101,673,서울,북오산,1597,26,91,18,5,96,1833,1624,22,94,15,6,105,1866,
20221022,101,677,서울,북평택,2990,33,218,33,64,122,3460,2601,25,223,40,88,123,3100,
20221022,102,101,동수원,서울,5168,36,328,13,14,258,5817,4153,41,210,6,2,211,4623,
20221022,102,212,동수원,북수원,3316,14,151,10,11,178,3680,3515,17,148,7,7,171,3865,
20221022,102,214,동수원,동군포,1589,31,6,8,2,80,1716,1356,16,8,5,2,87,1474,
20221022,102,215,동수원,군포,1403,13,16,1,3,87,1523,1955,18,18,1,2,112,2106,
20221022,102,253,동수원,서서울,6090,47,38,12,17,327,6531,5907,45,34,11,9,330,6336,
20221022,102,254,동수원,군자,4785,30,32,14,24,221,5106,5469,49,45,23,30,253,5869,
20221022,102,255,동수원,서안산,1305,28,6,2,3,78,1422,1601,27,11,10,2,92,1743,
20221022,103,101,수원신갈,서울,13905,438,995,267,77,621,16303,14786,394,1008,280,70,627,17165,
20221022,103,105,수원신갈,기흥,1880,15,17,4,17,98,2031,2409,16,9,2,14,96,2546,
20221022,103,108,수원신갈,천안,1103,5,32,1,1,40,1182,1276,7,34,5,3,55,1380,
20221022,103,212,수원신갈,북수원,874,27,24,11,18,47,1001,1490,46,24,23,26,84,1693,
20221022,103,253,수원신갈,서서울,2402,104,54,39,20,108,2727,2755,70,53,42,26,149,3095,
20221022,103,254,수원신갈,군자,1910,68,46,47,38,110,2219,2679,81,45,76,50,138,3069,
20221022,103,528,수원신갈,기흥동탄,1162,9,19,3,3,41,1237,1479,10,9,2,5,72,1577,
20221022,105,101,기흥,서울,5428,63,176,73,22,237,5999,6353,59,148,50,30,243,6883,
20221022,105,103,기흥,수원신갈,2409,16,9,2,14,96,2546,1880,15,17,4,17,98,2031,
20221022,106,101,오산,서울,5412,290,367,117,47,323,6556,4858,199,343,109,36,264,5809,
20221022,106,107,오산,안성,1325,21,14,10,14,94,1478,999,19,14,7,11,76,1126,
20221022,107,101,안성,서울,3664,38,267,22,19,161,4171,4177,48,303,19,24,194,4765,
20221022,107,106,안성,오산,999,19,14,7,11,76,1126,1325,21,14,10,14,94,1478,
20221022,107,108,안성,천안,1643,12,36,4,4,113,1812,1721,20,26,9,3,114,1893,
20221022,107,742,안성,남사진위,1109,27,42,12,9,74,1273,1659,22,41,20,5,93,1840,
20221022,108,101,천안,서울,5387,39,388,26,9,219,6068,5687,31,387,31,15,241,6392,
20221022,108,103,천안,수원신갈,1276,7,34,5,3,55,1380,1103,5,32,1,1,40,1182,
20221022,108,107,천안,안성,1721,20,26,9,3,114,1893,1643,12,36,4,4,113,1812,
20221022,108,229,천안,북천안,2003,39,77,20,24,108,2271,2084,43,85,28,32,108,2380,
20221022,108,542,천안,서안성,995,16,47,18,13,43,1132,894,21,55,20,10,47,1047,
20221022,108,742,천안,남사진위,1127,13,18,13,5,51,1227,1515,22,18,24,8,61,1648,
20221022,111,101,청주,서울,833,9,341,17,18,28,1246,869,8,340,15,7,32,1271,
20221022,112,115,남청주,대전,1336,58,60,5,47,81,1587,1297,69,44,8,16,77,1511,
20221022,114,153,남대전,서대전,1626,21,34,29,75,112,1897,1433,25,43,22,74,88,1685,
20221022,115,112,대전,남청주,1297,69,44,8,16,77,1511,1336,58,60,5,47,81,1587,
20221022,115,116,대전,옥천,2397,73,40,10,8,161,2689,2139,39,31,18,16,162,2405,
20221022,116,115,옥천,대전,2139,39,31,18,16,162,2405,2397,73,40,10,8,161,2689,
20221022,119,153,판암,서대전,1980,16,16,8,36,147,2203,2032,19,13,4,35,154,2257,
20221022,123,127,구미,서대구,1965,23,24,11,2,97,2122,1988,20,29,8,3,100,2148,
20221022,123,129,구미,북대구,2112,8,62,5,2,96,2285,2188,12,69,3,2,93,2367,
20221022,125,127,남구미,서대구,1814,28,53,18,13,105,2031,1864,31,62,22,16,111,2106,
20221022,125,129,남구미,북대구,1755,13,22,4,2,75,1871,1906,14,24,6,3,88,2041,
20221022,126,127,왜관,서대구,2266,73,44,29,70,132,2614,2427,82,50,32,33,128,2752,
20221022,126,129,왜관,북대구,2790,60,37,13,63,138,3101,3315,70,36,7,67,161,3656,
20221022,127,123,서대구,구미,1988,20,29,8,3,100,2148,1965,23,24,11,2,97,2122,
20221022,127,125,서대구,남구미,1864,31,62,22,16,111,2106,1814,28,53,18,13,105,2031,
20221022,127,126,서대구,왜관,2427,82,50,32,33,128,2752,2266,73,44,29,70,132,2614,
20221022,127,131,서대구,경산,2090,101,69,56,42,113,2471,1463,62,41,35,29,78,1708,
20221022,127,203,서대구,가산,2336,29,42,16,26,100,2549,2266,48,34,12,61,112,2533,
20221022,127,230,서대구,팔공산,1551,24,27,13,5,90,1710,930,18,13,6,4,40,1011,
20221022,127,527,서대구,포항,2273,25,30,15,43,98,2484,1316,25,26,5,35,65,1472,
20221022,127,621,서대구,동대구,1794,36,62,13,24,104,2033,1047,20,19,16,21,62,1185,
20221022,129,123,북대구,구미,2188,12,69,3,2,93,2367,2112,8,62,5,2,96,2285,
20221022,129,125,북대구,남구미,1906,14,24,6,3,88,2041,1755,13,22,4,2,75,1871,
20221022,129,126,북대구,왜관,3315,70,36,7,67,161,3656,2790,60,37,13,63,138,3101,
20221022,129,131,북대구,경산,1726,67,39,32,28,72,1964,2398,99,64,32,35,123,2751,
20221022,129,527,북대구,포항,2552,16,13,19,33,90,2723,3136,35,27,15,65,126,3404,
20221022,131,127,경산,서대구,1463,62,41,35,29,78,1708,2090,101,69,56,42,113,2471,
20221022,131,129,경산,북대구,2398,99,64,32,35,123,2751,1726,67,39,32,28,72,1964,
20221022,131,230,경산,팔공산,1037,34,29,3,17,54,1174,1147,38,29,9,13,64,1300,
20221022,131,621,경산,동대구,1818,43,37,15,78,78,2069,1814,45,38,7,32,99,2035,
20221022,132,621,영천,동대구,1177,9,20,2,20,64,1292,1244,8,17,1,24,60,1354,
20221022,135,140,경주,부산,2527,12,32,5,15,91,2682,2708,17,38,4,6,93,2866,
20221022,135,252,경주,대동,1817,14,62,17,44,80,2034,2341,18,66,11,20,110,2566,
20221022,135,621,경주,동대구,1201,7,47,1,1,51,1308,1369,2,49,3,2,46,1471,
20221022,137,140,통도사,부산,855,26,9,3,64,57,1014,1099,16,16,6,79,56,1272,
20221022,138,140,양산,부산,3908,175,90,25,43,196,4437,4019,199,98,34,51,201,4602,
20221022,138,252,양산,대동,1707,168,85,59,127,73,2219,1939,152,82,59,126,74,2432,
20221022,139,140,서울산,부산,2291,30,27,4,3,98,2453,2242,38,26,3,5,88,2402,
20221022,139,252,서울산,대동,1276,17,29,13,18,55,1408,1351,21,17,14,14,52,1469,
20221022,139,641,서울산,울산,1554,23,59,10,18,102,1766,1441,11,46,5,18,82,1603,
20221022,140,135,부산,경주,2708,17,38,4,6,93,2866,2527,12,32,5,15,91,2682,
20221022,140,137,부산,통도사,1099,16,16,6,79,56,1272,855,26,9,3,64,57,1014,
20221022,140,138,부산,양산,4019,199,98,34,51,201,4602,3908,175,90,25,43,196,4437,
20221022,140,139,부산,서울산,2242,38,26,3,5,88,2402,2291,30,27,4,3,98,2453,
20221022,140,250,부산,남양산,7954,113,177,16,17,536,8813,7674,95,152,12,19,516,8468,
20221022,140,251,부산,물금,890,102,20,17,18,49,1096,1102,86,20,19,20,70,1317,
20221022,140,252,부산,대동,1274,26,19,16,30,74,1439,1119,25,11,17,54,81,1307,
20221022,140,286,부산,통도사휴게소,1093,5,5,0,0,36,1139,1113,3,3,0,0,30,1149,
20221022,140,289,부산,마산,1728,5,14,6,1,59,1813,1238,8,8,4,0,57,1315,
20221022,140,755,부산,광재,1008,12,12,3,17,63,1115,926,12,12,1,14,51,1016,
20221022,142,145,군북,산인,4471,37,69,25,58,261,4921,5633,42,61,24,61,314,6135,
20221022,143,145,장지,산인,957,12,17,8,27,74,1095,951,5,12,8,39,71,1086,
20221022,144,145,함안,산인,2264,19,30,13,55,167,2548,2431,27,24,13,32,169,2696,
20221022,145,142,산인,군북,5633,42,61,24,61,314,6135,4471,37,69,25,58,261,4921,
20221022,145,143,산인,장지,951,5,12,8,39,71,1086,957,12,17,8,27,74,1095,
20221022,145,144,산인,함안,2431,27,24,13,32,169,2696,2264,19,30,13,55,167,2548,
20221022,145,272,산인,광양,1511,9,67,11,14,39,1651,1038,2,50,16,4,25,1135,
20221022,145,291,산인,사천,4336,34,53,7,26,157,4613,3090,38,51,11,18,135,3343,
20221022,145,292,산인,진주,3303,20,154,5,11,174,3667,3157,20,145,4,17,158,3501,
20221022,145,293,산인,문산,2432,30,23,7,8,132,2632,2111,22,20,5,10,111,2279,
20221022,145,295,산인,진성,1401,21,13,9,5,68,1517,1237,12,16,7,6,54,1332,
20221022,146,150,동창원,북부산,1259,15,14,1,20,75,1384,1620,12,10,2,20,89,1753,
20221022,146,244,동창원,서부산,1339,13,30,6,30,82,1500,1935,19,24,12,39,105,2134,
20221022,146,245,동창원,장유,939,10,5,3,6,96,1059,993,6,9,1,4,85,1098,
20221022,146,289,동창원,마산,2722,40,43,13,71,215,3104,2465,39,35,12,61,184,2796,
20221022,147,244,진례,서부산,1109,42,16,26,48,77,1318,1255,46,27,23,46,86,1483,
20221022,147,289,진례,마산,879,38,31,22,44,58,1072,842,27,29,21,47,47,1013,
20221022,148,150,서김해,북부산,6539,76,70,29,63,444,7221,6421,61,60,24,52,448,7066,
20221022,148,251,서김해,물금,938,32,11,14,6,69,1070,931,33,11,24,7,56,1062,
20221022,148,289,서김해,마산,2179,19,58,8,20,109,2393,1737,12,56,10,10,107,1932,
20221022,149,150,동김해,북부산,10456,145,125,17,42,753,11538,8845,118,115,18,25,578,9699,
20221022,149,250,동김해,남양산,1058,20,45,4,3,88,1218,869,15,47,4,2,70,1007,
20221022,149,251,동김해,물금,1138,39,7,7,3,79,1273,992,33,10,4,3,91,1133,
20221022,149,289,동김해,마산,1164,14,41,12,9,74,1314,1031,15,29,8,8,66,1157,
20221022,150,146,북부산,동창원,1620,12,10,2,20,89,1753,1259,15,14,1,20,75,1384,
20221022,150,148,북부산,서김해,6421,61,60,24,52,448,7066,6539,76,70,29,63,444,7221,
20221022,150,149,북부산,동김해,8845,118,115,18,25,578,9699,10456,145,125,17,42,753,11538,
20221022,150,245,북부산,장유,4116,24,84,7,19,224,4474,3625,29,77,6,11,215,3963,
20221022,150,289,북부산,마산,5562,23,146,5,15,222,5973,4637,38,135,8,8,175,5001,
20221022,152,154,유성,안영,1049,13,26,5,7,52,1152,1035,11,15,8,15,49,1133,
20221022,153,114,서대전,남대전,1433,25,43,22,74,88,1685,1626,21,34,29,75,112,1897,
20221022,153,119,서대전,판암,2032,19,13,4,35,154,2257,1980,16,16,8,36,147,2203,
20221022,153,154,서대전,안영,1159,16,17,12,78,62,1344,1123,26,20,7,63,54,1293,
20221022,153,579,서대전,남세종,973,14,7,3,4,63,1064,1080,16,7,0,14,52,1169,
20221022,154,152,안영,유성,1035,11,15,8,15,49,1133,1049,13,26,5,7,52,1152,
20221022,154,153,안영,서대전,1123,26,20,7,63,54,1293,1159,16,17,12,78,62,1344,
20221022,158,167,전주,광주,889,31,65,15,12,23,1035,1047,25,78,19,9,36,1214,
20221022,159,167,서전주,광주,2078,42,48,27,18,66,2279,2022,49,30,23,17,58,2199,
20221022,163,167,정읍,광주,972,15,38,18,11,30,1084,911,30,36,16,11,31,1035,
20221022,166,167,장성,광주,2330,57,59,22,42,91,2601,3143,83,57,23,32,121,3459,
20221022,167,158,광주,전주,1047,25,78,19,9,36,1214,889,31,65,15,12,23,1035,
20221022,167,159,광주,서전주,2022,49,30,23,17,58,2199,2078,42,48,27,18,66,2279,
20221022,167,163,광주,정읍,911,30,36,16,11,31,1035,972,15,38,18,11,30,1084,
20221022,167,166,광주,장성,3143,83,57,23,32,121,3459,2330,57,59,22,42,91,2601,
20221022,167,567,광주,남고창,1757,22,42,4,18,60,1903,1695,21,38,4,9,55,1822,
20221022,171,101,마성,서울,3284,8,147,39,1,159,3638,3843,56,146,39,1,161,4246,
20221022,171,253,마성,서서울,1159,6,10,2,2,54,1233,1351,6,8,0,5,55,1425,
20221022,172,101,용인,서울,3695,103,84,35,17,197,4131,2707,66,76,23,7,154,3033,
20221022,172,173,용인,양지,1560,73,41,48,97,100,1919,1273,63,59,53,115,98,1661,
20221022,172,253,용인,서서울,1076,26,14,16,5,54,1191,990,17,11,10,5,47,1080,
20221022,173,101,양지,서울,4491,258,120,83,73,153,5178,2545,116,114,35,28,75,2913,
20221022,173,172,양지,용인,1273,63,59,53,115,98,1661,1560,73,41,48,97,100,1919,
20221022,174,179,춘천,홍천,3650,46,69,14,31,283,4093,3177,47,60,18,24,247,3573,
20221022,174,216,춘천,횡성,1324,35,19,14,28,56,1476,1233,27,20,13,21,62,1376,
20221022,174,218,춘천,남원주,1447,26,64,6,11,79,1633,1458,15,63,10,6,78,1630,
20221022,174,554,춘천,동홍천,1295,15,30,5,15,78,1438,1299,16,24,2,7,76,1424,
20221022,176,190,이천,동서울,1619,30,69,107,34,72,1931,1165,21,53,21,19,75,1354,
20221022,177,190,여주,동서울,1267,8,31,19,22,45,1392,1170,5,32,29,16,42,1294,
20221022,179,174,홍천,춘천,3177,47,60,18,24,247,3573,3650,46,69,14,31,283,4093,
20221022,184,189,대관령,강릉,1802,30,50,7,13,95,1997,1811,34,59,6,9,94,2013,
20221022,189,184,강릉,대관령,1811,34,59,6,9,94,2013,1802,30,50,7,13,95,1997,
20221022,190,176,동서울,이천,1165,21,53,21,19,75,1354,1619,30,69,107,34,72,1931,
20221022,190,177,동서울,여주,1170,5,32,29,16,42,1294,1267,8,31,19,22,45,1392,
20221022,190,191,동서울,경기광주,9297,266,266,105,115,512,10561,9120,281,273,177,178,547,10576,
20221022,190,192,동서울,곤지암,4460,189,103,78,54,211,5095,4095,213,77,78,29,201,4693,
20221022,190,193,동서울,일죽,3085,46,94,83,70,107,3485,2938,52,98,110,64,107,3369,
20221022,190,194,동서울,서이천,4313,331,208,93,32,206,5183,3492,275,158,93,39,168,4225,
20221022,190,198,동서울,서청주,1085,10,26,14,5,43,1183,1388,11,15,16,10,59,1499,
20221022,190,199,동서울,오창,1301,8,5,10,19,63,1406,1307,3,7,7,9,46,1379,
20221022,190,560,동서울,감곡,1173,4,10,8,34,34,1263,1157,9,8,8,44,30,1256,
20221022,190,705,동서울,남이천,1445,34,25,26,44,42,1616,1832,39,20,44,40,46,2021,
20221022,191,190,경기광주,동서울,9120,281,273,177,178,547,10576,9297,266,266,105,115,512,10561,
20221022,192,190,곤지암,동서울,4095,213,77,78,29,201,4693,4460,189,103,78,54,211,5095,
20221022,192,194,곤지암,서이천,1542,153,68,58,47,81,1949,1314,104,56,37,40,71,1622,
20221022,193,190,일죽,동서울,2938,52,98,110,64,107,3369,3085,46,94,83,70,107,3485,
20221022,194,190,서이천,동서울,3492,275,158,93,39,168,4225,4313,331,208,93,32,206,5183,
20221022,194,192,서이천,곤지암,1314,104,56,37,40,71,1622,1542,153,68,58,47,81,1949,
20221022,196,198,진천,서청주,923,26,58,24,28,46,1105,910,19,53,19,22,45,1068,
20221022,198,190,서청주,동서울,1388,11,15,16,10,59,1499,1085,10,26,14,5,43,1183,
20221022,198,196,서청주,진천,910,19,53,19,22,45,1068,923,26,58,24,28,46,1105,
20221022,199,190,오창,동서울,1307,3,7,7,9,46,1379,1301,8,5,10,19,63,1406,
20221022,203,127,가산,서대구,2266,48,34,12,61,112,2533,2336,29,42,16,26,100,2549,
20221022,203,775,가산,동명동호,1987,33,38,23,200,80,2361,1728,39,19,20,85,77,1968,
20221022,207,775,남안동,동명동호,1030,6,8,4,3,34,1085,1107,12,3,1,4,33,1160,
20221022,212,102,북수원,동수원,3515,17,148,7,7,171,3865,3316,14,151,10,11,178,3680,
20221022,212,103,북수원,수원신갈,1490,46,24,23,26,84,1693,874,27,24,11,18,47,1001,
20221022,212,253,북수원,서서울,2328,26,12,3,7,131,2507,933,11,17,5,7,61,1034,
20221022,212,254,북수원,군자,2021,28,35,14,12,119,2229,1548,19,23,7,7,93,1697,
20221022,213,253,부곡,서서울,1342,68,30,22,42,82,1586,1030,56,30,26,27,70,1239,
20221022,213,254,부곡,군자,1007,22,15,9,192,49,1294,1016,20,14,11,196,61,1318,
20221022,214,102,동군포,동수원,1356,16,8,5,2,87,1474,1589,31,6,8,2,80,1716,
20221022,215,102,군포,동수원,1955,18,18,1,2,112,2106,1403,13,16,1,3,87,1523,
20221022,215,253,군포,서서울,3623,31,47,16,32,218,3967,4263,79,79,57,45,262,4785,
20221022,215,254,군포,군자,2598,31,24,31,37,149,2870,3540,71,50,49,77,209,3996,
20221022,216,174,횡성,춘천,1233,27,20,13,21,62,1376,1324,35,19,14,28,56,1476,
20221022,218,174,남원주,춘천,1458,15,63,10,6,78,1630,1447,26,64,6,11,79,1633,
20221022,218,240,남원주,제천,2286,28,44,16,37,113,2524,2309,34,44,9,27,133,2556,
20221022,225,291,서진주,사천,1104,18,23,8,16,62,1231,998,17,20,4,14,59,1112,
20221022,225,516,서진주,통영,930,3,11,2,3,67,1016,921,7,6,2,2,70,1008,
20221022,229,108,북천안,천안,2084,43,85,28,32,108,2380,2003,39,77,20,24,108,2271,
20221022,230,127,팔공산,서대구,930,18,13,6,4,40,1011,1551,24,27,13,5,90,1710,
20221022,230,131,팔공산,경산,1147,38,29,9,13,64,1300,1037,34,29,3,17,54,1174,
20221022,230,524,팔공산,청통와촌,1074,28,22,5,19,52,1200,928,26,15,6,30,43,1048,
20221022,230,527,팔공산,포항,2568,19,15,5,13,85,2705,2164,20,14,3,11,85,2297,
20221022,231,519,화원옥포,남대구,5454,107,74,37,164,417,6253,5208,100,84,25,105,399,5921,
20221022,232,519,달성,남대구,2125,61,70,22,23,154,2455,2025,55,64,23,12,127,2306,
20221022,233,519,현풍,남대구,3928,70,117,33,44,242,4434,3562,64,80,45,29,203,3983,
20221022,237,239,남지,칠원,1009,14,41,7,58,78,1207,1126,15,46,13,57,96,1353,
20221022,238,239,칠서,칠원,1140,35,46,51,411,59,1742,1237,43,44,33,405,65,1827,
20221022,239,237,칠원,남지,1126,15,46,13,57,96,1353,1009,14,41,7,58,78,1207,
20221022,239,238,칠원,칠서,1237,43,44,33,405,65,1827,1140,35,46,51,411,59,1742,
20221022,239,519,칠원,남대구,2239,22,101,23,58,110,2553,2503,27,80,34,37,121,2802,
20221022,240,218,제천,남원주,2309,34,44,9,27,133,2556,2286,28,44,16,37,113,2524,
20221022,241,519,동고령,남대구,3132,52,74,39,108,160,3565,3034,51,59,26,109,150,3429,
20221022,242,519,고령,남대구,2829,26,37,13,127,124,3156,3672,17,48,10,137,153,4037,
20221022,244,146,서부산,동창원,1935,19,24,12,39,105,2134,1339,13,30,6,30,82,1500,
20221022,244,147,서부산,진례,1255,46,27,23,46,86,1483,1109,42,16,26,48,77,1318,
20221022,244,245,서부산,장유,14320,123,308,58,98,1002,15909,14174,106,314,48,117,958,15717,
20221022,244,289,서부산,마산,6320,29,322,25,48,279,7023,4760,23,279,27,24,203,5316,
20221022,245,146,장유,동창원,993,6,9,1,4,85,1098,939,10,5,3,6,96,1059,
20221022,245,150,장유,북부산,3625,29,77,6,11,215,3963,4116,24,84,7,19,224,4474,
20221022,245,244,장유,서부산,14174,106,314,48,117,958,15717,14320,123,308,58,98,1002,15909,
20221022,245,289,장유,마산,2017,14,41,9,4,98,2183,1780,13,39,7,5,108,1952,
20221022,250,140,남양산,부산,7674,95,152,12,19,516,8468,7954,113,177,16,17,536,8813,
20221022,250,149,남양산,동김해,869,15,47,4,2,70,1007,1058,20,45,4,3,88,1218,
20221022,250,252,남양산,대동,2958,94,60,32,59,211,3414,3772,81,67,48,69,256,4293,
20221022,251,140,물금,부산,1102,86,20,19,20,70,1317,890,102,20,17,18,49,1096,
20221022,251,148,물금,서김해,931,33,11,24,7,56,1062,938,32,11,14,6,69,1070,
20221022,251,149,물금,동김해,992,33,10,4,3,91,1133,1138,39,7,7,3,79,1273,
20221022,251,252,물금,대동,2647,141,39,66,278,182,3353,3540,158,40,53,316,229,4336,
20221022,252,135,대동,경주,2341,18,66,11,20,110,2566,1817,14,62,17,44,80,2034,
20221022,252,138,대동,양산,1939,152,82,59,126,74,2432,1707,168,85,59,127,73,2219,
20221022,252,139,대동,서울산,1351,21,17,14,14,52,1469,1276,17,29,13,18,55,1408,
20221022,252,140,대동,부산,1119,25,11,17,54,81,1307,1274,26,19,16,30,74,1439,
20221022,252,250,대동,남양산,3772,81,67,48,69,256,4293,2958,94,60,32,59,211,3414,
20221022,252,251,대동,물금,3540,158,40,53,316,229,4336,2647,141,39,66,278,182,3353,
20221022,252,641,대동,울산,2031,22,55,12,32,115,2267,2046,33,51,21,41,111,2303,
20221022,252,752,대동,기장철마,1717,21,17,15,67,118,1955,1848,23,22,13,32,142,2080,
20221022,252,753,대동,금정,1756,40,41,23,130,121,2111,997,22,31,20,68,64,1202,
20221022,252,755,대동,광재,1742,39,43,29,142,115,2110,1660,36,37,30,249,108,2120,
20221022,253,102,서서울,동수원,5907,45,34,11,9,330,6336,6090,47,38,12,17,327,6531,
20221022,253,103,서서울,수원신갈,2755,70,53,42,26,149,3095,2402,104,54,39,20,108,2727,
20221022,253,171,서서울,마성,1351,6,8,0,5,55,1425,1159,6,10,2,2,54,1233,
20221022,253,172,서서울,용인,990,17,11,10,5,47,1080,1076,26,14,16,5,54,1191,
20221022,253,212,서서울,북수원,933,11,17,5,7,61,1034,2328,26,12,3,7,131,2507,
20221022,253,213,서서울,부곡,1030,56,30,26,27,70,1239,1342,68,30,22,42,82,1586,
20221022,253,215,서서울,군포,4263,79,79,57,45,262,4785,3623,31,47,16,32,218,3967,
20221022,253,255,서서울,서안산,10870,225,143,155,222,594,12209,11599,204,106,101,197,644,12851,
20221022,253,256,서서울,안산,8832,119,75,32,18,593,9669,5977,91,57,22,33,394,6574,
20221022,253,257,서서울,홍성,1747,4,11,4,4,62,1832,1057,1,12,4,1,43,1118,
20221022,253,259,서서울,대천,1670,9,14,4,0,56,1753,992,5,11,5,1,43,1057,
20221022,253,281,서서울,매송,3495,27,18,5,16,181,3742,4330,23,22,5,68,247,4695,
20221022,253,282,서서울,비봉,5354,102,127,64,467,278,6392,5444,129,101,81,434,284,6473,
20221022,253,283,서서울,발안,2841,49,40,29,53,182,3194,3421,82,55,47,66,198,3869,
20221022,253,285,서서울,서평택,1623,9,41,51,116,81,1921,1594,32,38,71,185,110,2030,
20221022,253,287,서서울,송악,2613,16,22,19,117,127,2914,3383,17,32,44,220,192,3888,
20221022,253,288,서서울,당진,1730,5,34,13,10,66,1858,1922,9,33,15,46,91,2116,
20221022,253,298,서서울,서산,4099,16,51,33,8,131,4338,3595,16,41,19,25,115,3811,
20221022,253,520,서서울,평택,3516,49,46,61,76,136,3884,3305,48,49,68,59,139,3668,
20221022,253,540,서서울,청북,1040,12,15,14,29,43,1153,854,23,15,47,44,47,1030,
20221022,253,741,서서울,평택고덕,1342,13,14,9,2,71,1451,1730,15,13,13,8,123,1902,
20221022,254,102,군자,동수원,5469,49,45,23,30,253,5869,4785,30,32,14,24,221,5106,
20221022,254,103,군자,수원신갈,2679,81,45,76,50,138,3069,1910,68,46,47,38,110,2219,
20221022,254,212,군자,북수원,1548,19,23,7,7,93,1697,2021,28,35,14,12,119,2229,
20221022,254,213,군자,부곡,1016,20,14,11,196,61,1318,1007,22,15,9,192,49,1294,
20221022,254,215,군자,군포,3540,71,50,49,77,209,3996,2598,31,24,31,37,149,2870,
20221022,254,255,군자,서안산,8956,177,120,107,190,577,10127,8885,180,109,91,148,564,9977,
20221022,254,256,군자,안산,4867,66,112,24,48,355,5472,5458,69,110,34,35,408,6114,
20221022,254,281,군자,매송,897,11,10,9,43,54,1024,1166,17,10,6,39,66,1304,
20221022,254,282,군자,비봉,1368,45,45,27,115,80,1680,1040,43,32,30,111,60,1316,
20221022,254,283,군자,발안,1015,21,25,21,21,73,1176,1017,21,22,12,24,77,1173,
20221022,255,102,서안산,동수원,1601,27,11,10,2,92,1743,1305,28,6,2,3,78,1422,
20221022,255,253,서안산,서서울,11599,204,106,101,197,644,12851,10870,225,143,155,222,594,12209,
20221022,255,254,서안산,군자,8885,180,109,91,148,564,9977,8956,177,120,107,190,577,10127,
20221022,256,253,안산,서서울,5977,91,57,22,33,394,6574,8832,119,75,32,18,593,9669,
20221022,256,254,안산,군자,5458,69,110,34,35,408,6114,4867,66,112,24,48,355,5472,
20221022,257,253,홍성,서서울,1057,1,12,4,1,43,1118,1747,4,11,4,4,62,1832,
20221022,259,253,대천,서서울,992,5,11,5,1,43,1057,1670,9,14,4,0,56,1753,
20221022,261,262,동광주,창평,1744,59,25,12,9,57,1906,1660,43,22,13,20,51,1809,
20221022,261,263,동광주,옥과,2747,16,86,8,42,114,3013,2241,15,81,9,56,76,2478,
20221022,261,265,동광주,곡성,2007,14,31,13,26,66,2157,1493,7,27,6,19,44,1596,
20221022,262,261,창평,동광주,1660,43,22,13,20,51,1809,1744,59,25,12,9,57,1906,
20221022,263,261,옥과,동광주,2241,15,81,9,56,76,2478,2747,16,86,8,42,114,3013,
20221022,265,261,곡성,동광주,1493,7,27,6,19,44,1596,2007,14,31,13,26,66,2157,
20221022,267,271,주암송광사,순천,1009,5,13,2,23,40,1092,1031,5,12,2,20,32,1102,
20221022,271,267,순천,주암송광사,1031,5,12,2,20,32,1102,1009,5,13,2,23,40,1092,
20221022,271,569,순천,북광주,1219,39,18,8,46,27,1357,2081,43,12,10,30,49,2225,
20221022,272,145,광양,산인,1038,2,50,16,4,25,1135,1511,9,67,11,14,39,1651,
20221022,280,519,거창,남대구,1472,18,36,4,2,74,1606,1706,22,39,5,5,94,1871,
20221022,281,253,매송,서서울,4330,23,22,5,68,247,4695,3495,27,18,5,16,181,3742,
20221022,281,254,매송,군자,1166,17,10,6,39,66,1304,897,11,10,9,43,54,1024,
20221022,282,253,비봉,서서울,5444,129,101,81,434,284,6473,5354,102,127,64,467,278,6392,
20221022,282,254,비봉,군자,1040,43,32,30,111,60,1316,1368,45,45,27,115,80,1680,
20221022,283,253,발안,서서울,3421,82,55,47,66,198,3869,2841,49,40,29,53,182,3194,
20221022,283,254,발안,군자,1017,21,22,12,24,77,1173,1015,21,25,21,21,73,1176,
20221022,285,253,서평택,서서울,1594,32,38,71,185,110,2030,1623,9,41,51,116,81,1921,
20221022,286,140,통도사휴게소,부산,1113,3,3,0,0,30,1149,1093,5,5,0,0,36,1139,
20221022,287,253,송악,서서울,3383,17,32,44,220,192,3888,2613,16,22,19,117,127,2914,
20221022,288,253,당진,서서울,1922,9,33,15,46,91,2116,1730,5,34,13,10,66,1858,
20221022,289,140,마산,부산,1238,8,8,4,0,57,1315,1728,5,14,6,1,59,1813,
20221022,289,146,마산,동창원,2465,39,35,12,61,184,2796,2722,40,43,13,71,215,3104,
20221022,289,147,마산,진례,842,27,29,21,47,47,1013,879,38,31,22,44,58,1072,
20221022,289,148,마산,서김해,1737,12,56,10,10,107,1932,2179,19,58,8,20,109,2393,
20221022,289,149,마산,동김해,1031,15,29,8,8,66,1157,1164,14,41,12,9,74,1314,
20221022,289,150,마산,북부산,4637,38,135,8,8,175,5001,5562,23,146,5,15,222,5973,
20221022,289,244,마산,서부산,4760,23,279,27,24,203,5316,6320,29,322,25,48,279,7023,
20221022,289,245,마산,장유,1780,13,39,7,5,108,1952,2017,14,41,9,4,98,2183,
20221022,291,145,사천,산인,3090,38,51,11,18,135,3343,4336,34,53,7,26,157,4613,
20221022,291,225,사천,서진주,998,17,20,4,14,59,1112,1104,18,23,8,16,62,1231,
20221022,291,292,사천,진주,2167,38,53,19,35,165,2477,2965,55,50,31,26,197,3324,
20221022,292,145,진주,산인,3157,20,145,4,17,158,3501,3303,20,154,5,11,174,3667,
20221022,292,291,진주,사천,2965,55,50,31,26,197,3324,2167,38,53,19,35,165,2477,
20221022,292,516,진주,통영,1235,11,20,3,4,81,1354,1266,30,20,4,7,83,1410,
20221022,293,145,문산,산인,2111,22,20,5,10,111,2279,2432,30,23,7,8,132,2632,
20221022,295,145,진성,산인,1237,12,16,7,6,54,1332,1401,21,13,9,5,68,1517,
20221022,298,253,서산,서서울,3595,16,41,19,25,115,3811,4099,16,51,33,8,131,4338,
20221022,508,509,무안,목포,1361,18,28,16,33,48,1504,1774,31,36,23,31,65,1960,
20221022,508,553,무안,동광산,1569,17,22,10,9,42,1669,2007,21,30,8,18,59,2143,
20221022,509,508,목포,무안,1774,31,36,23,31,65,1960,1361,18,28,16,33,48,1504,
20221022,509,553,목포,동광산,10396,131,182,66,246,356,11377,9967,122,196,104,263,310,10962,
20221022,513,515,고성,북통영,2595,24,77,19,13,126,2854,2778,24,78,20,11,144,3055,
20221022,513,516,고성,통영,5620,48,89,46,91,328,6222,4925,40,86,34,92,294,5471,
20221022,514,516,동고성,통영,1335,12,29,10,27,129,1542,1292,5,28,12,24,146,1507,
20221022,515,513,북통영,고성,2778,24,78,20,11,144,3055,2595,24,77,19,13,126,2854,
20221022,516,225,통영,서진주,921,7,6,2,2,70,1008,930,3,11,2,3,67,1016,
20221022,516,292,통영,진주,1266,30,20,4,7,83,1410,1235,11,20,3,4,81,1354,
20221022,516,513,통영,고성,4925,40,86,34,92,294,5471,5620,48,89,46,91,328,6222,
20221022,516,514,통영,동고성,1292,5,28,12,24,146,1507,1335,12,29,10,27,129,1542,
20221022,517,598,양평,북여주,2164,24,24,13,30,66,2321,1430,11,12,15,19,53,1540,
20221022,519,231,남대구,화원옥포,5208,100,84,25,105,399,5921,5454,107,74,37,164,417,6253,
20221022,519,232,남대구,달성,2025,55,64,23,12,127,2306,2125,61,70,22,23,154,2455,
20221022,519,233,남대구,현풍,3562,64,80,45,29,203,3983,3928,70,117,33,44,242,4434,
20221022,519,239,남대구,칠원,2503,27,80,34,37,121,2802,2239,22,101,23,58,110,2553,
20221022,519,241,남대구,동고령,3034,51,59,26,109,150,3429,3132,52,74,39,108,160,3565,
20221022,519,242,남대구,고령,3672,17,48,10,137,153,4037,2829,26,37,13,127,124,3156,
20221022,519,280,남대구,거창,1706,22,39,5,5,94,1871,1472,18,36,4,2,74,1606,
20221022,519,730,남대구,유천,2145,24,14,0,12,129,2324,2502,29,10,1,0,151,2693,
20221022,519,731,남대구,북현풍,1678,17,23,0,0,102,1820,1519,14,1,0,0,76,1610,
20221022,520,253,평택,서서울,3305,48,49,68,59,139,3668,3516,49,46,61,76,136,3884,
20221022,520,540,평택,청북,1300,29,50,25,39,54,1497,958,15,58,57,62,40,1190,
20221022,524,230,청통와촌,팔공산,928,26,15,6,30,43,1048,1074,28,22,5,19,52,1200,
20221022,524,527,청통와촌,포항,994,33,15,2,33,40,1117,1050,25,15,6,38,44,1178,
20221022,526,527,서포항,포항,1163,7,20,2,10,78,1280,1562,9,16,2,16,90,1695,
20221022,527,127,포항,서대구,1316,25,26,5,35,65,1472,2273,25,30,15,43,98,2484,
20221022,527,129,포항,북대구,3136,35,27,15,65,126,3404,2552,16,13,19,33,90,2723,
20221022,527,230,포항,팔공산,2164,20,14,3,11,85,2297,2568,19,15,5,13,85,2705,
20221022,527,524,포항,청통와촌,1050,25,15,6,38,44,1178,994,33,15,2,33,40,1117,
20221022,527,526,포항,서포항,1562,9,16,2,16,90,1695,1163,7,20,2,10,78,1280,
20221022,528,101,기흥동탄,서울,6424,43,531,97,5,256,7356,6933,38,528,96,9,276,7880,
20221022,528,103,기흥동탄,수원신갈,1479,10,9,2,5,72,1577,1162,9,19,3,3,41,1237,
20221022,540,253,청북,서서울,854,23,15,47,44,47,1030,1040,12,15,14,29,43,1153,
20221022,540,520,청북,평택,958,15,58,57,62,40,1190,1300,29,50,25,39,54,1497,
20221022,542,101,서안성,서울,2293,26,53,142,29,120,2663,1274,18,58,72,14,58,1494,
20221022,542,108,서안성,천안,894,21,55,20,10,47,1047,995,16,47,18,13,43,1132,
20221022,543,101,남안성,서울,1130,65,60,55,44,60,1414,1048,42,29,37,39,43,1238,
20221022,548,553,북무안,동광산,2038,30,21,14,36,67,2206,2744,25,27,21,32,76,2925,
20221022,549,553,동함평,동광산,5051,26,54,14,42,172,5359,5472,34,66,24,35,194,5825,
20221022,551,553,나주,동광산,1172,7,18,7,53,48,1305,1207,6,15,6,41,52,1327,
20221022,552,553,서광산,동광산,3711,110,118,120,83,102,4244,5390,125,132,123,95,161,6026,
20221022,553,508,동광산,무안,2007,21,30,8,18,59,2143,1569,17,22,10,9,42,1669,
20221022,553,509,동광산,목포,9967,122,196,104,263,310,10962,10396,131,182,66,246,356,11377,
20221022,553,548,동광산,북무안,2744,25,27,21,32,76,2925,2038,30,21,14,36,67,2206,
20221022,553,549,동광산,동함평,5472,34,66,24,35,194,5825,5051,26,54,14,42,172,5359,
20221022,553,551,동광산,나주,1207,6,15,6,41,52,1327,1172,7,18,7,53,48,1305,
20221022,553,552,동광산,서광산,5390,125,132,123,95,161,6026,3711,110,118,120,83,102,4244,
20221022,554,174,동홍천,춘천,1299,16,24,2,7,76,1424,1295,15,30,5,15,78,1438,
20221022,556,557,동순천,황전,1342,10,9,6,64,40,1471,1101,8,13,4,66,35,1227,
20221022,556,589,동순천,상관,980,10,21,6,70,21,1108,1527,9,20,11,54,31,1652,
20221022,557,556,황전,동순천,1101,8,13,4,66,35,1227,1342,10,9,6,64,40,1471,
20221022,560,190,감곡,동서울,1157,9,8,8,44,30,1256,1173,4,10,8,34,34,1263,
20221022,567,167,남고창,광주,1695,21,38,4,9,55,1822,1757,22,42,4,18,60,1903,
20221022,569,271,북광주,순천,2081,43,12,10,30,49,2225,1219,39,18,8,46,27,1357,
20221022,573,578,예산수덕사,서세종,1128,20,11,14,8,36,1217,1268,13,12,11,12,56,1372,
20221022,578,573,서세종,예산수덕사,1268,13,12,11,12,56,1372,1128,20,11,14,8,36,1217,
20221022,579,153,남세종,서대전,1080,16,7,0,14,52,1169,973,14,7,3,4,63,1064,
20221022,583,584,동해,남강릉,1047,18,15,2,36,83,1201,895,14,19,4,22,53,1007,
20221022,583,704,동해,근덕,1060,3,28,5,115,66,1277,1063,7,34,5,86,53,1248,
20221022,584,583,남강릉,동해,895,14,19,4,22,53,1007,1047,18,15,2,36,83,1201,
20221022,587,589,오수,상관,1244,13,42,17,62,31,1409,1468,14,34,12,91,37,1656,
20221022,589,556,상관,동순천,1527,9,20,11,54,31,1652,980,10,21,6,70,21,1108,
20221022,589,587,상관,오수,1468,14,34,12,91,37,1656,1244,13,42,17,62,31,1409,
20221022,597,598,서여주,북여주,772,27,106,22,39,50,1016,910,17,28,13,30,46,1044,
20221022,598,517,북여주,양평,1430,11,12,15,19,53,1540,2164,24,24,13,30,66,2321,
20221022,598,597,북여주,서여주,910,17,28,13,30,46,1044,772,27,106,22,39,50,1016,
20221022,621,127,동대구,서대구,1047,20,19,16,21,62,1185,1794,36,62,13,24,104,2033,
20221022,621,131,동대구,경산,1814,45,38,7,32,99,2035,1818,43,37,15,78,78,2069,
20221022,621,132,동대구,영천,1244,8,17,1,24,60,1354,1177,9,20,2,20,64,1292,
20221022,621,135,동대구,경주,1369,2,49,3,2,46,1471,1201,7,47,1,1,51,1308,
20221022,624,626,청도,남밀양,1102,15,22,12,24,62,1237,1041,19,18,26,28,55,1187,
20221022,625,626,밀양,남밀양,1922,43,43,22,29,86,2145,2281,29,51,14,26,88,2489,
20221022,626,624,남밀양,청도,1041,19,18,26,28,55,1187,1102,15,22,12,24,62,1237,
20221022,626,625,남밀양,밀양,2281,29,51,14,26,88,2489,1922,43,43,22,29,86,2145,
20221022,626,627,남밀양,삼랑진,1006,16,19,6,21,98,1166,1114,23,14,12,16,102,1281,
20221022,627,626,삼랑진,남밀양,1114,23,14,12,16,102,1281,1006,16,19,6,21,98,1166,
20221022,641,139,울산,서울산,1441,11,46,5,18,82,1603,1554,23,59,10,18,102,1766,
20221022,641,252,울산,대동,2046,33,51,21,41,111,2303,2031,22,55,12,32,115,2267,
20221022,641,648,울산,해운대,1320,4,2,0,3,104,1433,1581,11,2,1,1,90,1686,
20221022,641,706,울산,남경주,1521,12,7,3,15,66,1624,1577,7,9,3,21,86,1703,
20221022,641,707,울산,남포항,1957,15,23,8,137,119,2259,1929,11,30,11,108,101,2190,
20221022,643,645,청량,장안,999,5,17,13,138,51,1223,784,5,9,12,163,48,1021,
20221022,643,648,청량,해운대,4187,10,21,10,27,223,4478,4268,21,71,25,224,237,4846,
20221022,645,643,장안,청량,784,5,9,12,163,48,1021,999,5,17,13,138,51,1223,
20221022,645,648,장안,해운대,1505,4,7,2,2,73,1593,2949,13,17,13,24,162,3178,
20221022,646,648,기장일광,해운대,4831,9,18,4,17,249,5128,5920,23,24,9,67,300,6343,
20221022,648,641,해운대,울산,1581,11,2,1,1,90,1686,1320,4,2,0,3,104,1433,
20221022,648,643,해운대,청량,4268,21,71,25,224,237,4846,4187,10,21,10,27,223,4478,
20221022,648,645,해운대,장안,2949,13,17,13,24,162,3178,1505,4,7,2,2,73,1593,
20221022,648,646,해운대,기장일광,5920,23,24,9,67,300,6343,4831,9,18,4,17,249,5128,
20221022,648,707,해운대,남포항,1508,7,29,8,44,66,1662,1397,7,9,2,13,47,1475,
20221022,651,652,남양주,화도,8998,175,250,232,77,592,10324,10482,189,357,245,48,582,11903,
20221022,651,653,남양주,서종,1811,6,10,1,23,61,1912,2912,12,18,2,25,103,3072,
20221022,651,654,남양주,설악,5018,30,75,14,4,184,5325,4156,23,72,6,3,164,4424,
20221022,651,655,남양주,강촌,3091,19,114,23,28,105,3380,3084,14,101,10,21,100,3330,
20221022,651,656,남양주,남춘천,3649,26,42,26,13,121,3877,2455,11,32,7,8,64,2577,
20221022,652,651,화도,남양주,10482,189,357,245,48,582,11903,8998,175,250,232,77,592,10324,
20221022,652,653,화도,서종,1340,18,4,7,3,83,1455,1768,22,16,9,4,119,1938,
20221022,652,654,화도,설악,2306,8,14,2,2,91,2423,1128,16,9,6,4,65,1228,
20221022,653,651,서종,남양주,2912,12,18,2,25,103,3072,1811,6,10,1,23,61,1912,
20221022,653,652,서종,화도,1768,22,16,9,4,119,1938,1340,18,4,7,3,83,1455,
20221022,654,651,설악,남양주,4156,23,72,6,3,164,4424,5018,30,75,14,4,184,5325,
20221022,654,652,설악,화도,1128,16,9,6,4,65,1228,2306,8,14,2,2,91,2423,
20221022,655,651,강촌,남양주,3084,14,101,10,21,100,3330,3091,19,114,23,28,105,3380,
20221022,656,651,남춘천,남양주,2455,11,32,7,8,64,2577,3649,26,42,26,13,121,3877,
20221022,671,672,봉담,정남,2025,53,39,23,106,115,2361,2477,56,40,16,225,154,2968,
20221022,671,673,봉담,북오산,1636,27,21,19,9,99,1811,2064,31,33,18,13,117,2276,
20221022,671,677,봉담,북평택,10585,76,102,44,105,424,11336,11037,105,95,55,101,527,11920,
20221022,672,671,정남,봉담,2477,56,40,16,225,154,2968,2025,53,39,23,106,115,2361,
20221022,673,101,북오산,서울,1624,22,94,15,6,105,1866,1597,26,91,18,5,96,1833,
20221022,673,671,북오산,봉담,2064,31,33,18,13,117,2276,1636,27,21,19,9,99,1811,
20221022,673,677,북오산,북평택,2440,30,33,15,90,124,2732,1920,29,30,14,86,95,2174,
20221022,675,676,서오산,향남,2215,68,35,23,103,133,2577,1851,43,29,20,95,103,2141,
20221022,675,677,서오산,북평택,15806,133,183,94,120,746,17082,13908,117,210,84,114,722,15155,
20221022,676,675,향남,서오산,1851,43,29,20,95,103,2141,2215,68,35,23,103,133,2577,
20221022,676,677,향남,북평택,1733,63,45,52,63,84,2040,1533,54,48,49,51,77,1812,
20221022,677,101,북평택,서울,2601,25,223,40,88,123,3100,2990,33,218,33,64,122,3460,
20221022,677,671,북평택,봉담,11037,105,95,55,101,527,11920,10585,76,102,44,105,424,11336,
20221022,677,673,북평택,북오산,1920,29,30,14,86,95,2174,2440,30,33,15,90,124,2732,
20221022,677,675,북평택,서오산,13908,117,210,84,114,722,15155,15806,133,183,94,120,746,17082,
20221022,677,676,북평택,향남,1533,54,48,49,51,77,1812,1733,63,45,52,63,84,2040,
20221022,677,876,북평택,양감,2985,54,59,32,73,160,3363,1782,36,51,33,63,83,2048,
20221022,682,685,조암,서시흥,1376,55,55,54,112,56,1708,1476,51,62,61,119,79,1848,
20221022,683,684,송산마도,남안산,2059,75,64,47,230,113,2588,2055,56,46,43,138,105,2443,
20221022,683,685,송산마도,서시흥,5037,113,100,94,802,282,6428,4320,73,89,82,788,224,5576,
20221022,684,683,남안산,송산마도,2055,56,46,43,138,105,2443,2059,75,64,47,230,113,2588,
20221022,684,685,남안산,서시흥,3276,170,142,222,233,237,4280,3935,126,122,203,169,243,4798,
20221022,685,682,서시흥,조암,1476,51,62,61,119,79,1848,1376,55,55,54,112,56,1708,
20221022,685,683,서시흥,송산마도,4320,73,89,82,788,224,5576,5037,113,100,94,802,282,6428,
20221022,685,684,서시흥,남안산,3935,126,122,203,169,243,4798,3276,170,142,222,233,237,4280,
20221022,704,583,근덕,동해,1063,7,34,5,86,53,1248,1060,3,28,5,115,66,1277,
20221022,705,190,남이천,동서울,1832,39,20,44,40,46,2021,1445,34,25,26,44,42,1616,
20221022,706,641,남경주,울산,1577,7,9,3,21,86,1703,1521,12,7,3,15,66,1624,
20221022,706,707,남경주,남포항,1787,19,45,16,147,86,2100,1655,21,43,17,89,74,1899,
20221022,707,641,남포항,울산,1929,11,30,11,108,101,2190,1957,15,23,8,137,119,2259,
20221022,707,648,남포항,해운대,1397,7,9,2,13,47,1475,1508,7,29,8,44,66,1662,
20221022,707,706,남포항,남경주,1655,21,43,17,89,74,1899,1787,19,45,16,147,86,2100,
20221022,707,708,남포항,동경주,1868,17,20,12,171,98,2186,1889,19,19,14,223,99,2263,
20221022,708,707,동경주,남포항,1889,19,19,14,223,99,2263,1868,17,20,12,171,98,2186,
20221022,715,716,동안동,청송,1104,15,20,9,15,58,1221,1075,21,10,9,18,56,1189,
20221022,715,749,동안동,영덕,1182,10,26,6,24,42,1290,1003,8,27,4,13,33,1088,
20221022,716,715,청송,동안동,1075,21,10,9,18,56,1189,1104,15,20,9,15,58,1221,
20221022,730,519,유천,남대구,2502,29,10,1,0,151,2693,2145,24,14,0,12,129,2324,
20221022,731,519,북현풍,남대구,1519,14,1,0,0,76,1610,1678,17,23,0,0,102,1820,
20221022,741,253,평택고덕,서서울,1730,15,13,13,8,123,1902,1342,13,14,9,2,71,1451,
20221022,742,107,남사진위,안성,1659,22,41,20,5,93,1840,1109,27,42,12,9,74,1273,
20221022,742,108,남사진위,천안,1515,22,18,24,8,61,1648,1127,13,18,13,5,51,1227,
20221022,749,715,영덕,동안동,1003,8,27,4,13,33,1088,1182,10,26,6,24,42,1290,
20221022,752,252,기장철마,대동,1848,23,22,13,32,142,2080,1717,21,17,15,67,118,1955,
20221022,753,252,금정,대동,997,22,31,20,68,64,1202,1756,40,41,23,130,121,2111,
20221022,755,140,광재,부산,926,12,12,1,14,51,1016,1008,12,12,3,17,63,1115,
20221022,755,252,광재,대동,1660,36,37,30,249,108,2120,1742,39,43,29,142,115,2110,
20221022,772,774,북달성,남칠곡,2408,35,27,18,16,107,2611,2545,37,31,20,26,116,2775,
20221022,773,774,북다사,남칠곡,1295,12,12,3,7,53,1382,1136,15,15,5,7,53,1231,
20221022,774,772,남칠곡,북달성,2545,37,31,20,26,116,2775,2408,35,27,18,16,107,2611,
20221022,774,773,남칠곡,북다사,1136,15,15,5,7,53,1231,1295,12,12,3,7,53,1382,
20221022,775,203,동명동호,가산,1728,39,19,20,85,77,1968,1987,33,38,23,200,80,2361,
20221022,775,207,동명동호,남안동,1107,12,3,1,4,33,1160,1030,6,8,4,3,34,1085,
20221022,776,777,연경,파군재,4442,32,22,7,16,256,4775,3709,19,15,3,12,218,3976,
20221022,776,779,연경,율암,5849,61,66,44,203,329,6552,6366,77,72,38,191,323,7067,
20221022,777,776,파군재,연경,3709,19,15,3,12,218,3976,4442,32,22,7,16,256,4775,
20221022,777,779,파군재,율암,2987,12,13,4,5,200,3221,3104,12,10,2,6,213,3347,
20221022,779,776,율암,연경,6366,77,72,38,191,323,7067,5849,61,66,44,203,329,6552,
20221022,779,777,율암,파군재,3104,12,10,2,6,213,3347,2987,12,13,4,5,200,3221,
20221022,876,677,양감,북평택,1782,36,51,33,63,83,2048,2985,54,59,32,73,160,3363,
20221022,981,982,서영암,강진무위사,2613,23,91,20,44,72,2863,2446,22,94,27,32,79,2700,
20221022,981,987,서영암,남순천,2793,19,94,31,125,81,3143,2575,21,98,39,159,68,2960,
20221022,982,981,강진무위사,서영암,2446,22,94,27,32,79,2700,2613,23,91,20,44,72,2863,
20221022,982,987,강진무위사,남순천,1126,8,48,33,43,39,1297,1213,9,46,15,59,38,1380,
20221022,983,987,장흥,남순천,934,5,26,3,17,26,1011,1126,11,48,4,15,31,1235,
20221022,984,985,보성,벌교,2721,39,40,29,27,60,2916,2225,38,34,18,22,55,2392,
20221022,984,987,보성,남순천,2896,16,66,25,155,75,3233,2852,20,75,36,160,83,3226,
20221022,985,984,벌교,보성,2225,38,34,18,22,55,2392,2721,39,40,29,27,60,2916,
20221022,986,987,고흥,남순천,4329,44,96,67,103,155,4794,5343,43,115,97,133,173,5904,
20221022,987,981,남순천,서영암,2575,21,98,39,159,68,2960,2793,19,94,31,125,81,3143,
20221022,987,982,남순천,강진무위사,1213,9,46,15,59,38,1380,1126,8,48,33,43,39,1297,
20221022,987,983,남순천,장흥,1126,11,48,4,15,31,1235,934,5,26,3,17,26,1011,
20221022,987,984,남순천,보성,2852,20,75,36,160,83,3226,2896,16,66,25,155,75,3233,
20221022,987,986,남순천,고흥,5343,43,115,97,133,173,5904,4329,44,96,67,103,155,4794,
20221023,101,102,서울,동수원,3220,13,170,5,2,180,3590,4062,20,283,15,8,197,4585,
20221023,101,103,서울,수원신갈,13417,192,893,231,19,562,15314,11919,201,867,203,25,534,13749,
20221023,101,105,서울,기흥,5500,25,138,39,3,208,5913,5244,22,157,62,4,189,5678,
20221023,101,106,서울,오산,5069,127,225,63,7,316,5807,4531,111,238,54,11,242,5187,
20221023,101,107,서울,안성,4735,37,255,9,3,237,5276,3417,21,262,8,7,153,3868,
20221023,101,108,서울,천안,5476,16,306,7,4,250,6059,5165,20,337,10,4,213,5749,
20221023,101,111,서울,청주,1150,8,249,5,0,48,1460,785,8,331,2,2,23,1151,
20221023,101,171,서울,마성,3075,13,108,39,1,113,3349,2866,14,121,40,1,110,3152,
20221023,101,172,서울,용인,3161,41,51,11,0,168,3432,3754,31,49,15,6,196,4051,
20221023,101,173,서울,양지,3210,69,70,34,20,97,3500,4360,110,91,29,33,149,4772,
20221023,101,528,서울,기흥동탄,6270,18,401,92,1,251,7033,6002,15,413,96,3,274,6803,
20221023,101,542,서울,서안성,1658,15,36,40,4,82,1835,1894,21,35,63,3,93,2109,
20221023,101,543,서울,남안성,1384,23,41,37,14,38,1537,1287,32,36,47,14,43,1459,
20221023,101,673,서울,북오산,1520,6,96,6,4,109,1741,1296,10,91,7,2,88,1494,
20221023,101,677,서울,북평택,2206,15,276,20,14,101,2632,2845,13,154,19,24,114,3169,
20221023,102,101,동수원,서울,4062,20,283,15,8,197,4585,3220,13,170,5,2,180,3590,
20221023,102,173,동수원,양지,1001,15,13,2,13,42,1086,1344,10,12,2,1,59,1428,
20221023,102,212,동수원,북수원,2413,7,128,1,1,118,2668,2513,7,136,0,2,101,2759,
20221023,102,215,동수원,군포,1051,5,2,0,1,61,1120,1490,4,5,0,1,90,1590,
20221023,102,253,동수원,서서울,5277,18,31,4,7,259,5596,5608,22,34,8,3,294,5969,
20221023,102,254,동수원,군자,4136,17,30,4,7,211,4405,5160,15,37,6,5,266,5489,
20221023,102,255,동수원,서안산,1022,21,5,0,0,63,1111,1198,13,4,2,1,74,1292,
20221023,103,101,수원신갈,서울,11919,201,867,203,25,534,13749,13417,192,893,231,19,562,15314,
20221023,103,105,수원신갈,기흥,1425,6,13,4,9,84,1541,2297,9,4,2,10,119,2441,
20221023,103,108,수원신갈,천안,1045,3,28,13,1,38,1128,1071,7,29,12,1,50,1170,
20221023,103,253,수원신갈,서서울,1833,48,15,30,5,97,2028,2689,45,28,22,7,141,2932,
20221023,103,254,수원신갈,군자,1721,30,18,19,10,95,1893,2480,43,21,37,16,119,2716,
20221023,105,101,기흥,서울,5244,22,157,62,4,189,5678,5500,25,138,39,3,208,5913,
20221023,105,103,기흥,수원신갈,2297,9,4,2,10,119,2441,1425,6,13,4,9,84,1541,
20221023,106,101,오산,서울,4531,111,238,54,11,242,5187,5069,127,225,63,7,316,5807,
20221023,107,101,안성,서울,3417,21,262,8,7,153,3868,4735,37,255,9,3,237,5276,
20221023,107,108,안성,천안,1600,7,24,0,4,94,1729,1596,14,22,0,2,90,1724,
20221023,107,742,안성,남사진위,936,16,23,10,4,51,1040,1143,14,27,11,2,63,1260,
20221023,108,101,천안,서울,5165,20,337,10,4,213,5749,5476,16,306,7,4,250,6059,
20221023,108,103,천안,수원신갈,1071,7,29,12,1,50,1170,1045,3,28,13,1,38,1128,
20221023,108,107,천안,안성,1596,14,22,0,2,90,1724,1600,7,24,0,4,94,1729,
20221023,108,229,천안,북천안,1082,20,40,4,4,68,1218,1498,22,44,4,10,75,1653,
20221023,111,101,청주,서울,785,8,331,2,2,23,1151,1150,8,249,5,0,48,1460,
20221023,112,115,남청주,대전,957,19,49,2,1,66,1094,1006,24,41,2,0,53,1126,
20221023,114,153,남대전,서대전,1431,6,6,4,1,76,1524,1081,4,7,9,0,73,1174,
20221023,115,112,대전,남청주,1006,24,41,2,0,53,1126,957,19,49,2,1,66,1094,
20221023,115,116,대전,옥천,1899,11,13,4,5,136,2068,1933,5,21,2,0,136,2097,
20221023,116,115,옥천,대전,1933,5,21,2,0,136,2097,1899,11,13,4,5,136,2068,
20221023,119,153,판암,서대전,1671,5,7,0,2,111,1796,1694,2,11,5,2,112,1826,
20221023,123,127,구미,서대구,1475,12,24,1,2,95,1609,1628,9,28,1,3,94,1763,
20221023,123,129,구미,북대구,1730,4,55,0,2,65,1856,1954,8,58,3,0,83,2106,
20221023,125,127,남구미,서대구,1307,6,41,5,5,83,1447,1665,8,37,4,2,83,1799,
20221023,125,129,남구미,북대구,1281,0,17,2,0,81,1381,1606,3,21,1,1,97,1729,
20221023,126,127,왜관,서대구,1828,28,20,6,1,113,1996,1892,31,16,4,1,104,2048,
20221023,126,129,왜관,북대구,2437,21,11,2,3,114,2588,2506,22,12,2,2,113,2657,
20221023,127,123,서대구,구미,1628,9,28,1,3,94,1763,1475,12,24,1,2,95,1609,
20221023,127,125,서대구,남구미,1665,8,37,4,2,83,1799,1307,6,41,5,5,83,1447,
20221023,127,126,서대구,왜관,1892,31,16,4,1,104,2048,1828,28,20,6,1,113,1996,
20221023,127,131,서대구,경산,1639,28,15,6,8,88,1784,1125,27,9,5,3,57,1226,
20221023,127,203,서대구,가산,2259,18,27,8,5,91,2408,2138,12,16,2,1,90,2259,
20221023,127,527,서대구,포항,1819,13,31,5,9,62,1939,1513,7,27,2,8,55,1612,
20221023,129,123,북대구,구미,1954,8,58,3,0,83,2106,1730,4,55,0,2,65,1856,
20221023,129,125,북대구,남구미,1606,3,21,1,1,97,1729,1281,0,17,2,0,81,1381,
20221023,129,126,북대구,왜관,2506,22,12,2,2,113,2657,2437,21,11,2,3,114,2588,
20221023,129,131,북대구,경산,1315,31,8,5,6,72,1437,1825,28,19,8,10,94,1984,
20221023,129,527,북대구,포항,2321,23,9,4,6,88,2451,3474,27,13,9,13,127,3663,
20221023,131,127,경산,서대구,1125,27,9,5,3,57,1226,1639,28,15,6,8,88,1784,
20221023,131,129,경산,북대구,1825,28,19,8,10,94,1984,1315,31,8,5,6,72,1437,
20221023,131,621,경산,동대구,1476,20,13,2,4,87,1602,1428,13,11,4,4,68,1528,
20221023,135,140,경주,부산,2753,8,16,5,4,115,2901,2616,8,7,1,2,101,2735,
20221023,135,252,경주,대동,2165,7,58,11,37,98,2376,2224,16,54,10,13,103,2420,
20221023,135,621,경주,동대구,1274,9,46,0,0,44,1373,1168,3,45,0,0,49,1265,
20221023,138,140,양산,부산,3361,33,50,4,8,141,3597,3012,48,44,6,5,130,3245,
20221023,138,252,양산,대동,1275,20,10,7,11,62,1385,1438,44,21,5,24,56,1588,
20221023,139,140,서울산,부산,3017,13,19,1,0,97,3147,2132,8,8,0,2,80,2230,
20221023,139,252,서울산,대동,1564,10,27,5,1,92,1699,1326,9,15,1,2,65,1418,
20221023,139,641,서울산,울산,1490,9,55,1,5,90,1650,1056,6,46,2,2,69,1181,
20221023,140,135,부산,경주,2616,8,7,1,2,101,2735,2753,8,16,5,4,115,2901,
20221023,140,138,부산,양산,3012,48,44,6,5,130,3245,3361,33,50,4,8,141,3597,
20221023,140,139,부산,서울산,2132,8,8,0,2,80,2230,3017,13,19,1,0,97,3147,
20221023,140,250,부산,남양산,6626,26,135,6,4,430,7227,6257,35,120,9,4,420,6845,
20221023,140,286,부산,통도사휴게소,1187,4,5,0,0,32,1228,1191,2,3,0,0,35,1231,
20221023,140,289,부산,마산,1127,4,7,0,0,40,1178,1398,3,8,2,1,58,1470,
20221023,142,145,군북,산인,5280,14,63,2,4,241,5604,4312,14,48,4,9,183,4570,
20221023,144,145,함안,산인,2138,6,9,3,6,129,2291,2261,6,11,0,5,135,2418,
20221023,145,142,산인,군북,4312,14,48,4,9,183,4570,5280,14,63,2,4,241,5604,
20221023,145,144,산인,함안,2261,6,11,0,5,135,2418,2138,6,9,3,6,129,2291,
20221023,145,272,산인,광양,977,6,64,0,4,21,1072,1334,8,79,6,5,48,1480,
20221023,145,291,산인,사천,3541,15,40,6,4,125,3731,3780,16,47,1,6,140,3990,
20221023,145,292,산인,진주,1933,6,149,2,3,88,2181,2782,11,147,3,2,153,3098,
20221023,145,293,산인,문산,1688,12,12,1,1,74,1788,1889,5,16,7,5,93,2015,
20221023,146,150,동창원,북부산,1107,4,10,0,2,62,1185,1069,2,5,1,0,50,1127,
20221023,146,244,동창원,서부산,1419,8,17,5,8,70,1527,1448,9,15,2,9,83,1566,
20221023,146,289,동창원,마산,1954,12,13,3,2,146,2130,2200,16,19,6,4,161,2406,
20221023,147,244,진례,서부산,901,23,11,17,6,55,1013,975,23,9,14,7,52,1080,
20221023,148,150,서김해,북부산,5462,45,46,2,21,345,5921,5102,34,57,4,5,347,5549,
20221023,148,289,서김해,마산,1395,5,48,6,0,75,1529,1779,11,59,4,1,92,1946,
20221023,149,150,동김해,북부산,8395,79,96,8,13,574,9165,7265,63,78,6,0,472,7884,
20221023,150,146,북부산,동창원,1069,2,5,1,0,50,1127,1107,4,10,0,2,62,1185,
20221023,150,148,북부산,서김해,5102,34,57,4,5,347,5549,5462,45,46,2,21,345,5921,
20221023,150,149,북부산,동김해,7265,63,78,6,0,472,7884,8395,79,96,8,13,574,9165,
20221023,150,245,북부산,장유,3767,11,69,4,4,211,4066,2955,10,70,2,2,155,3194,
20221023,150,289,북부산,마산,3545,11,125,2,11,136,3830,5947,22,187,1,8,203,6368,
20221023,153,114,서대전,남대전,1081,4,7,9,0,73,1174,1431,6,6,4,1,76,1524,
20221023,153,119,서대전,판암,1694,2,11,5,2,112,1826,1671,5,7,0,2,111,1796,
20221023,153,154,서대전,안영,1010,11,13,3,8,58,1103,989,8,22,5,1,50,1075,
20221023,154,153,안영,서대전,989,8,22,5,1,50,1075,1010,11,13,3,8,58,1103,
20221023,159,167,서전주,광주,1819,17,38,12,5,62,1953,2109,14,25,4,5,68,2225,
20221023,166,167,장성,광주,2509,22,43,10,3,80,2667,3125,34,43,11,4,100,3317,
20221023,167,159,광주,서전주,2109,14,25,4,5,68,2225,1819,17,38,12,5,62,1953,
20221023,167,166,광주,장성,3125,34,43,11,4,100,3317,2509,22,43,10,3,80,2667,
20221023,167,567,광주,남고창,1516,15,43,9,6,42,1631,1717,11,36,6,1,52,1823,
20221023,171,101,마성,서울,2866,14,121,40,1,110,3152,3075,13,108,39,1,113,3349,
20221023,172,101,용인,서울,3754,31,49,15,6,196,4051,3161,41,51,11,0,168,3432,
20221023,172,173,용인,양지,1087,72,25,13,10,77,1284,1076,38,20,6,4,76,1220,
20221023,172,253,용인,서서울,1047,13,3,8,0,58,1129,1108,16,4,8,1,56,1193,
20221023,173,101,양지,서울,4360,110,91,29,33,149,4772,3210,69,70,34,20,97,3500,
20221023,173,102,양지,동수원,1344,10,12,2,1,59,1428,1001,15,13,2,13,42,1086,
20221023,173,172,양지,용인,1076,38,20,6,4,76,1220,1087,72,25,13,10,77,1284,
20221023,173,212,양지,북수원,1256,24,9,13,3,48,1353,908,32,15,18,3,36,1012,
20221023,173,253,양지,서서울,1466,31,12,24,7,56,1596,1065,42,12,16,5,59,1199,
20221023,174,179,춘천,홍천,4118,19,61,6,2,236,4442,2522,18,38,4,5,177,2764,
20221023,174,216,춘천,횡성,936,15,10,3,1,65,1030,1269,20,16,5,1,59,1370,
20221023,174,218,춘천,남원주,1455,10,50,5,2,81,1603,1396,2,57,2,2,81,1540,
20221023,174,554,춘천,동홍천,1011,9,17,3,0,60,1100,1234,8,15,4,0,69,1330,
20221023,176,190,이천,동서울,1440,23,43,12,9,60,1587,1608,20,73,39,15,88,1843,
20221023,177,190,여주,동서울,1312,3,22,2,1,50,1390,1177,4,25,11,0,36,1253,
20221023,179,174,홍천,춘천,2522,18,38,4,5,177,2764,4118,19,61,6,2,236,4442,
20221023,184,189,대관령,강릉,1296,22,46,2,7,55,1428,1439,15,53,6,4,63,1580,
20221023,189,184,강릉,대관령,1439,15,53,6,4,63,1580,1296,22,46,2,7,55,1428,
20221023,190,176,동서울,이천,1608,20,73,39,15,88,1843,1440,23,43,12,9,60,1587,
20221023,190,177,동서울,여주,1177,4,25,11,0,36,1253,1312,3,22,2,1,50,1390,
20221023,190,191,동서울,경기광주,9233,199,246,49,22,478,10227,7395,123,223,31,16,397,8185,
20221023,190,192,동서울,곤지암,4168,136,74,57,15,197,4647,3681,85,53,45,15,162,4041,
20221023,190,193,동서울,일죽,2759,20,60,42,17,121,3019,3421,32,50,60,18,98,3679,
20221023,190,194,동서울,서이천,3611,144,101,81,15,179,4131,2711,46,75,58,13,137,3040,
20221023,190,198,동서울,서청주,1378,5,26,3,5,63,1480,1210,4,17,8,2,48,1289,
20221023,190,199,동서울,오창,1170,4,7,3,6,47,1237,1211,3,6,2,5,47,1274,
20221023,190,560,동서울,감곡,1134,5,10,9,9,32,1199,1310,10,5,16,17,44,1402,
20221023,190,705,동서울,남이천,1386,19,20,15,8,41,1489,1734,25,13,12,4,55,1843,
20221023,191,190,경기광주,동서울,7395,123,223,31,16,397,8185,9233,199,246,49,22,478,10227,
20221023,192,190,곤지암,동서울,3681,85,53,45,15,162,4041,4168,136,74,57,15,197,4647,
20221023,192,194,곤지암,서이천,1202,79,35,28,7,73,1424,1254,30,18,23,7,73,1405,
20221023,193,190,일죽,동서울,3421,32,50,60,18,98,3679,2759,20,60,42,17,121,3019,
20221023,194,190,서이천,동서울,2711,46,75,58,13,137,3040,3611,144,101,81,15,179,4131,
20221023,194,192,서이천,곤지암,1254,30,18,23,7,73,1405,1202,79,35,28,7,73,1424,
20221023,198,190,서청주,동서울,1210,4,17,8,2,48,1289,1378,5,26,3,5,63,1480,
20221023,199,190,오창,동서울,1211,3,6,2,5,47,1274,1170,4,7,3,6,47,1237,
20221023,203,127,가산,서대구,2138,12,16,2,1,90,2259,2259,18,27,8,5,91,2408,
20221023,203,775,가산,동명동호,1797,15,6,6,6,58,1888,1755,9,14,7,9,65,1859,
20221023,212,102,북수원,동수원,2513,7,136,0,2,101,2759,2413,7,128,1,1,118,2668,
20221023,212,173,북수원,양지,908,32,15,18,3,36,1012,1256,24,9,13,3,48,1353,
20221023,212,254,북수원,군자,1764,9,21,0,7,89,1890,1266,13,13,5,2,78,1377,
20221023,213,253,부곡,서서울,1025,50,15,16,7,92,1205,949,49,16,18,10,67,1109,
20221023,215,102,군포,동수원,1490,4,5,0,1,90,1590,1051,5,2,0,1,61,1120,
20221023,215,253,군포,서서울,2876,13,30,2,12,150,3083,2819,30,59,25,11,180,3124,
20221023,215,254,군포,군자,2288,12,24,0,7,126,2457,2670,21,23,24,14,181,2933,
20221023,216,174,횡성,춘천,1269,20,16,5,1,59,1370,936,15,10,3,1,65,1030,
20221023,218,174,남원주,춘천,1396,2,57,2,2,81,1540,1455,10,50,5,2,81,1603,
20221023,218,240,남원주,제천,1986,18,27,6,16,99,2152,1956,9,26,7,7,95,2100,
20221023,229,108,북천안,천안,1498,22,44,4,10,75,1653,1082,20,40,4,4,68,1218,
20221023,230,527,팔공산,포항,2184,11,10,0,3,110,2318,2332,7,12,2,3,96,2452,
20221023,231,519,화원옥포,남대구,4373,27,48,5,6,294,4753,4161,25,38,7,9,302,4542,
20221023,232,519,달성,남대구,1405,23,30,5,2,119,1584,1433,19,13,9,4,108,1586,
20221023,233,519,현풍,남대구,3307,29,35,10,11,178,3570,3057,21,33,24,9,176,3320,
20221023,239,519,칠원,남대구,2226,23,53,8,3,89,2402,2320,16,64,6,3,104,2513,
20221023,240,218,제천,남원주,1956,9,26,7,7,95,2100,1986,18,27,6,16,99,2152,
20221023,241,519,동고령,남대구,3985,21,64,6,10,166,4252,2654,17,41,2,8,127,2849,
20221023,242,519,고령,남대구,3244,19,38,4,16,130,3451,3270,12,37,4,23,163,3509,
20221023,243,519,해인사,남대구,1206,3,3,0,0,43,1255,1077,3,4,0,0,35,1119,
20221023,244,146,서부산,동창원,1448,9,15,2,9,83,1566,1419,8,17,5,8,70,1527,
20221023,244,147,서부산,진례,975,23,9,14,7,52,1080,901,23,11,17,6,55,1013,
20221023,244,245,서부산,장유,13455,60,280,23,26,876,14720,12822,63,265,23,36,842,14051,
20221023,244,289,서부산,마산,4219,22,308,9,9,163,4730,5752,26,313,14,6,249,6360,
20221023,245,150,장유,북부산,2955,10,70,2,2,155,3194,3767,11,69,4,4,211,4066,
20221023,245,244,장유,서부산,12822,63,265,23,36,842,14051,13455,60,280,23,26,876,14720,
20221023,245,289,장유,마산,1517,11,36,5,2,79,1650,2059,8,29,9,2,102,2209,
20221023,249,261,담양,동광주,2863,9,93,2,5,82,3054,2566,10,98,1,2,87,2764,
20221023,250,140,남양산,부산,6257,35,120,9,4,420,6845,6626,26,135,6,4,430,7227,
20221023,250,252,남양산,대동,2156,19,22,8,36,147,2388,3030,28,15,6,25,200,3304,
20221023,251,252,물금,대동,2176,80,14,19,93,152,2534,3309,86,13,17,63,208,3696,
20221023,252,135,대동,경주,2224,16,54,10,13,103,2420,2165,7,58,11,37,98,2376,
20221023,252,138,대동,양산,1438,44,21,5,24,56,1588,1275,20,10,7,11,62,1385,
20221023,252,139,대동,서울산,1326,9,15,1,2,65,1418,1564,10,27,5,1,92,1699,
20221023,252,250,대동,남양산,3030,28,15,6,25,200,3304,2156,19,22,8,36,147,2388,
20221023,252,251,대동,물금,3309,86,13,17,63,208,3696,2176,80,14,19,93,152,2534,
20221023,252,641,대동,울산,2236,14,42,1,4,132,2429,1605,10,44,3,4,97,1763,
20221023,252,752,대동,기장철마,1567,4,8,3,19,124,1725,1547,14,10,3,16,113,1703,
20221023,252,755,대동,광재,1391,10,14,3,52,85,1555,1342,7,14,7,47,71,1488,
20221023,253,102,서서울,동수원,5608,22,34,8,3,294,5969,5277,18,31,4,7,259,5596,
20221023,253,103,서서울,수원신갈,2689,45,28,22,7,141,2932,1833,48,15,30,5,97,2028,
20221023,253,172,서서울,용인,1108,16,4,8,1,56,1193,1047,13,3,8,0,58,1129,
20221023,253,173,서서울,양지,1065,42,12,16,5,59,1199,1466,31,12,24,7,56,1596,
20221023,253,213,서서울,부곡,949,49,16,18,10,67,1109,1025,50,15,16,7,92,1205,
20221023,253,215,서서울,군포,2819,30,59,25,11,180,3124,2876,13,30,2,12,150,3083,
20221023,253,255,서서울,서안산,8981,93,62,59,113,509,9817,8853,108,76,54,103,486,9680,
20221023,253,256,서서울,안산,6987,80,58,17,15,465,7622,4505,42,38,5,18,294,4902,
20221023,253,257,서서울,홍성,1179,7,12,0,0,37,1235,1878,10,11,4,0,61,1964,
20221023,253,259,서서울,대천,997,3,16,1,1,40,1058,1576,6,10,2,0,49,1643,
20221023,253,281,서서울,매송,2861,20,4,5,12,187,3089,2250,19,7,3,21,132,2432,
20221023,253,282,서서울,비봉,4256,55,41,24,19,253,4648,4486,63,48,17,34,253,4901,
20221023,253,283,서서울,발안,3680,27,25,9,272,240,4253,2613,18,18,17,214,149,3029,
20221023,253,285,서서울,서평택,2321,11,20,38,71,136,2597,1801,8,24,44,79,68,2024,
20221023,253,287,서서울,송악,3243,11,38,20,51,148,3511,4467,23,22,25,64,163,4764,
20221023,253,288,서서울,당진,2331,10,42,7,5,109,2504,2310,5,39,18,6,111,2489,
20221023,253,298,서서울,서산,3631,10,42,13,5,166,3867,4049,17,20,38,8,139,4271,
20221023,253,520,서서울,평택,3696,24,36,24,21,154,3955,3369,28,24,32,22,140,3615,
20221023,253,741,서서울,평택고덕,2020,3,8,4,11,134,2180,1004,9,6,2,4,63,1088,
20221023,254,102,군자,동수원,5160,15,37,6,5,266,5489,4136,17,30,4,7,211,4405,
20221023,254,103,군자,수원신갈,2480,43,21,37,16,119,2716,1721,30,18,19,10,95,1893,
20221023,254,212,군자,북수원,1266,13,13,5,2,78,1377,1764,9,21,0,7,89,1890,
20221023,254,215,군자,군포,2670,21,23,24,14,181,2933,2288,12,24,0,7,126,2457,
20221023,254,255,군자,서안산,6601,62,57,21,25,424,7190,7458,68,42,35,30,458,8091,
20221023,254,256,군자,안산,4408,34,96,12,12,303,4865,4509,25,92,15,16,314,4971,
20221023,255,102,서안산,동수원,1198,13,4,2,1,74,1292,1022,21,5,0,0,63,1111,
20221023,255,253,서안산,서서울,8853,108,76,54,103,486,9680,8981,93,62,59,113,509,9817,
20221023,255,254,서안산,군자,7458,68,42,35,30,458,8091,6601,62,57,21,25,424,7190,
20221023,256,253,안산,서서울,4505,42,38,5,18,294,4902,6987,80,58,17,15,465,7622,
20221023,256,254,안산,군자,4509,25,92,15,16,314,4971,4408,34,96,12,12,303,4865,
20221023,257,253,홍성,서서울,1878,10,11,4,0,61,1964,1179,7,12,0,0,37,1235,
20221023,259,253,대천,서서울,1576,6,10,2,0,49,1643,997,3,16,1,1,40,1058,
20221023,261,249,동광주,담양,2566,10,98,1,2,87,2764,2863,9,93,2,5,82,3054,
20221023,261,263,동광주,옥과,2420,6,83,3,3,90,2605,2281,3,72,4,3,72,2435,
20221023,261,265,동광주,곡성,1930,7,26,5,3,59,2030,1923,3,24,3,3,36,1992,
20221023,261,271,동광주,순천,4049,23,62,7,13,100,4254,4299,25,59,0,7,93,4483,
20221023,263,261,옥과,동광주,2281,3,72,4,3,72,2435,2420,6,83,3,3,90,2605,
20221023,265,261,곡성,동광주,1923,3,24,3,3,36,1992,1930,7,26,5,3,59,2030,
20221023,271,261,순천,동광주,4299,25,59,0,7,93,4483,4049,23,62,7,13,100,4254,
20221023,272,145,광양,산인,1334,8,79,6,5,48,1480,977,6,64,0,4,21,1072,
20221023,280,519,거창,남대구,1511,6,33,1,2,67,1620,1372,12,39,2,2,70,1497,
20221023,281,253,매송,서서울,2250,19,7,3,21,132,2432,2861,20,4,5,12,187,3089,
20221023,282,253,비봉,서서울,4486,63,48,17,34,253,4901,4256,55,41,24,19,253,4648,
20221023,283,253,발안,서서울,2613,18,18,17,214,149,3029,3680,27,25,9,272,240,4253,
20221023,285,253,서평택,서서울,1801,8,24,44,79,68,2024,2321,11,20,38,71,136,2597,
20221023,286,140,통도사휴게소,부산,1191,2,3,0,0,35,1231,1187,4,5,0,0,32,1228,
20221023,287,253,송악,서서울,4467,23,22,25,64,163,4764,3243,11,38,20,51,148,3511,
20221023,288,253,당진,서서울,2310,5,39,18,6,111,2489,2331,10,42,7,5,109,2504,
20221023,289,140,마산,부산,1398,3,8,2,1,58,1470,1127,4,7,0,0,40,1178,
20221023,289,146,마산,동창원,2200,16,19,6,4,161,2406,1954,12,13,3,2,146,2130,
20221023,289,148,마산,서김해,1779,11,59,4,1,92,1946,1395,5,48,6,0,75,1529,
20221023,289,150,마산,북부산,5947,22,187,1,8,203,6368,3545,11,125,2,11,136,3830,
20221023,289,244,마산,서부산,5752,26,313,14,6,249,6360,4219,22,308,9,9,163,4730,
20221023,289,245,마산,장유,2059,8,29,9,2,102,2209,1517,11,36,5,2,79,1650,
20221023,291,145,사천,산인,3780,16,47,1,6,140,3990,3541,15,40,6,4,125,3731,
20221023,291,292,사천,진주,1438,10,20,6,1,91,1566,2154,24,22,9,5,127,2341,
20221023,292,145,진주,산인,2782,11,147,3,2,153,3098,1933,6,149,2,3,88,2181,
20221023,292,291,진주,사천,2154,24,22,9,5,127,2341,1438,10,20,6,1,91,1566,
20221023,292,516,진주,통영,1143,4,16,0,2,87,1252,982,6,13,0,0,76,1077,
20221023,293,145,문산,산인,1889,5,16,7,5,93,2015,1688,12,12,1,1,74,1788,
20221023,298,253,서산,서서울,4049,17,20,38,8,139,4271,3631,10,42,13,5,166,3867,
20221023,298,520,서산,평택,901,1,55,7,2,37,1003,935,5,98,2,4,43,1087,
20221023,508,509,무안,목포,1334,14,15,9,4,42,1418,1774,20,18,5,8,60,1885,
20221023,508,553,무안,동광산,1428,6,18,7,8,47,1514,1611,7,24,8,6,54,1710,
20221023,509,508,목포,무안,1774,20,18,5,8,60,1885,1334,14,15,9,4,42,1418,
20221023,509,553,목포,동광산,8790,53,142,47,24,261,9317,8154,43,137,40,12,266,8652,
20221023,513,515,고성,북통영,2051,14,61,2,2,114,2244,2801,16,58,1,1,137,3014,
20221023,513,516,고성,통영,4690,25,69,8,3,259,5054,5198,29,53,9,4,264,5557,
20221023,514,516,동고성,통영,1233,7,15,3,27,110,1395,1048,4,9,2,28,93,1184,
20221023,515,513,북통영,고성,2801,16,58,1,1,137,3014,2051,14,61,2,2,114,2244,
20221023,516,292,통영,진주,982,6,13,0,0,76,1077,1143,4,16,0,2,87,1252,
20221023,516,513,통영,고성,5198,29,53,9,4,264,5557,4690,25,69,8,3,259,5054,
20221023,516,514,통영,동고성,1048,4,9,2,28,93,1184,1233,7,15,3,27,110,1395,
20221023,517,598,양평,북여주,1263,5,9,6,15,49,1347,1082,6,14,13,15,35,1165,
20221023,519,231,남대구,화원옥포,4161,25,38,7,9,302,4542,4373,27,48,5,6,294,4753,
20221023,519,232,남대구,달성,1433,19,13,9,4,108,1586,1405,23,30,5,2,119,1584,
20221023,519,233,남대구,현풍,3057,21,33,24,9,176,3320,3307,29,35,10,11,178,3570,
20221023,519,239,남대구,칠원,2320,16,64,6,3,104,2513,2226,23,53,8,3,89,2402,
20221023,519,241,남대구,동고령,2654,17,41,2,8,127,2849,3985,21,64,6,10,166,4252,
20221023,519,242,남대구,고령,3270,12,37,4,23,163,3509,3244,19,38,4,16,130,3451,
20221023,519,243,남대구,해인사,1077,3,4,0,0,35,1119,1206,3,3,0,0,43,1255,
20221023,519,280,남대구,거창,1372,12,39,2,2,70,1497,1511,6,33,1,2,67,1620,
20221023,519,730,남대구,유천,1600,10,13,0,0,67,1690,1833,10,7,0,0,96,1946,
20221023,519,731,남대구,북현풍,1401,2,18,0,0,58,1479,1118,3,5,0,0,56,1182,
20221023,520,253,평택,서서울,3369,28,24,32,22,140,3615,3696,24,36,24,21,154,3955,
20221023,520,298,평택,서산,935,5,98,2,4,43,1087,901,1,55,7,2,37,1003,
20221023,526,527,서포항,포항,1493,5,18,4,3,98,1621,1327,9,15,1,3,82,1437,
20221023,527,127,포항,서대구,1513,7,27,2,8,55,1612,1819,13,31,5,9,62,1939,
20221023,527,129,포항,북대구,3474,27,13,9,13,127,3663,2321,23,9,4,6,88,2451,
20221023,527,230,포항,팔공산,2332,7,12,2,3,96,2452,2184,11,10,0,3,110,2318,
20221023,527,526,포항,서포항,1327,9,15,1,3,82,1437,1493,5,18,4,3,98,1621,
20221023,528,101,기흥동탄,서울,6002,15,413,96,3,274,6803,6270,18,401,92,1,251,7033,
20221023,542,101,서안성,서울,1894,21,35,63,3,93,2109,1658,15,36,40,4,82,1835,
20221023,543,101,남안성,서울,1287,32,36,47,14,43,1459,1384,23,41,37,14,38,1537,
20221023,548,553,북무안,동광산,2393,14,17,20,9,70,2523,2011,16,27,8,9,56,2127,
20221023,549,553,동함평,동광산,5767,20,39,11,8,164,6009,5717,16,51,10,12,155,5961,
20221023,551,553,나주,동광산,996,3,8,9,3,33,1052,953,8,9,8,2,32,1012,
20221023,552,553,서광산,동광산,2961,48,80,71,37,79,3276,3912,57,109,56,20,114,4268,
20221023,553,508,동광산,무안,1611,7,24,8,6,54,1710,1428,6,18,7,8,47,1514,
20221023,553,509,동광산,목포,8154,43,137,40,12,266,8652,8790,53,142,47,24,261,9317,
20221023,553,548,동광산,북무안,2011,16,27,8,9,56,2127,2393,14,17,20,9,70,2523,
20221023,553,549,동광산,동함평,5717,16,51,10,12,155,5961,5767,20,39,11,8,164,6009,
20221023,553,551,동광산,나주,953,8,9,8,2,32,1012,996,3,8,9,3,33,1052,
20221023,553,552,동광산,서광산,3912,57,109,56,20,114,4268,2961,48,80,71,37,79,3276,
20221023,554,174,동홍천,춘천,1234,8,15,4,0,69,1330,1011,9,17,3,0,60,1100,
20221023,556,557,동순천,황전,1436,10,15,1,4,36,1502,1235,9,8,0,5,43,1300,
20221023,557,556,황전,동순천,1235,9,8,0,5,43,1300,1436,10,15,1,4,36,1502,
20221023,560,190,감곡,동서울,1310,10,5,16,17,44,1402,1134,5,10,9,9,32,1199,
20221023,567,167,남고창,광주,1717,11,36,6,1,52,1823,1516,15,43,9,6,42,1631,
20221023,587,589,오수,상관,1039,3,21,5,5,21,1094,1207,4,22,6,7,32,1278,
20221023,589,587,상관,오수,1207,4,22,6,7,32,1278,1039,3,21,5,5,21,1094,
20221023,598,517,북여주,양평,1082,6,14,13,15,35,1165,1263,5,9,6,15,49,1347,
20221023,621,131,동대구,경산,1428,13,11,4,4,68,1528,1476,20,13,2,4,87,1602,
20221023,621,135,동대구,경주,1168,3,45,0,0,49,1265,1274,9,46,0,0,44,1373,
20221023,624,626,청도,남밀양,1125,8,3,11,8,57,1212,1067,8,10,7,7,51,1150,
20221023,625,626,밀양,남밀양,2616,18,14,14,6,107,2775,2058,9,15,10,6,85,2183,
20221023,626,624,남밀양,청도,1067,8,10,7,7,51,1150,1125,8,3,11,8,57,1212,
20221023,626,625,남밀양,밀양,2058,9,15,10,6,85,2183,2616,18,14,14,6,107,2775,
20221023,641,139,울산,서울산,1056,6,46,2,2,69,1181,1490,9,55,1,5,90,1650,
20221023,641,252,울산,대동,1605,10,44,3,4,97,1763,2236,14,42,1,4,132,2429,
20221023,641,648,울산,해운대,1172,0,2,0,0,78,1252,1503,1,3,0,0,83,1590,
20221023,641,706,울산,남경주,1223,1,6,2,0,64,1296,1686,2,5,4,2,94,1793,
20221023,641,707,울산,남포항,1824,8,21,5,29,82,1969,2146,9,20,11,32,99,2317,
20221023,643,648,청량,해운대,3402,3,9,1,0,208,3623,4378,9,48,3,26,237,4701,
20221023,645,648,장안,해운대,1414,1,4,1,0,70,1490,3115,7,8,2,1,134,3267,
20221023,646,648,기장일광,해운대,4626,5,11,1,3,233,4879,5441,10,12,4,20,261,5748,
20221023,648,641,해운대,울산,1503,1,3,0,0,83,1590,1172,0,2,0,0,78,1252,
20221023,648,643,해운대,청량,4378,9,48,3,26,237,4701,3402,3,9,1,0,208,3623,
20221023,648,645,해운대,장안,3115,7,8,2,1,134,3267,1414,1,4,1,0,70,1490,
20221023,648,646,해운대,기장일광,5441,10,12,4,20,261,5748,4626,5,11,1,3,233,4879,
20221023,648,707,해운대,남포항,1553,4,24,2,14,56,1653,1232,2,9,0,1,45,1289,
20221023,651,652,남양주,화도,11312,114,273,168,29,620,12516,14277,114,295,210,16,733,15645,
20221023,651,653,남양주,서종,1827,4,2,3,1,79,1916,4843,16,3,0,0,140,5002,
20221023,651,654,남양주,설악,4281,14,63,3,2,129,4492,4176,10,53,6,2,132,4379,
20221023,651,655,남양주,강촌,3052,10,102,7,8,106,3285,2899,13,86,20,12,83,3113,
20221023,651,656,남양주,남춘천,3556,14,88,3,10,100,3771,1983,6,48,2,4,55,2098,
20221023,652,651,화도,남양주,14277,114,295,210,16,733,15645,11312,114,273,168,29,620,12516,
20221023,652,653,화도,서종,1193,10,2,3,1,62,1271,2735,10,2,7,1,125,2880,
20221023,652,654,화도,설악,1160,2,7,1,1,66,1237,1145,3,5,0,1,56,1210,
20221023,653,651,서종,남양주,4843,16,3,0,0,140,5002,1827,4,2,3,1,79,1916,
20221023,653,652,서종,화도,2735,10,2,7,1,125,2880,1193,10,2,3,1,62,1271,
20221023,654,651,설악,남양주,4176,10,53,6,2,132,4379,4281,14,63,3,2,129,4492,
20221023,654,652,설악,화도,1145,3,5,0,1,56,1210,1160,2,7,1,1,66,1237,
20221023,655,651,강촌,남양주,2899,13,86,20,12,83,3113,3052,10,102,7,8,106,3285,
20221023,656,651,남춘천,남양주,1983,6,48,2,4,55,2098,3556,14,88,3,10,100,3771,
20221023,671,672,봉담,정남,1393,19,15,3,4,77,1511,1549,23,12,6,4,92,1686,
20221023,671,673,봉담,북오산,1464,8,17,3,4,109,1605,1497,13,21,6,1,93,1631,
20221023,671,677,봉담,북평택,8159,35,52,20,22,405,8693,10170,36,56,32,17,439,10750,
20221023,672,671,정남,봉담,1549,23,12,6,4,92,1686,1393,19,15,3,4,77,1511,
20221023,673,101,북오산,서울,1296,10,91,7,2,88,1494,1520,6,96,6,4,109,1741,
20221023,673,671,북오산,봉담,1497,13,21,6,1,93,1631,1464,8,17,3,4,109,1605,
20221023,673,677,북오산,북평택,1832,8,9,5,3,89,1946,1871,15,13,3,2,87,1991,
20221023,675,676,서오산,향남,1470,19,11,2,29,102,1633,1175,28,6,10,45,93,1357,
20221023,675,677,서오산,북평택,9751,46,133,27,43,503,10503,13662,62,112,45,33,586,14500,
20221023,676,675,향남,서오산,1175,28,6,10,45,93,1357,1470,19,11,2,29,102,1633,
20221023,676,677,향남,북평택,1054,22,20,30,14,63,1203,1567,23,22,33,23,89,1757,
20221023,677,101,북평택,서울,2845,13,154,19,24,114,3169,2206,15,276,20,14,101,2632,
20221023,677,671,북평택,봉담,10170,36,56,32,17,439,10750,8159,35,52,20,22,405,8693,
20221023,677,673,북평택,북오산,1871,15,13,3,2,87,1991,1832,8,9,5,3,89,1946,
20221023,677,675,북평택,서오산,13662,62,112,45,33,586,14500,9751,46,133,27,43,503,10503,
20221023,677,676,북평택,향남,1567,23,22,33,23,89,1757,1054,22,20,30,14,63,1203,
20221023,677,876,북평택,양감,3109,23,21,15,16,133,3317,1064,9,21,9,16,71,1190,
20221023,682,685,조암,서시흥,1157,21,17,17,33,59,1304,1529,21,19,19,28,75,1691,
20221023,683,684,송산마도,남안산,1457,24,22,9,83,98,1693,1491,21,18,9,83,92,1714,
20221023,683,685,송산마도,서시흥,4371,31,35,30,86,241,4794,4290,31,40,34,66,240,4701,
20221023,684,683,남안산,송산마도,1491,21,18,9,83,92,1714,1457,24,22,9,83,98,1693,
20221023,684,685,남안산,서시흥,2084,77,79,132,93,151,2616,3814,93,80,128,84,251,4450,
20221023,685,682,서시흥,조암,1529,21,19,19,28,75,1691,1157,21,17,17,33,59,1304,
20221023,685,683,서시흥,송산마도,4290,31,40,34,66,240,4701,4371,31,35,30,86,241,4794,
20221023,685,684,서시흥,남안산,3814,93,80,128,84,251,4450,2084,77,79,132,93,151,2616,
20221023,705,190,남이천,동서울,1734,25,13,12,4,55,1843,1386,19,20,15,8,41,1489,
20221023,706,641,남경주,울산,1686,2,5,4,2,94,1793,1223,1,6,2,0,64,1296,
20221023,706,707,남경주,남포항,1606,7,41,3,14,83,1754,1910,13,40,6,24,94,2087,
20221023,707,641,남포항,울산,2146,9,20,11,32,99,2317,1824,8,21,5,29,82,1969,
20221023,707,648,남포항,해운대,1232,2,9,0,1,45,1289,1553,4,24,2,14,56,1653,
20221023,707,706,남포항,남경주,1910,13,40,6,24,94,2087,1606,7,41,3,14,83,1754,
20221023,707,708,남포항,동경주,1959,9,17,1,4,84,2074,2092,10,18,2,7,97,2226,
20221023,708,707,동경주,남포항,2092,10,18,2,7,97,2226,1959,9,17,1,4,84,2074,
20221023,715,716,동안동,청송,1020,11,12,8,0,50,1101,1011,13,9,4,0,44,1081,
20221023,715,749,동안동,영덕,1012,5,13,3,0,40,1073,1212,7,15,3,0,41,1278,
20221023,716,715,청송,동안동,1011,13,9,4,0,44,1081,1020,11,12,8,0,50,1101,
20221023,730,519,유천,남대구,1833,10,7,0,0,96,1946,1600,10,13,0,0,67,1690,
20221023,731,519,북현풍,남대구,1118,3,5,0,0,56,1182,1401,2,18,0,0,58,1479,
20221023,741,253,평택고덕,서서울,1004,9,6,2,4,63,1088,2020,3,8,4,11,134,2180,
20221023,742,107,남사진위,안성,1143,14,27,11,2,63,1260,936,16,23,10,4,51,1040,
20221023,749,715,영덕,동안동,1212,7,15,3,0,41,1278,1012,5,13,3,0,40,1073,
20221023,752,252,기장철마,대동,1547,14,10,3,16,113,1703,1567,4,8,3,19,124,1725,
20221023,755,252,광재,대동,1342,7,14,7,47,71,1488,1391,10,14,3,52,85,1555,
20221023,772,774,북달성,남칠곡,1998,7,10,7,7,74,2103,2459,10,10,6,9,96,2590,
20221023,773,774,북다사,남칠곡,1052,6,12,3,4,57,1134,1249,7,8,2,3,47,1316,
20221023,774,772,남칠곡,북달성,2459,10,10,6,9,96,2590,1998,7,10,7,7,74,2103,
20221023,774,773,남칠곡,북다사,1249,7,8,2,3,47,1316,1052,6,12,3,4,57,1134,
20221023,775,203,동명동호,가산,1755,9,14,7,9,65,1859,1797,15,6,6,6,58,1888,
20221023,776,777,연경,파군재,3865,11,9,3,1,185,4074,3940,6,14,2,2,190,4154,
20221023,776,779,연경,율암,4437,26,31,20,21,212,4747,4587,29,44,29,24,247,4960,
20221023,777,776,파군재,연경,3940,6,14,2,2,190,4154,3865,11,9,3,1,185,4074,
20221023,777,779,파군재,율암,2969,5,3,1,2,167,3147,2840,8,4,2,1,174,3029,
20221023,779,776,율암,연경,4587,29,44,29,24,247,4960,4437,26,31,20,21,212,4747,
20221023,779,777,율암,파군재,2840,8,4,2,1,174,3029,2969,5,3,1,2,167,3147,
20221023,876,677,양감,북평택,1064,9,21,9,16,71,1190,3109,23,21,15,16,133,3317,
20221023,981,982,서영암,강진무위사,1932,10,65,24,9,62,2102,2506,18,74,27,7,62,2694,
20221023,981,987,서영암,남순천,2191,25,77,29,52,70,2444,2736,19,86,26,31,91,2989,
20221023,982,981,강진무위사,서영암,2506,18,74,27,7,62,2694,1932,10,65,24,9,62,2102,
20221023,982,987,강진무위사,남순천,1196,4,33,19,12,35,1299,1087,6,32,7,7,37,1176,
20221023,984,985,보성,벌교,1874,17,37,7,14,62,2011,2584,21,26,15,17,70,2733,
20221023,984,987,보성,남순천,2576,16,60,32,42,67,2793,2749,20,62,18,43,77,2969,
20221023,985,984,벌교,보성,2584,21,26,15,17,70,2733,1874,17,37,7,14,62,2011,
20221023,986,987,고흥,남순천,5200,22,78,60,58,154,5572,4016,18,57,22,32,142,4287,
20221023,987,981,남순천,서영암,2736,19,86,26,31,91,2989,2191,25,77,29,52,70,2444,
20221023,987,982,남순천,강진무위사,1087,6,32,7,7,37,1176,1196,4,33,19,12,35,1299,
20221023,987,984,남순천,보성,2749,20,62,18,43,77,2969,2576,16,60,32,42,67,2793,
20221023,987,986,남순천,고흥,4016,18,57,22,32,142,4287,5200,22,78,60,58,154,5572,
20221024,101,102,서울,동수원,3656,48,238,18,3,215,4178,4948,44,366,31,11,272,5672,
20221024,101,103,서울,수원신갈,14834,608,1622,396,118,735,18313,13927,667,1607,385,93,675,17354,
20221024,101,105,서울,기흥,7291,74,402,67,23,337,8194,5924,86,364,83,25,319,6801,
20221024,101,106,서울,오산,4867,350,404,156,91,299,6167,4241,411,437,184,113,262,5648,
20221024,101,107,서울,안성,3601,106,308,32,17,204,4268,2870,80,287,44,27,153,3461,
20221024,101,108,서울,천안,4277,62,332,39,13,207,4930,3651,59,335,33,11,182,4271,
20221024,101,111,서울,청주,1045,15,169,12,23,47,1311,851,21,195,15,10,45,1137,
20221024,101,171,서울,마성,2400,36,245,53,0,137,2871,2631,25,270,53,2,150,3131,
20221024,101,172,서울,용인,3377,142,106,39,14,211,3889,3742,161,107,39,41,225,4315,
20221024,101,173,서울,양지,3277,189,119,111,114,150,3960,4066,340,126,117,147,182,4978,
20221024,101,528,서울,기흥동탄,7067,72,1148,126,10,368,8791,7118,55,1284,128,15,361,8961,
20221024,101,542,서울,서안성,1349,31,84,82,18,72,1636,1698,43,71,123,35,80,2050,
20221024,101,543,서울,남안성,1272,70,58,50,56,42,1548,1251,83,76,91,88,59,1648,
20221024,101,673,서울,북오산,1614,42,116,25,6,107,1910,1503,46,121,22,14,95,1801,
20221024,101,677,서울,북평택,2291,64,263,87,100,97,2902,1624,61,250,88,126,93,2242,
20221024,102,101,동수원,서울,4948,44,366,31,11,272,5672,3656,48,238,18,3,215,4178,
20221024,102,172,동수원,용인,947,23,14,5,7,91,1087,961,33,17,0,1,85,1097,
20221024,102,173,동수원,양지,1242,46,30,11,29,74,1432,1356,34,31,7,8,87,1523,
20221024,102,212,동수원,북수원,4224,26,228,70,29,235,4812,4760,41,241,75,20,279,5416,
20221024,102,213,동수원,부곡,1061,18,14,3,20,73,1189,1017,13,17,3,21,75,1146,
20221024,102,214,동수원,동군포,1419,26,18,13,6,81,1563,1573,24,10,15,4,106,1732,
20221024,102,215,동수원,군포,1562,20,23,7,13,98,1723,2198,26,40,12,8,138,2422,
20221024,102,253,동수원,서서울,5677,59,59,17,12,307,6131,5134,50,62,12,26,329,5613,
20221024,102,254,동수원,군자,3913,50,70,19,25,205,4282,4146,65,71,28,38,244,4592,
20221024,102,255,동수원,서안산,1810,36,18,10,4,104,1982,1959,34,18,13,4,122,2150,
20221024,103,101,수원신갈,서울,13927,667,1607,385,93,675,17354,14834,608,1622,396,118,735,18313,
20221024,103,105,수원신갈,기흥,1703,16,44,16,16,118,1913,2168,30,35,17,18,136,2404,
20221024,103,106,수원신갈,오산,1031,71,54,39,16,65,1276,1339,74,61,61,18,105,1658,
20221024,103,108,수원신갈,천안,957,7,55,15,1,40,1075,1247,8,47,16,2,57,1377,
20221024,103,253,수원신갈,서서울,1962,136,83,65,27,121,2394,2057,126,74,74,28,110,2469,
20221024,103,254,수원신갈,군자,1526,118,57,70,82,84,1937,1749,128,79,112,130,103,2301,
20221024,103,528,수원신갈,기흥동탄,1390,13,194,4,1,87,1689,2083,19,157,4,2,116,2381,
20221024,105,101,기흥,서울,5924,86,364,83,25,319,6801,7291,74,402,67,23,337,8194,
20221024,105,103,기흥,수원신갈,2168,30,35,17,18,136,2404,1703,16,44,16,16,118,1913,
20221024,105,253,기흥,서서울,924,19,9,11,14,69,1046,998,18,13,6,10,63,1108,
20221024,106,101,오산,서울,4241,411,437,184,113,262,5648,4867,350,404,156,91,299,6167,
20221024,106,103,오산,수원신갈,1339,74,61,61,18,105,1658,1031,71,54,39,16,65,1276,
20221024,106,107,오산,안성,1589,51,33,26,16,132,1847,1389,50,21,20,8,132,1620,
20221024,106,108,오산,천안,1039,22,28,8,8,60,1165,1043,26,34,7,5,60,1175,
20221024,107,101,안성,서울,2870,80,287,44,27,153,3461,3601,106,308,32,17,204,4268,
20221024,107,106,안성,오산,1389,50,21,20,8,132,1620,1589,51,33,26,16,132,1847,
20221024,107,108,안성,천안,1495,27,36,8,9,115,1690,1460,24,43,17,7,135,1686,
20221024,107,528,안성,기흥동탄,997,8,15,6,4,92,1122,1171,19,20,3,13,89,1315,
20221024,107,742,안성,남사진위,1186,34,48,30,2,102,1402,1402,40,54,28,9,121,1654,
20221024,108,101,천안,서울,3651,59,335,33,11,182,4271,4277,62,332,39,13,207,4930,
20221024,108,103,천안,수원신갈,1247,8,47,16,2,57,1377,957,7,55,15,1,40,1075,
20221024,108,106,천안,오산,1043,26,34,7,5,60,1175,1039,22,28,8,8,60,1165,
20221024,108,107,천안,안성,1460,24,43,17,7,135,1686,1495,27,36,8,9,115,1690,
20221024,108,111,천안,청주,1128,33,65,20,42,75,1363,1121,26,57,19,44,79,1346,
20221024,108,229,천안,북천안,3502,98,114,52,30,213,4009,3838,83,136,77,52,235,4421,
20221024,108,528,천안,기흥동탄,1071,11,115,4,13,70,1284,1095,20,115,0,16,74,1320,
20221024,108,742,천안,남사진위,1054,19,39,21,5,66,1204,1189,25,43,23,8,61,1349,
20221024,111,101,청주,서울,851,21,195,15,10,45,1137,1045,15,169,12,23,47,1311,
20221024,111,108,청주,천안,1121,26,57,19,44,79,1346,1128,33,65,20,42,75,1363,
20221024,112,115,남청주,대전,1577,73,57,2,16,111,1836,1664,89,56,7,6,136,1958,
20221024,113,115,신탄진,대전,914,15,10,6,13,99,1057,1085,24,16,9,4,124,1262,
20221024,113,198,신탄진,서청주,811,32,33,46,34,66,1022,896,32,16,34,15,61,1054,
20221024,114,153,남대전,서대전,1852,43,62,59,24,133,2173,1697,24,70,67,30,132,2020,
20221024,115,112,대전,남청주,1664,89,56,7,6,136,1958,1577,73,57,2,16,111,1836,
20221024,115,113,대전,신탄진,1085,24,16,9,4,124,1262,914,15,10,6,13,99,1057,
20221024,115,116,대전,옥천,2210,94,50,18,22,166,2560,1966,60,42,31,24,151,2274,
20221024,115,151,대전,북대전,1103,14,16,6,4,112,1255,892,9,12,1,7,91,1012,
20221024,115,153,대전,서대전,928,16,3,3,3,74,1027,918,25,9,7,2,70,1031,
20221024,115,198,대전,서청주,1001,18,3,8,3,68,1101,920,16,4,6,2,66,1014,
20221024,115,579,대전,남세종,1021,12,24,8,15,84,1164,1119,10,22,8,15,92,1266,
20221024,116,115,옥천,대전,1966,60,42,31,24,151,2274,2210,94,50,18,22,166,2560,
20221024,119,153,판암,서대전,1777,19,21,9,8,140,1974,1866,19,25,8,9,143,2070,
20221024,123,127,구미,서대구,1619,31,7,16,4,90,1767,1689,32,18,12,4,102,1857,
20221024,123,129,구미,북대구,1781,15,54,11,5,82,1948,1918,17,61,2,3,94,2095,
20221024,123,130,구미,동김천,1170,36,28,34,24,69,1361,1148,26,27,27,23,69,1320,
20221024,125,127,남구미,서대구,1900,49,93,33,11,104,2190,2188,60,112,43,20,127,2550,
20221024,125,129,남구미,북대구,1741,16,72,9,10,91,1939,2190,30,63,7,11,111,2412,
20221024,126,127,왜관,서대구,2441,118,56,34,106,144,2899,2740,131,74,43,68,160,3216,
20221024,126,129,왜관,북대구,2996,88,50,16,72,128,3350,3414,90,50,21,48,156,3779,
20221024,127,123,서대구,구미,1689,32,18,12,4,102,1857,1619,31,7,16,4,90,1767,
20221024,127,125,서대구,남구미,2188,60,112,43,20,127,2550,1900,49,93,33,11,104,2190,
20221024,127,126,서대구,왜관,2740,131,74,43,68,160,3216,2441,118,56,34,106,144,2899,
20221024,127,131,서대구,경산,2507,195,164,92,89,164,3211,1769,149,108,71,63,117,2277,
20221024,127,203,서대구,가산,2125,55,76,52,95,98,2501,1947,39,61,33,132,98,2310,
20221024,127,230,서대구,팔공산,1396,52,35,13,6,98,1600,1053,31,23,15,7,71,1200,
20221024,127,621,서대구,동대구,1775,56,78,34,33,125,2101,1315,40,30,28,22,102,1537,
20221024,129,123,북대구,구미,1918,17,61,2,3,94,2095,1781,15,54,11,5,82,1948,
20221024,129,125,북대구,남구미,2190,30,63,7,11,111,2412,1741,16,72,9,10,91,1939,
20221024,129,126,북대구,왜관,3414,90,50,21,48,156,3779,2996,88,50,16,72,128,3350,
20221024,129,131,북대구,경산,2264,146,101,46,30,145,2732,2916,184,122,64,52,164,3502,
20221024,129,524,북대구,청통와촌,944,44,30,12,18,49,1097,1124,66,26,23,26,54,1319,
20221024,129,527,북대구,포항,1589,25,26,18,60,69,1787,1857,38,34,17,80,90,2116,
20221024,130,123,동김천,구미,1148,26,27,27,23,69,1320,1170,36,28,34,24,69,1361,
20221024,131,127,경산,서대구,1769,149,108,71,63,117,2277,2507,195,164,92,89,164,3211,
20221024,131,129,경산,북대구,2916,184,122,64,52,164,3502,2264,146,101,46,30,145,2732,
20221024,131,132,경산,영천,903,48,41,38,62,43,1135,815,45,43,36,42,43,1024,
20221024,131,230,경산,팔공산,1237,86,35,27,20,76,1481,1467,77,53,67,26,91,1781,
20221024,131,621,경산,동대구,2231,68,35,246,77,130,2787,2384,73,43,212,46,129,2887,
20221024,132,131,영천,경산,815,45,43,36,42,43,1024,903,48,41,38,62,43,1135,
20221024,132,621,영천,동대구,1151,11,22,6,34,39,1263,1224,13,23,4,37,49,1350,
20221024,135,140,경주,부산,1297,14,27,5,38,45,1426,1442,12,32,6,34,59,1585,
20221024,135,252,경주,대동,995,27,75,49,166,53,1365,1251,40,78,59,124,61,1613,
20221024,138,140,양산,부산,5064,228,173,197,254,264,6180,5424,305,183,221,231,293,6657,
20221024,138,252,양산,대동,2593,321,197,182,286,129,3708,3078,320,194,199,280,151,4222,
20221024,139,140,서울산,부산,1348,53,32,6,25,79,1543,1255,55,26,4,24,66,1430,
20221024,139,252,서울산,대동,858,50,46,32,51,43,1080,858,32,33,27,41,53,1044,
20221024,139,641,서울산,울산,1088,38,69,24,38,83,1340,1075,20,51,12,30,68,1256,
20221024,140,135,부산,경주,1442,12,32,6,34,59,1585,1297,14,27,5,38,45,1426,
20221024,140,138,부산,양산,5424,305,183,221,231,293,6657,5064,228,173,197,254,264,6180,
20221024,140,139,부산,서울산,1255,55,26,4,24,66,1430,1348,53,32,6,25,79,1543,
20221024,140,250,부산,남양산,7754,147,230,65,48,628,8872,7744,122,204,66,56,639,8831,
20221024,140,251,부산,물금,1086,116,34,26,51,79,1392,959,95,38,18,58,68,1236,
20221024,140,252,부산,대동,1776,43,61,57,56,104,2097,1451,47,47,31,108,97,1781,
20221024,140,755,부산,광재,1119,12,13,8,44,64,1260,977,10,11,5,38,48,1089,
20221024,142,145,군북,산인,3965,60,107,41,80,298,4551,4087,59,114,44,84,293,4681,
20221024,143,145,장지,산인,1192,17,26,30,102,84,1451,1301,22,27,28,117,106,1601,
20221024,144,145,함안,산인,1832,52,31,29,66,135,2145,1976,53,41,28,50,144,2292,
20221024,145,142,산인,군북,4087,59,114,44,84,293,4681,3965,60,107,41,80,298,4551,
20221024,145,143,산인,장지,1301,22,27,28,117,106,1601,1192,17,26,30,102,84,1451,
20221024,145,144,산인,함안,1976,53,41,28,50,144,2292,1832,52,31,29,66,135,2145,
20221024,145,291,산인,사천,1360,31,48,18,18,51,1526,1305,50,49,23,24,53,1504,
20221024,145,292,산인,진주,1399,32,146,19,21,65,1682,1589,25,141,19,18,98,1890,
20221024,145,293,산인,문산,1248,32,21,12,6,78,1397,1088,27,26,17,14,72,1244,
20221024,146,150,동창원,북부산,1070,15,16,5,27,75,1208,997,20,19,1,18,75,1130,
20221024,146,244,동창원,서부산,1276,31,32,21,29,85,1474,1353,31,31,21,43,105,1584,
20221024,146,245,동창원,장유,890,15,10,11,7,104,1037,988,18,17,6,8,90,1127,
20221024,146,289,동창원,마산,2643,94,67,41,81,230,3156,2390,83,70,26,40,202,2811,
20221024,147,150,진례,북부산,1431,47,27,18,27,89,1639,1687,44,28,22,19,100,1900,
20221024,147,244,진례,서부산,1741,97,88,44,84,105,2159,1938,104,77,58,84,105,2366,
20221024,147,245,진례,장유,1076,66,100,95,18,86,1441,1415,59,96,87,17,124,1798,
20221024,147,289,진례,마산,1296,98,83,49,107,84,1717,1340,87,82,48,89,86,1732,
20221024,148,150,서김해,북부산,6485,113,75,57,115,520,7365,6418,111,64,37,85,528,7243,
20221024,148,251,서김해,물금,887,38,18,31,10,92,1076,855,32,26,25,17,82,1037,
20221024,148,289,서김해,마산,1451,30,52,14,6,96,1649,1351,23,50,10,9,100,1543,
20221024,149,150,동김해,북부산,10260,181,173,32,90,880,11616,8927,156,126,33,49,691,9982,
20221024,149,250,동김해,남양산,1045,25,52,9,5,84,1220,898,17,48,6,6,79,1054,
20221024,149,251,동김해,물금,1153,39,18,7,3,112,1332,1068,35,18,8,6,114,1249,
20221024,150,146,북부산,동창원,997,20,19,1,18,75,1130,1070,15,16,5,27,75,1208,
20221024,150,147,북부산,진례,1687,44,28,22,19,100,1900,1431,47,27,18,27,89,1639,
20221024,150,148,북부산,서김해,6418,111,64,37,85,528,7243,6485,113,75,57,115,520,7365,
20221024,150,149,북부산,동김해,8927,156,126,33,49,691,9982,10260,181,173,32,90,880,11616,
20221024,150,245,북부산,장유,3707,32,79,12,35,282,4147,3115,32,75,8,30,208,3468,
20221024,150,289,북부산,마산,2741,27,87,8,29,145,3037,2505,33,71,7,20,149,2785,
20221024,151,115,북대전,대전,892,9,12,1,7,91,1012,1103,14,16,6,4,112,1255,
20221024,151,153,북대전,서대전,1062,14,26,15,26,79,1222,1192,17,21,20,16,92,1358,
20221024,152,154,유성,안영,926,19,39,10,3,58,1055,1105,24,42,15,13,65,1264,
20221024,153,114,서대전,남대전,1697,24,70,67,30,132,2020,1852,43,62,59,24,133,2173,
20221024,153,115,서대전,대전,918,25,9,7,2,70,1031,928,16,3,3,3,74,1027,
20221024,153,119,서대전,판암,1866,19,25,8,9,143,2070,1777,19,21,9,8,140,1974,
20221024,153,151,서대전,북대전,1192,17,21,20,16,92,1358,1062,14,26,15,26,79,1222,
20221024,153,154,서대전,안영,1060,26,42,38,125,63,1354,1075,30,43,47,101,64,1360,
20221024,153,579,서대전,남세종,1213,16,11,8,16,84,1348,1062,23,19,8,16,80,1208,
20221024,154,152,안영,유성,1105,24,42,15,13,65,1264,926,19,39,10,3,58,1055,
20221024,154,153,안영,서대전,1075,30,43,47,101,64,1360,1060,26,42,38,125,63,1354,
20221024,159,167,서전주,광주,1450,63,68,45,40,39,1705,1409,56,49,42,43,47,1646,
20221024,166,167,장성,광주,2178,94,74,38,56,105,2545,2676,111,87,46,55,105,3080,
20221024,167,159,광주,서전주,1409,56,49,42,43,47,1646,1450,63,68,45,40,39,1705,
20221024,167,166,광주,장성,2676,111,87,46,55,105,3080,2178,94,74,38,56,105,2545,
20221024,167,567,광주,남고창,1259,33,53,9,32,46,1432,1286,34,53,9,35,41,1458,
20221024,171,101,마성,서울,2631,25,270,53,2,150,3131,2400,36,245,53,0,137,2871,
20221024,172,101,용인,서울,3742,161,107,39,41,225,4315,3377,142,106,39,14,211,3889,
20221024,172,102,용인,동수원,961,33,17,0,1,85,1097,947,23,14,5,7,91,1087,
20221024,172,173,용인,양지,1940,230,113,129,105,141,2658,1744,205,144,105,101,156,2455,
20221024,172,212,용인,북수원,941,39,22,19,14,62,1097,1123,58,26,21,10,78,1316,
20221024,172,253,용인,서서울,1074,50,22,23,19,65,1253,1064,63,20,26,16,66,1255,
20221024,173,101,양지,서울,4066,340,126,117,147,182,4978,3277,189,119,111,114,150,3960,
20221024,173,102,양지,동수원,1356,34,31,7,8,87,1523,1242,46,30,11,29,74,1432,
20221024,173,172,양지,용인,1744,205,144,105,101,156,2455,1940,230,113,129,105,141,2658,
20221024,173,212,양지,북수원,1171,77,36,42,21,67,1414,1317,99,58,59,28,67,1628,
20221024,173,253,양지,서서울,1159,129,69,84,50,54,1545,938,125,62,100,37,61,1323,
20221024,173,254,양지,군자,700,99,84,165,201,25,1274,764,102,97,137,205,44,1349,
20221024,174,179,춘천,홍천,3144,68,82,39,18,310,3661,3218,77,80,34,17,303,3729,
20221024,174,216,춘천,횡성,1110,50,32,19,39,85,1335,1113,47,38,17,22,73,1310,
20221024,174,218,춘천,남원주,1172,20,65,11,13,78,1359,1103,17,62,9,9,70,1270,
20221024,174,554,춘천,동홍천,1206,14,23,11,12,101,1367,956,12,18,3,6,77,1072,
20221024,176,190,이천,동서울,1447,61,169,105,110,68,1960,1766,53,197,133,89,97,2335,
20221024,179,174,홍천,춘천,3218,77,80,34,17,303,3729,3144,68,82,39,18,310,3661,
20221024,184,189,대관령,강릉,1272,36,80,14,13,78,1493,1253,46,67,5,7,86,1464,
20221024,189,184,강릉,대관령,1253,46,67,5,7,86,1464,1272,36,80,14,13,78,1493,
20221024,190,176,동서울,이천,1766,53,197,133,89,97,2335,1447,61,169,105,110,68,1960,
20221024,190,191,동서울,경기광주,10053,645,472,360,188,709,12427,10039,632,415,303,180,693,12262,
20221024,190,192,동서울,곤지암,6227,480,235,201,81,369,7593,5650,435,174,193,51,367,6870,
20221024,190,193,동서울,일죽,2566,136,167,181,103,100,3253,2300,151,148,207,95,74,2975,
20221024,190,194,동서울,서이천,4365,531,308,284,196,248,5932,3179,408,214,195,118,203,4317,
20221024,190,198,동서울,서청주,1089,21,52,26,34,34,1256,886,17,43,29,23,46,1044,
20221024,190,560,동서울,감곡,972,16,30,36,98,30,1182,936,33,29,31,92,30,1151,
20221024,190,705,동서울,남이천,1517,90,56,119,109,42,1933,1372,85,54,85,72,56,1724,
20221024,191,190,경기광주,동서울,10039,632,415,303,180,693,12262,10053,645,472,360,188,709,12427,
20221024,192,190,곤지암,동서울,5650,435,174,193,51,367,6870,6227,480,235,201,81,369,7593,
20221024,192,194,곤지암,서이천,1338,250,102,122,90,98,2000,993,139,94,120,130,84,1560,
20221024,193,190,일죽,동서울,2300,151,148,207,95,74,2975,2566,136,167,181,103,100,3253,
20221024,194,190,서이천,동서울,3179,408,214,195,118,203,4317,4365,531,308,284,196,248,5932,
20221024,194,192,서이천,곤지암,993,139,94,120,130,84,1560,1338,250,102,122,90,98,2000,
20221024,196,198,진천,서청주,1228,30,80,38,27,88,1491,1062,27,75,24,39,70,1297,
20221024,198,113,서청주,신탄진,896,32,16,34,15,61,1054,811,32,33,46,34,66,1022,
20221024,198,115,서청주,대전,920,16,4,6,2,66,1014,1001,18,3,8,3,68,1101,
20221024,198,190,서청주,동서울,886,17,43,29,23,46,1044,1089,21,52,26,34,34,1256,
20221024,198,196,서청주,진천,1062,27,75,24,39,70,1297,1228,30,80,38,27,88,1491,
20221024,201,203,칠곡,가산,796,32,27,34,120,48,1057,857,36,40,34,158,42,1167,
20221024,203,127,가산,서대구,1947,39,61,33,132,98,2310,2125,55,76,52,95,98,2501,
20221024,203,201,가산,칠곡,857,36,40,34,158,42,1167,796,32,27,34,120,48,1057,
20221024,203,775,가산,동명동호,1662,40,43,47,276,75,2143,1526,54,41,46,187,57,1911,
20221024,212,102,북수원,동수원,4760,41,241,75,20,279,5416,4224,26,228,70,29,235,4812,
20221024,212,172,북수원,용인,1123,58,26,21,10,78,1316,941,39,22,19,14,62,1097,
20221024,212,173,북수원,양지,1317,99,58,59,28,67,1628,1171,77,36,42,21,67,1414,
20221024,212,253,북수원,서서울,2716,48,20,9,13,179,2985,954,28,7,7,7,57,1060,
20221024,212,254,북수원,군자,1799,35,31,14,33,102,2014,1067,25,19,12,23,71,1217,
20221024,213,102,부곡,동수원,1017,13,17,3,21,75,1146,1061,18,14,3,20,73,1189,
20221024,213,253,부곡,서서울,1538,78,41,20,173,103,1953,1024,59,26,34,132,63,1338,
20221024,213,254,부곡,군자,1016,30,19,28,450,62,1605,818,36,20,35,409,55,1373,
20221024,214,102,동군포,동수원,1573,24,10,15,4,106,1732,1419,26,18,13,6,81,1563,
20221024,215,102,군포,동수원,2198,26,40,12,8,138,2422,1562,20,23,7,13,98,1723,
20221024,215,253,군포,서서울,3133,96,76,44,51,225,3625,3899,128,144,157,102,256,4686,
20221024,215,254,군포,군자,2087,50,53,30,91,137,2448,2917,124,83,129,167,195,3615,
20221024,215,255,군포,서안산,1247,42,27,22,15,86,1439,1462,78,57,91,89,116,1893,
20221024,216,174,횡성,춘천,1113,47,38,17,22,73,1310,1110,50,32,19,39,85,1335,
20221024,218,174,남원주,춘천,1103,17,62,9,9,70,1270,1172,20,65,11,13,78,1359,
20221024,218,240,남원주,제천,2133,43,47,28,60,151,2462,2017,56,44,29,44,142,2332,
20221024,225,291,서진주,사천,976,23,16,9,27,62,1113,1009,19,23,10,26,62,1149,
20221024,229,108,북천안,천안,3838,83,136,77,52,235,4421,3502,98,114,52,30,213,4009,
20221024,230,127,팔공산,서대구,1053,31,23,15,7,71,1200,1396,52,35,13,6,98,1600,
20221024,230,131,팔공산,경산,1467,77,53,67,26,91,1781,1237,86,35,27,20,76,1481,
20221024,230,524,팔공산,청통와촌,1177,37,43,9,8,61,1335,994,37,34,5,24,48,1142,
20221024,230,527,팔공산,포항,1626,24,13,7,18,72,1760,1264,26,16,6,22,56,1390,
20221024,231,519,화원옥포,남대구,6377,153,111,103,196,482,7422,6084,144,93,97,77,465,6960,
20221024,232,519,달성,남대구,2731,107,131,44,37,178,3228,2967,123,142,50,32,183,3497,
20221024,233,519,현풍,남대구,4818,205,179,75,125,329,5731,4571,196,204,102,111,311,5495,
20221024,238,239,칠서,칠원,1477,103,111,133,278,101,2203,1740,106,107,123,343,102,2521,
20221024,239,238,칠원,칠서,1740,106,107,123,343,102,2521,1477,103,111,133,278,101,2203,
20221024,239,519,칠원,남대구,1108,42,86,29,89,56,1410,1186,44,94,34,74,43,1475,
20221024,240,218,제천,남원주,2017,56,44,29,44,142,2332,2133,43,47,28,60,151,2462,
20221024,241,519,동고령,남대구,3173,105,84,388,126,150,4026,3205,101,99,376,132,158,4071,
20221024,242,519,고령,남대구,1724,29,38,26,171,79,2067,1801,32,46,20,164,83,2146,
20221024,244,146,서부산,동창원,1353,31,31,21,43,105,1584,1276,31,32,21,29,85,1474,
20221024,244,147,서부산,진례,1938,104,77,58,84,105,2366,1741,97,88,44,84,105,2159,
20221024,244,245,서부산,장유,12881,249,368,182,318,957,14955,12224,219,339,178,344,926,14230,
20221024,244,289,서부산,마산,3164,54,246,41,55,148,3708,2555,52,209,53,46,140,3055,
20221024,245,146,장유,동창원,988,18,17,6,8,90,1127,890,15,10,11,7,104,1037,
20221024,245,147,장유,진례,1415,59,96,87,17,124,1798,1076,66,100,95,18,86,1441,
20221024,245,150,장유,북부산,3115,32,75,8,30,208,3468,3707,32,79,12,35,282,4147,
20221024,245,244,장유,서부산,12224,219,339,178,344,926,14230,12881,249,368,182,318,957,14955,
20221024,245,289,장유,마산,1538,30,45,21,18,125,1777,1239,22,38,18,11,98,1426,
20221024,248,261,순창,동광주,1166,19,18,2,16,37,1258,1382,19,30,12,12,58,1513,
20221024,250,140,남양산,부산,7744,122,204,66,56,639,8831,7754,147,230,65,48,628,8872,
20221024,250,149,남양산,동김해,898,17,48,6,6,79,1054,1045,25,52,9,5,84,1220,
20221024,250,252,남양산,대동,3337,146,116,121,123,240,4083,4016,155,121,83,126,306,4807,
20221024,251,140,물금,부산,959,95,38,18,58,68,1236,1086,116,34,26,51,79,1392,
20221024,251,148,물금,서김해,855,32,26,25,17,82,1037,887,38,18,31,10,92,1076,
20221024,251,149,물금,동김해,1068,35,18,8,6,114,1249,1153,39,18,7,3,112,1332,
20221024,251,252,물금,대동,3132,208,107,132,440,257,4276,3829,201,76,126,595,307,5134,
20221024,252,135,대동,경주,1251,40,78,59,124,61,1613,995,27,75,49,166,53,1365,
20221024,252,138,대동,양산,3078,320,194,199,280,151,4222,2593,321,197,182,286,129,3708,
20221024,252,139,대동,서울산,858,32,33,27,41,53,1044,858,50,46,32,51,43,1080,
20221024,252,140,대동,부산,1451,47,47,31,108,97,1781,1776,43,61,57,56,104,2097,
20221024,252,250,대동,남양산,4016,155,121,83,126,306,4807,3337,146,116,121,123,240,4083,
20221024,252,251,대동,물금,3829,201,76,126,595,307,5134,3132,208,107,132,440,257,4276,
20221024,252,641,대동,울산,1744,77,90,25,51,124,2111,1392,64,104,25,58,73,1716,
20221024,252,752,대동,기장철마,1778,65,38,46,140,139,2206,1829,57,57,36,76,148,2203,
20221024,252,753,대동,금정,1833,84,99,81,177,111,2385,1058,59,63,61,83,62,1386,
20221024,252,755,대동,광재,2413,101,91,135,324,142,3206,2300,101,76,138,480,140,3235,
20221024,252,756,대동,한림,874,40,41,24,93,41,1113,946,45,41,29,116,38,1215,
20221024,253,102,서서울,동수원,5134,50,62,12,26,329,5613,5677,59,59,17,12,307,6131,
20221024,253,103,서서울,수원신갈,2057,126,74,74,28,110,2469,1962,136,83,65,27,121,2394,
20221024,253,105,서서울,기흥,998,18,13,6,10,63,1108,924,19,9,11,14,69,1046,
20221024,253,172,서서울,용인,1064,63,20,26,16,66,1255,1074,50,22,23,19,65,1253,
20221024,253,173,서서울,양지,938,125,62,100,37,61,1323,1159,129,69,84,50,54,1545,
20221024,253,212,서서울,북수원,954,28,7,7,7,57,1060,2716,48,20,9,13,179,2985,
20221024,253,213,서서울,부곡,1024,59,26,34,132,63,1338,1538,78,41,20,173,103,1953,
20221024,253,215,서서울,군포,3899,128,144,157,102,256,4686,3133,96,76,44,51,225,3625,
20221024,253,255,서서울,서안산,15345,477,253,282,287,879,17523,14454,475,208,230,264,890,16521,
20221024,253,256,서서울,안산,9068,185,97,48,26,654,10078,6010,124,67,29,56,405,6691,
20221024,253,281,서서울,매송,4035,60,35,23,33,231,4417,3312,69,38,24,70,203,3716,
20221024,253,282,서서울,비봉,5813,243,179,138,352,345,7070,5175,280,203,132,352,311,6453,
20221024,253,283,서서울,발안,3469,159,99,79,102,194,4102,3299,209,116,103,125,194,4046,
20221024,253,285,서서울,서평택,1824,69,80,136,235,106,2450,1353,70,74,195,361,88,2141,
20221024,253,287,서서울,송악,2071,28,44,55,198,96,2492,1754,29,53,92,384,78,2390,
20221024,253,288,서서울,당진,1434,22,42,24,25,63,1610,1321,28,37,46,64,62,1558,
20221024,253,298,서서울,서산,2324,31,59,33,27,94,2568,2477,27,37,55,34,92,2722,
20221024,253,520,서서울,평택,2638,108,84,162,131,107,3230,2323,138,116,161,122,91,2951,
20221024,253,540,서서울,청북,934,43,46,74,42,53,1192,882,63,51,57,77,39,1169,
20221024,253,741,서서울,평택고덕,1450,18,15,29,10,111,1633,947,27,29,29,11,53,1096,
20221024,254,102,군자,동수원,4146,65,71,28,38,244,4592,3913,50,70,19,25,205,4282,
20221024,254,103,군자,수원신갈,1749,128,79,112,130,103,2301,1526,118,57,70,82,84,1937,
20221024,254,173,군자,양지,764,102,97,137,205,44,1349,700,99,84,165,201,25,1274,
20221024,254,212,군자,북수원,1067,25,19,12,23,71,1217,1799,35,31,14,33,102,2014,
20221024,254,213,군자,부곡,818,36,20,35,409,55,1373,1016,30,19,28,450,62,1605,
20221024,254,215,군자,군포,2917,124,83,129,167,195,3615,2087,50,53,30,91,137,2448,
20221024,254,255,군자,서안산,10379,415,237,210,349,732,12322,9449,386,177,174,293,688,11167,
20221024,254,256,군자,안산,4672,130,114,35,59,370,5380,5092,115,125,51,68,387,5838,
20221024,254,281,군자,매송,1213,44,14,25,85,71,1452,863,24,16,12,63,53,1031,
20221024,254,282,군자,비봉,1390,129,95,87,188,109,1998,1021,108,62,69,151,76,1487,
20221024,254,283,군자,발안,1198,73,72,58,137,68,1606,975,81,56,54,104,47,1317,
20221024,255,102,서안산,동수원,1959,34,18,13,4,122,2150,1810,36,18,10,4,104,1982,
20221024,255,215,서안산,군포,1462,78,57,91,89,116,1893,1247,42,27,22,15,86,1439,
20221024,255,253,서안산,서서울,14454,475,208,230,264,890,16521,15345,477,253,282,287,879,17523,
20221024,255,254,서안산,군자,9449,386,177,174,293,688,11167,10379,415,237,210,349,732,12322,
20221024,256,253,안산,서서울,6010,124,67,29,56,405,6691,9068,185,97,48,26,654,10078,
20221024,256,254,안산,군자,5092,115,125,51,68,387,5838,4672,130,114,35,59,370,5380,
20221024,261,248,동광주,순창,1382,19,30,12,12,58,1513,1166,19,18,2,16,37,1258,
20221024,261,262,동광주,창평,1495,79,20,20,73,61,1748,1498,54,14,21,75,47,1709,
20221024,262,261,창평,동광주,1498,54,14,21,75,47,1709,1495,79,20,20,73,61,1748,
20221024,271,569,순천,북광주,963,75,25,26,106,30,1225,916,66,37,28,97,24,1168,
20221024,281,253,매송,서서울,3312,69,38,24,70,203,3716,4035,60,35,23,33,231,4417,
20221024,281,254,매송,군자,863,24,16,12,63,53,1031,1213,44,14,25,85,71,1452,
20221024,282,253,비봉,서서울,5175,280,203,132,352,311,6453,5813,243,179,138,352,345,7070,
20221024,282,254,비봉,군자,1021,108,62,69,151,76,1487,1390,129,95,87,188,109,1998,
20221024,283,253,발안,서서울,3299,209,116,103,125,194,4046,3469,159,99,79,102,194,4102,
20221024,283,254,발안,군자,975,81,56,54,104,47,1317,1198,73,72,58,137,68,1606,
20221024,285,253,서평택,서서울,1353,70,74,195,361,88,2141,1824,69,80,136,235,106,2450,
20221024,285,287,서평택,송악,640,29,67,47,588,39,1410,640,35,57,42,519,47,1340,
20221024,287,253,송악,서서울,1754,29,53,92,384,78,2390,2071,28,44,55,198,96,2492,
20221024,287,285,송악,서평택,640,35,57,42,519,47,1340,640,29,67,47,588,39,1410,
20221024,288,253,당진,서서울,1321,28,37,46,64,62,1558,1434,22,42,24,25,63,1610,
20221024,289,146,마산,동창원,2390,83,70,26,40,202,2811,2643,94,67,41,81,230,3156,
20221024,289,147,마산,진례,1340,87,82,48,89,86,1732,1296,98,83,49,107,84,1717,
20221024,289,148,마산,서김해,1351,23,50,10,9,100,1543,1451,30,52,14,6,96,1649,
20221024,289,150,마산,북부산,2505,33,71,7,20,149,2785,2741,27,87,8,29,145,3037,
20221024,289,244,마산,서부산,2555,52,209,53,46,140,3055,3164,54,246,41,55,148,3708,
20221024,289,245,마산,장유,1239,22,38,18,11,98,1426,1538,30,45,21,18,125,1777,
20221024,289,757,마산,진영,745,39,48,45,88,40,1005,811,56,56,36,83,44,1086,
20221024,291,145,사천,산인,1305,50,49,23,24,53,1504,1360,31,48,18,18,51,1526,
20221024,291,225,사천,서진주,1009,19,23,10,26,62,1149,976,23,16,9,27,62,1113,
20221024,291,292,사천,진주,2712,71,77,41,76,250,3227,3453,97,107,51,63,295,4066,
20221024,292,145,진주,산인,1589,25,141,19,18,98,1890,1399,32,146,19,21,65,1682,
20221024,292,291,진주,사천,3453,97,107,51,63,295,4066,2712,71,77,41,76,250,3227,
20221024,293,145,문산,산인,1088,27,26,17,14,72,1244,1248,32,21,12,6,78,1397,
20221024,298,253,서산,서서울,2477,27,37,55,34,92,2722,2324,31,59,33,27,94,2568,
20221024,508,509,무안,목포,1430,54,43,32,72,64,1695,1705,48,41,29,73,88,1984,
20221024,508,553,무안,동광산,1502,33,40,18,25,62,1680,1710,30,46,24,25,64,1899,
20221024,509,508,목포,무안,1705,48,41,29,73,88,1984,1430,54,43,32,72,64,1695,
20221024,509,553,목포,동광산,6678,188,183,139,237,244,7669,7467,168,190,122,215,260,8422,
20221024,513,515,고성,북통영,1281,35,71,15,25,98,1525,1720,41,70,24,34,108,1997,
20221024,513,516,고성,통영,3055,68,115,92,171,232,3733,3074,73,128,89,161,242,3767,
20221024,514,516,동고성,통영,1153,24,53,51,146,158,1585,1178,17,68,66,155,167,1651,
20221024,515,513,북통영,고성,1720,41,70,24,34,108,1997,1281,35,71,15,25,98,1525,
20221024,516,513,통영,고성,3074,73,128,89,161,242,3767,3055,68,115,92,171,232,3733,
20221024,516,514,통영,동고성,1178,17,68,66,155,167,1651,1153,24,53,51,146,158,1585,
20221024,519,231,남대구,화원옥포,6084,144,93,97,77,465,6960,6377,153,111,103,196,482,7422,
20221024,519,232,남대구,달성,2967,123,142,50,32,183,3497,2731,107,131,44,37,178,3228,
20221024,519,233,남대구,현풍,4571,196,204,102,111,311,5495,4818,205,179,75,125,329,5731,
20221024,519,239,남대구,칠원,1186,44,94,34,74,43,1475,1108,42,86,29,89,56,1410,
20221024,519,241,남대구,동고령,3205,101,99,376,132,158,4071,3173,105,84,388,126,150,4026,
20221024,519,242,남대구,고령,1801,32,46,20,164,83,2146,1724,29,38,26,171,79,2067,
20221024,519,730,남대구,유천,2288,48,14,1,15,149,2515,2800,54,8,1,0,183,3046,
20221024,519,731,남대구,북현풍,1997,26,28,1,4,130,2186,1496,25,6,0,0,114,1641,
20221024,520,253,평택,서서울,2323,138,116,161,122,91,2951,2638,108,84,162,131,107,3230,
20221024,520,540,평택,청북,1015,76,113,137,103,58,1502,795,90,128,111,85,41,1250,
20221024,520,741,평택,평택고덕,1001,9,197,20,19,83,1329,753,14,151,19,26,76,1039,
20221024,524,129,청통와촌,북대구,1124,66,26,23,26,54,1319,944,44,30,12,18,49,1097,
20221024,524,230,청통와촌,팔공산,994,37,34,5,24,48,1142,1177,37,43,9,8,61,1335,
20221024,526,527,서포항,포항,886,11,17,9,18,70,1011,1016,15,17,5,17,73,1143,
20221024,527,129,포항,북대구,1857,38,34,17,80,90,2116,1589,25,26,18,60,69,1787,
20221024,527,230,포항,팔공산,1264,26,16,6,22,56,1390,1626,24,13,7,18,72,1760,
20221024,527,526,포항,서포항,1016,15,17,5,17,73,1143,886,11,17,9,18,70,1011,
20221024,528,101,기흥동탄,서울,7118,55,1284,128,15,361,8961,7067,72,1148,126,10,368,8791,
20221024,528,103,기흥동탄,수원신갈,2083,19,157,4,2,116,2381,1390,13,194,4,1,87,1689,
20221024,528,107,기흥동탄,안성,1171,19,20,3,13,89,1315,997,8,15,6,4,92,1122,
20221024,528,108,기흥동탄,천안,1095,20,115,0,16,74,1320,1071,11,115,4,13,70,1284,
20221024,540,253,청북,서서울,882,63,51,57,77,39,1169,934,43,46,74,42,53,1192,
20221024,540,520,청북,평택,795,90,128,111,85,41,1250,1015,76,113,137,103,58,1502,
20221024,540,741,청북,평택고덕,902,27,40,56,100,75,1200,921,24,38,61,106,87,1237,
20221024,542,101,서안성,서울,1698,43,71,123,35,80,2050,1349,31,84,82,18,72,1636,
20221024,542,543,서안성,남안성,1064,38,86,99,96,81,1464,1133,47,83,102,70,89,1524,
20221024,543,101,남안성,서울,1251,83,76,91,88,59,1648,1272,70,58,50,56,42,1548,
20221024,543,542,남안성,서안성,1133,47,83,102,70,89,1524,1064,38,86,99,96,81,1464,
20221024,543,555,남안성,북진천,829,106,179,184,153,44,1495,815,117,170,162,152,54,1470,
20221024,548,553,북무안,동광산,1276,32,26,19,81,38,1472,1532,33,26,33,113,58,1795,
20221024,549,553,동함평,동광산,3682,44,68,34,50,114,3992,3753,59,78,35,44,124,4093,
20221024,551,553,나주,동광산,1339,16,29,73,57,77,1591,1328,21,36,67,47,77,1576,
20221024,552,553,서광산,동광산,4348,174,164,195,168,164,5213,5942,185,173,195,162,212,6869,
20221024,553,508,동광산,무안,1710,30,46,24,25,64,1899,1502,33,40,18,25,62,1680,
20221024,553,509,동광산,목포,7467,168,190,122,215,260,8422,6678,188,183,139,237,244,7669,
20221024,553,548,동광산,북무안,1532,33,26,33,113,58,1795,1276,32,26,19,81,38,1472,
20221024,553,549,동광산,동함평,3753,59,78,35,44,124,4093,3682,44,68,34,50,114,3992,
20221024,553,551,동광산,나주,1328,21,36,67,47,77,1576,1339,16,29,73,57,77,1591,
20221024,553,552,동광산,서광산,5942,185,173,195,162,212,6869,4348,174,164,195,168,164,5213,
20221024,554,174,동홍천,춘천,956,12,18,3,6,77,1072,1206,14,23,11,12,101,1367,
20221024,555,543,북진천,남안성,815,117,170,162,152,54,1470,829,106,179,184,153,44,1495,
20221024,560,190,감곡,동서울,936,33,29,31,92,30,1151,972,16,30,36,98,30,1182,
20221024,567,167,남고창,광주,1286,34,53,9,35,41,1458,1259,33,53,9,32,46,1432,
20221024,569,271,북광주,순천,916,66,37,28,97,24,1168,963,75,25,26,106,30,1225,
20221024,579,115,남세종,대전,1119,10,22,8,15,92,1266,1021,12,24,8,15,84,1164,
20221024,579,153,남세종,서대전,1062,23,19,8,16,80,1208,1213,16,11,8,16,84,1348,
20221024,587,589,오수,상관,1074,13,42,29,41,47,1246,1275,27,50,15,112,46,1525,
20221024,589,587,상관,오수,1275,27,50,15,112,46,1525,1074,13,42,29,41,47,1246,
20221024,597,598,서여주,북여주,971,36,115,34,54,46,1256,999,30,66,43,51,50,1239,
20221024,598,597,북여주,서여주,999,30,66,43,51,50,1239,971,36,115,34,54,46,1256,
20221024,621,127,동대구,서대구,1315,40,30,28,22,102,1537,1775,56,78,34,33,125,2101,
20221024,621,131,동대구,경산,2384,73,43,212,46,129,2887,2231,68,35,246,77,130,2787,
20221024,621,132,동대구,영천,1224,13,23,4,37,49,1350,1151,11,22,6,34,39,1263,
20221024,625,626,밀양,남밀양,1198,58,48,49,92,53,1498,1217,56,52,48,104,60,1537,
20221024,626,625,남밀양,밀양,1217,56,52,48,104,60,1537,1198,58,48,49,92,53,1498,
20221024,626,627,남밀양,삼랑진,1020,17,34,15,64,128,1278,1026,27,21,24,68,103,1269,
20221024,627,626,삼랑진,남밀양,1026,27,21,24,68,103,1269,1020,17,34,15,64,128,1278,
20221024,641,139,울산,서울산,1075,20,51,12,30,68,1256,1088,38,69,24,38,83,1340,
20221024,641,252,울산,대동,1392,64,104,25,58,73,1716,1744,77,90,25,51,124,2111,
20221024,641,643,울산,청량,1132,20,10,9,56,104,1331,1253,14,14,11,32,132,1456,
20221024,641,648,울산,해운대,941,5,20,0,11,57,1034,1174,10,23,1,7,66,1281,
20221024,641,706,울산,남경주,1081,8,21,12,38,49,1209,1097,7,21,16,36,55,1232,
20221024,641,707,울산,남포항,1155,12,27,18,123,56,1391,1100,17,32,32,142,53,1376,
20221024,643,641,청량,울산,1253,14,14,11,32,132,1456,1132,20,10,9,56,104,1331,
20221024,643,648,청량,해운대,2847,19,46,18,97,190,3217,3584,43,70,46,568,225,4536,
20221024,645,648,장안,해운대,1586,10,19,1,9,97,1722,2926,22,25,89,89,189,3340,
20221024,646,648,기장일광,해운대,4599,21,31,42,57,273,5023,5481,37,27,20,211,325,6101,
20221024,648,641,해운대,울산,1174,10,23,1,7,66,1281,941,5,20,0,11,57,1034,
20221024,648,643,해운대,청량,3584,43,70,46,568,225,4536,2847,19,46,18,97,190,3217,
20221024,648,645,해운대,장안,2926,22,25,89,89,189,3340,1586,10,19,1,9,97,1722,
20221024,648,646,해운대,기장일광,5481,37,27,20,211,325,6101,4599,21,31,42,57,273,5023,
20221024,651,652,남양주,화도,13706,509,486,430,226,1046,16403,16305,599,565,503,229,1242,19443,
20221024,651,653,남양주,서종,1802,15,11,1,26,84,1939,1928,19,10,6,8,74,2045,
20221024,651,654,남양주,설악,3912,42,72,15,14,153,4208,3896,27,62,16,16,150,4167,
20221024,651,655,남양주,강촌,2353,36,109,31,34,80,2643,2574,27,104,31,26,95,2857,
20221024,651,656,남양주,남춘천,2784,30,51,30,56,97,3048,2429,19,33,14,56,76,2627,
20221024,652,651,화도,남양주,16305,599,565,503,229,1242,19443,13706,509,486,430,226,1046,16403,
20221024,652,653,화도,서종,1476,34,24,25,14,101,1674,1542,29,31,22,17,121,1762,
20221024,652,654,화도,설악,1282,20,11,4,16,93,1426,1378,16,15,8,13,85,1515,
20221024,653,651,서종,남양주,1928,19,10,6,8,74,2045,1802,15,11,1,26,84,1939,
20221024,653,652,서종,화도,1542,29,31,22,17,121,1762,1476,34,24,25,14,101,1674,
20221024,654,651,설악,남양주,3896,27,62,16,16,150,4167,3912,42,72,15,14,153,4208,
20221024,654,652,설악,화도,1378,16,15,8,13,85,1515,1282,20,11,4,16,93,1426,
20221024,655,651,강촌,남양주,2574,27,104,31,26,95,2857,2353,36,109,31,34,80,2643,
20221024,656,651,남춘천,남양주,2429,19,33,14,56,76,2627,2784,30,51,30,56,97,3048,
20221024,671,672,봉담,정남,3310,164,78,75,136,230,3993,3843,146,80,78,199,269,4615,
20221024,671,673,봉담,북오산,1914,48,39,22,12,138,2173,1828,46,37,21,23,134,2089,
20221024,671,676,봉담,향남,1315,93,52,38,64,98,1660,1182,103,41,23,64,73,1486,
20221024,671,677,봉담,북평택,8402,174,226,140,297,479,9718,7364,187,197,124,194,433,8499,
20221024,672,671,정남,봉담,3843,146,80,78,199,269,4615,3310,164,78,75,136,230,3993,
20221024,673,101,북오산,서울,1503,46,121,22,14,95,1801,1614,42,116,25,6,107,1910,
20221024,673,671,북오산,봉담,1828,46,37,21,23,134,2089,1914,48,39,22,12,138,2173,
20221024,673,677,북오산,북평택,1886,40,80,32,29,130,2197,1957,40,60,28,14,130,2229,
20221024,675,676,서오산,향남,3413,121,79,55,229,215,4112,3066,85,54,43,228,208,3684,
20221024,675,677,서오산,북평택,12656,226,398,159,204,797,14440,10905,217,368,178,166,676,12510,
20221024,675,876,서오산,양감,1816,64,44,54,137,120,2235,2085,58,31,35,107,157,2473,
20221024,676,671,향남,봉담,1182,103,41,23,64,73,1486,1315,93,52,38,64,98,1660,
20221024,676,675,향남,서오산,3066,85,54,43,228,208,3684,3413,121,79,55,229,215,4112,
20221024,676,677,향남,북평택,1836,183,171,207,111,107,2615,1531,144,135,198,130,91,2229,
20221024,677,101,북평택,서울,1624,61,250,88,126,93,2242,2291,64,263,87,100,97,2902,
20221024,677,671,북평택,봉담,7364,187,197,124,194,433,8499,8402,174,226,140,297,479,9718,
20221024,677,673,북평택,북오산,1957,40,60,28,14,130,2229,1886,40,80,32,29,130,2197,
20221024,677,675,북평택,서오산,10905,217,368,178,166,676,12510,12656,226,398,159,204,797,14440,
20221024,677,676,북평택,향남,1531,144,135,198,130,91,2229,1836,183,171,207,111,107,2615,
20221024,677,876,북평택,양감,2297,148,181,204,145,150,3125,2067,157,169,206,155,142,2896,
20221024,682,683,조암,송산마도,841,81,102,56,53,43,1176,966,101,95,72,63,45,1342,
20221024,682,684,조암,남안산,1033,121,158,88,88,39,1527,1165,126,128,85,90,39,1633,
20221024,682,685,조암,서시흥,1825,183,153,146,250,95,2652,2113,161,156,150,304,116,3000,
20221024,683,682,송산마도,조암,966,101,95,72,63,45,1342,841,81,102,56,53,43,1176,
20221024,683,684,송산마도,남안산,2599,190,144,100,242,135,3410,2227,178,111,77,156,132,2881,
20221024,683,685,송산마도,서시흥,5085,257,240,177,790,274,6823,4560,240,236,203,771,257,6267,
20221024,684,682,남안산,조암,1165,126,128,85,90,39,1633,1033,121,158,88,88,39,1527,
20221024,684,683,남안산,송산마도,2227,178,111,77,156,132,2881,2599,190,144,100,242,135,3410,
20221024,684,685,남안산,서시흥,5530,482,298,418,579,429,7736,4086,346,299,341,421,340,5833,
20221024,685,682,서시흥,조암,2113,161,156,150,304,116,3000,1825,183,153,146,250,95,2652,
20221024,685,683,서시흥,송산마도,4560,240,236,203,771,257,6267,5085,257,240,177,790,274,6823,
20221024,685,684,서시흥,남안산,4086,346,299,341,421,340,5833,5530,482,298,418,579,429,7736,
20221024,705,190,남이천,동서울,1372,85,54,85,72,56,1724,1517,90,56,119,109,42,1933,
20221024,706,641,남경주,울산,1097,7,21,16,36,55,1232,1081,8,21,12,38,49,1209,
20221024,706,707,남경주,남포항,994,32,74,34,193,56,1383,1056,31,70,33,182,62,1434,
20221024,707,641,남포항,울산,1100,17,32,32,142,53,1376,1155,12,27,18,123,56,1391,
20221024,707,706,남포항,남경주,1056,31,70,33,182,62,1434,994,32,74,34,193,56,1383,
20221024,707,708,남포항,동경주,1390,29,24,27,238,75,1783,1363,23,31,23,300,85,1825,
20221024,708,707,동경주,남포항,1363,23,31,23,300,85,1825,1390,29,24,27,238,75,1783,
20221024,715,716,동안동,청송,1232,17,21,10,45,55,1380,1171,26,14,13,44,50,1318,
20221024,716,715,청송,동안동,1171,26,14,13,44,50,1318,1232,17,21,10,45,55,1380,
20221024,730,519,유천,남대구,2800,54,8,1,0,183,3046,2288,48,14,1,15,149,2515,
20221024,731,519,북현풍,남대구,1496,25,6,0,0,114,1641,1997,26,28,1,4,130,2186,
20221024,741,253,평택고덕,서서울,947,27,29,29,11,53,1096,1450,18,15,29,10,111,1633,
20221024,741,520,평택고덕,평택,753,14,151,19,26,76,1039,1001,9,197,20,19,83,1329,
20221024,741,540,평택고덕,청북,921,24,38,61,106,87,1237,902,27,40,56,100,75,1200,
20221024,742,107,남사진위,안성,1402,40,54,28,9,121,1654,1186,34,48,30,2,102,1402,
20221024,742,108,남사진위,천안,1189,25,43,23,8,61,1349,1054,19,39,21,5,66,1204,
20221024,752,252,기장철마,대동,1829,57,57,36,76,148,2203,1778,65,38,46,140,139,2206,
20221024,753,252,금정,대동,1058,59,63,61,83,62,1386,1833,84,99,81,177,111,2385,
20221024,755,140,광재,부산,977,10,11,5,38,48,1089,1119,12,13,8,44,64,1260,
20221024,755,252,광재,대동,2300,101,76,138,480,140,3235,2413,101,91,135,324,142,3206,
20221024,756,252,한림,대동,946,45,41,29,116,38,1215,874,40,41,24,93,41,1113,
20221024,757,289,진영,마산,811,56,56,36,83,44,1086,745,39,48,45,88,40,1005,
20221024,772,774,북달성,남칠곡,2489,54,41,35,35,138,2792,2571,47,62,39,30,154,2903,
20221024,773,774,북다사,남칠곡,1383,17,18,11,20,91,1540,1293,20,17,11,12,85,1438,
20221024,774,772,남칠곡,북달성,2571,47,62,39,30,154,2903,2489,54,41,35,35,138,2792,
20221024,774,773,남칠곡,북다사,1293,20,17,11,12,85,1438,1383,17,18,11,20,91,1540,
20221024,775,203,동명동호,가산,1526,54,41,46,187,57,1911,1662,40,43,47,276,75,2143,
20221024,776,777,연경,파군재,3341,36,32,11,13,220,3653,2475,33,36,15,18,159,2736,
20221024,776,779,연경,율암,5788,85,68,59,188,421,6609,6116,109,79,75,191,426,6996,
20221024,777,776,파군재,연경,2475,33,36,15,18,159,2736,3341,36,32,11,13,220,3653,
20221024,777,779,파군재,율암,2431,16,28,8,2,226,2711,2392,17,23,3,10,234,2679,
20221024,779,776,율암,연경,6116,109,79,75,191,426,6996,5788,85,68,59,188,421,6609,
20221024,779,777,율암,파군재,2392,17,23,3,10,234,2679,2431,16,28,8,2,226,2711,
20221024,876,675,양감,서오산,2085,58,31,35,107,157,2473,1816,64,44,54,137,120,2235,
20221024,876,677,양감,북평택,2067,157,169,206,155,142,2896,2297,148,181,204,145,150,3125,
20221024,981,982,서영암,강진무위사,1875,53,66,47,45,93,2179,1875,44,54,68,49,75,2165,
20221024,981,987,서영암,남순천,1606,24,55,61,337,38,2121,1934,27,82,77,355,57,2532,
20221024,982,981,강진무위사,서영암,1875,44,54,68,49,75,2165,1875,53,66,47,45,93,2179,
20221024,984,985,보성,벌교,1579,33,53,41,56,39,1801,1431,39,62,31,43,33,1639,
20221024,984,987,보성,남순천,1889,30,80,67,338,54,2458,2096,33,70,43,292,62,2596,
20221024,985,984,벌교,보성,1431,39,62,31,43,33,1639,1579,33,53,41,56,39,1801,
20221024,986,987,고흥,남순천,3518,78,112,137,227,131,4203,3999,86,107,131,221,151,4695,
20221024,987,981,남순천,서영암,1934,27,82,77,355,57,2532,1606,24,55,61,337,38,2121,
20221024,987,984,남순천,보성,2096,33,70,43,292,62,2596,1889,30,80,67,338,54,2458,
20221024,987,986,남순천,고흥,3999,86,107,131,221,151,4695,3518,78,112,137,227,131,4203,
20221025,101,102,서울,동수원,3599,58,257,11,4,200,4129,4995,55,377,27,11,289,5754,
20221025,101,103,서울,수원신갈,15502,671,1701,420,139,789,19222,13950,668,1716,382,102,669,17487,
20221025,101,105,서울,기흥,7131,97,378,84,29,344,8063,5830,113,348,85,30,284,6690,
20221025,101,106,서울,오산,4053,354,411,159,94,251,5322,4233,407,451,187,94,254,5626,
20221025,101,107,서울,안성,3130,96,319,46,12,171,3774,2736,79,303,49,29,153,3349,
20221025,101,108,서울,천안,3508,66,351,48,16,167,4156,3429,58,343,54,25,135,4044,
20221025,101,111,서울,청주,853,14,181,20,21,32,1121,717,15,215,22,16,35,1020,
20221025,101,171,서울,마성,2272,19,226,57,5,101,2680,2550,20,259,57,2,128,3016,
20221025,101,172,서울,용인,3459,156,127,43,23,240,4048,3791,168,129,49,19,259,4415,
20221025,101,173,서울,양지,3295,209,122,114,69,137,3946,4209,385,146,168,112,182,5202,
20221025,101,175,서울,덕평,803,59,75,38,58,36,1069,822,116,91,34,55,40,1158,
20221025,101,229,서울,북천안,802,49,45,52,22,32,1002,852,56,39,53,21,46,1067,
20221025,101,528,서울,기흥동탄,7165,84,1184,131,10,349,8923,7156,69,1298,131,9,332,8995,
20221025,101,542,서울,서안성,1147,45,75,104,20,57,1448,1697,43,75,168,62,85,2130,
20221025,101,543,서울,남안성,1113,58,61,63,47,42,1384,1212,86,80,86,74,55,1593,
20221025,101,673,서울,북오산,1479,41,111,25,12,91,1759,1485,35,107,26,18,92,1763,
20221025,101,677,서울,북평택,1580,54,257,93,107,66,2157,1246,53,264,84,127,66,1840,
20221025,102,101,동수원,서울,4995,55,377,27,11,289,5754,3599,58,257,11,4,200,4129,
20221025,102,172,동수원,용인,1074,20,23,1,2,90,1210,972,29,17,1,1,100,1120,
20221025,102,173,동수원,양지,1181,49,28,14,18,55,1345,1387,45,44,18,7,81,1582,
20221025,102,212,동수원,북수원,4323,26,225,20,51,269,4914,4653,41,224,39,23,297,5277,
20221025,102,213,동수원,부곡,1102,22,12,11,28,82,1257,1037,17,18,2,24,89,1187,
20221025,102,214,동수원,동군포,1507,30,20,16,10,106,1689,1524,28,21,10,4,103,1690,
20221025,102,215,동수원,군포,1636,20,28,4,23,111,1822,2334,8,46,3,12,171,2574,
20221025,102,253,동수원,서서울,5758,67,73,23,20,346,6287,5254,61,65,23,20,339,5762,
20221025,102,254,동수원,군자,3896,52,70,18,42,196,4274,4094,57,73,30,54,241,4549,
20221025,102,255,동수원,서안산,1767,38,21,9,6,96,1937,1987,46,21,13,6,114,2187,
20221025,103,101,수원신갈,서울,13950,668,1716,382,102,669,17487,15502,671,1701,420,139,789,19222,
20221025,103,105,수원신갈,기흥,1542,30,62,38,36,109,1817,2131,31,37,24,36,151,2410,
20221025,103,106,수원신갈,오산,956,61,51,37,15,63,1183,1341,73,65,61,9,94,1643,
20221025,103,253,수원신갈,서서울,1930,143,83,70,28,113,2367,2175,135,108,80,36,125,2659,
20221025,103,254,수원신갈,군자,1359,99,85,79,70,80,1772,1787,131,90,129,114,103,2354,
20221025,103,528,수원신갈,기흥동탄,1467,13,211,2,6,96,1795,2151,21,160,8,3,132,2475,
20221025,105,101,기흥,서울,5830,113,348,85,30,284,6690,7131,97,378,84,29,344,8063,
20221025,105,103,기흥,수원신갈,2131,31,37,24,36,151,2410,1542,30,62,38,36,109,1817,
20221025,106,101,오산,서울,4233,407,451,187,94,254,5626,4053,354,411,159,94,251,5322,
20221025,106,103,오산,수원신갈,1341,73,65,61,9,94,1643,956,61,51,37,15,63,1183,
20221025,106,107,오산,안성,1864,48,41,30,26,147,2156,1432,43,24,14,8,139,1660,
20221025,106,108,오산,천안,1104,20,23,18,9,70,1244,1040,21,23,15,5,60,1164,
20221025,106,528,오산,기흥동탄,863,38,40,15,10,70,1036,944,31,56,15,8,82,1136,
20221025,107,101,안성,서울,2736,79,303,49,29,153,3349,3130,96,319,46,12,171,3774,
20221025,107,106,안성,오산,1432,43,24,14,8,139,1660,1864,48,41,30,26,147,2156,
20221025,107,108,안성,천안,1543,17,34,5,8,138,1745,1556,25,31,11,7,134,1764,
20221025,107,528,안성,기흥동탄,1005,24,18,3,7,87,1144,1141,24,20,4,11,88,1288,
20221025,107,742,안성,남사진위,1202,41,54,22,4,109,1432,1431,52,58,33,7,106,1687,
20221025,108,101,천안,서울,3429,58,343,54,25,135,4044,3508,66,351,48,16,167,4156,
20221025,108,106,천안,오산,1040,21,23,15,5,60,1164,1104,20,23,18,9,70,1244,
20221025,108,107,천안,안성,1556,25,31,11,7,134,1764,1543,17,34,5,8,138,1745,
20221025,108,110,천안,목천,1161,27,80,28,37,73,1406,844,24,63,21,23,59,1034,
20221025,108,111,천안,청주,1058,34,59,22,34,63,1270,1045,28,59,21,34,64,1251,
20221025,108,229,천안,북천안,3426,67,124,50,30,197,3894,3915,106,139,66,63,221,4510,
20221025,108,528,천안,기흥동탄,1058,12,102,1,13,60,1246,1096,25,123,2,14,61,1321,
20221025,108,742,천안,남사진위,1099,30,34,25,6,89,1283,1096,32,34,28,9,76,1275,
20221025,110,108,목천,천안,844,24,63,21,23,59,1034,1161,27,80,28,37,73,1406,
20221025,111,101,청주,서울,717,15,215,22,16,35,1020,853,14,181,20,21,32,1121,
20221025,111,108,청주,천안,1045,28,59,21,34,64,1251,1058,34,59,22,34,63,1270,
20221025,112,115,남청주,대전,1623,84,61,4,26,124,1922,1628,91,52,7,5,132,1915,
20221025,113,115,신탄진,대전,982,20,12,5,16,127,1162,1114,27,18,1,6,140,1306,
20221025,114,153,남대전,서대전,1890,54,59,57,66,140,2266,1730,40,80,60,62,126,2098,
20221025,115,112,대전,남청주,1628,91,52,7,5,132,1915,1623,84,61,4,26,124,1922,
20221025,115,113,대전,신탄진,1114,27,18,1,6,140,1306,982,20,12,5,16,127,1162,
20221025,115,116,대전,옥천,2368,99,50,23,34,164,2738,2124,56,49,25,32,154,2440,
20221025,115,151,대전,북대전,1126,9,12,6,3,118,1274,893,10,15,3,4,102,1027,
20221025,115,152,대전,유성,951,16,13,2,0,78,1060,977,14,20,1,3,67,1082,
20221025,115,198,대전,서청주,919,25,12,5,2,63,1026,926,18,5,5,4,67,1025,
20221025,115,579,대전,남세종,1078,14,14,7,11,100,1224,1170,20,21,6,7,103,1327,
20221025,116,115,옥천,대전,2124,56,49,25,32,154,2440,2368,99,50,23,34,164,2738,
20221025,119,153,판암,서대전,1748,22,10,102,82,152,2116,1779,26,27,105,75,160,2172,
20221025,123,127,구미,서대구,1604,37,20,23,14,88,1786,1724,43,41,24,6,89,1927,
20221025,123,129,구미,북대구,1795,20,70,9,4,100,1998,1823,21,69,4,4,101,2022,
20221025,123,130,구미,동김천,1273,17,40,55,39,78,1502,1182,27,33,37,18,84,1381,
20221025,125,127,남구미,서대구,1849,53,102,44,11,123,2182,2121,66,110,44,35,134,2510,
20221025,125,129,남구미,북대구,1834,32,73,9,8,113,2069,2066,36,78,19,10,105,2314,
20221025,126,127,왜관,서대구,2539,127,68,38,112,127,3011,2756,145,68,43,64,155,3231,
20221025,126,129,왜관,북대구,2934,84,54,29,80,134,3315,3447,104,65,28,54,169,3867,
20221025,127,123,서대구,구미,1724,43,41,24,6,89,1927,1604,37,20,23,14,88,1786,
20221025,127,125,서대구,남구미,2121,66,110,44,35,134,2510,1849,53,102,44,11,123,2182,
20221025,127,126,서대구,왜관,2756,145,68,43,64,155,3231,2539,127,68,38,112,127,3011,
20221025,127,131,서대구,경산,2518,199,137,90,74,161,3179,1809,139,104,57,66,114,2289,
20221025,127,201,서대구,칠곡,1478,27,26,9,40,91,1671,911,16,17,6,4,74,1028,
20221025,127,203,서대구,가산,2139,67,77,52,109,88,2532,1988,58,61,46,133,97,2383,
20221025,127,230,서대구,팔공산,1534,47,30,17,6,89,1723,1103,37,34,19,9,72,1274,
20221025,127,518,서대구,칠곡물류,942,128,86,102,30,52,1340,751,106,67,89,32,54,1099,
20221025,127,621,서대구,동대구,1847,47,95,28,25,120,2162,1284,45,28,34,21,93,1505,
20221025,129,123,북대구,구미,1823,21,69,4,4,101,2022,1795,20,70,9,4,100,1998,
20221025,129,125,북대구,남구미,2066,36,78,19,10,105,2314,1834,32,73,9,8,113,2069,
20221025,129,126,북대구,왜관,3447,104,65,28,54,169,3867,2934,84,54,29,80,134,3315,
20221025,129,131,북대구,경산,2387,156,82,59,33,119,2836,2991,198,121,77,46,164,3597,
20221025,129,524,북대구,청통와촌,961,46,30,11,24,56,1128,1180,79,49,19,41,61,1429,
20221025,129,527,북대구,포항,1488,29,20,27,61,85,1710,1871,53,41,30,71,91,2157,
20221025,130,123,동김천,구미,1182,27,33,37,18,84,1381,1273,17,40,55,39,78,1502,
20221025,131,127,경산,서대구,1809,139,104,57,66,114,2289,2518,199,137,90,74,161,3179,
20221025,131,129,경산,북대구,2991,198,121,77,46,164,3597,2387,156,82,59,33,119,2836,
20221025,131,132,경산,영천,897,54,45,51,53,49,1149,850,47,52,40,49,37,1075,
20221025,131,230,경산,팔공산,1258,82,43,18,11,92,1504,1508,69,44,20,24,100,1765,
20221025,131,621,경산,동대구,2311,58,42,100,54,137,2702,2454,70,51,108,36,139,2858,
20221025,132,131,영천,경산,850,47,52,40,49,37,1075,897,54,45,51,53,49,1149,
20221025,132,621,영천,동대구,1130,13,24,7,27,44,1245,1180,13,26,2,30,43,1294,
20221025,135,140,경주,부산,1161,14,42,15,61,48,1341,1216,15,41,12,55,62,1401,
20221025,135,252,경주,대동,863,37,84,55,163,44,1246,1082,49,84,43,101,53,1412,
20221025,138,140,양산,부산,5036,250,178,189,261,287,6201,5288,291,205,227,259,292,6562,
20221025,138,252,양산,대동,2698,340,189,186,349,129,3891,3007,317,184,166,324,139,4137,
20221025,139,140,서울산,부산,1307,46,26,7,16,71,1473,1248,53,23,8,15,58,1405,
20221025,139,252,서울산,대동,813,45,51,32,35,48,1024,837,34,28,34,29,39,1001,
20221025,139,641,서울산,울산,1085,39,59,21,43,92,1339,1108,25,56,15,31,64,1299,
20221025,140,135,부산,경주,1216,15,41,12,55,62,1401,1161,14,42,15,61,48,1341,
20221025,140,138,부산,양산,5288,291,205,227,259,292,6562,5036,250,178,189,261,287,6201,
20221025,140,139,부산,서울산,1248,53,23,8,15,58,1405,1307,46,26,7,16,71,1473,
20221025,140,250,부산,남양산,7957,145,214,28,34,651,9029,7667,142,212,32,59,645,8757,
20221025,140,251,부산,물금,1047,117,29,28,56,85,1362,1079,97,27,26,43,82,1354,
20221025,140,252,부산,대동,1747,47,50,45,65,89,2043,1530,39,33,37,99,81,1819,
20221025,140,286,부산,통도사휴게소,1061,9,7,0,0,44,1121,983,5,8,0,1,31,1028,
20221025,140,755,부산,광재,1115,15,18,36,24,68,1276,925,13,18,31,29,58,1074,
20221025,142,145,군북,산인,3888,69,124,43,57,291,4472,3881,72,118,54,72,285,4482,
20221025,143,145,장지,산인,1181,20,34,23,130,86,1474,1188,21,44,23,138,83,1497,
20221025,144,145,함안,산인,1905,53,41,28,64,122,2213,1905,45,39,19,56,132,2196,
20221025,145,142,산인,군북,3881,72,118,54,72,285,4482,3888,69,124,43,57,291,4472,
20221025,145,143,산인,장지,1188,21,44,23,138,83,1497,1181,20,34,23,130,86,1474,
20221025,145,144,산인,함안,1905,45,39,19,56,132,2196,1905,53,41,28,64,122,2213,
20221025,145,291,산인,사천,1116,35,61,17,18,70,1317,1326,65,63,17,20,65,1556,
20221025,145,292,산인,진주,1301,25,136,13,16,80,1571,1516,35,132,16,13,89,1801,
20221025,145,293,산인,문산,1176,27,20,17,4,73,1317,1145,23,26,14,10,81,1299,
20221025,146,150,동창원,북부산,1032,22,10,6,20,73,1163,962,20,14,2,19,77,1094,
20221025,146,244,동창원,서부산,1209,25,35,21,31,82,1403,1242,38,43,23,40,78,1464,
20221025,146,245,동창원,장유,946,10,21,44,8,93,1122,985,11,18,48,21,88,1171,
20221025,146,289,동창원,마산,2599,74,71,42,65,226,3077,2536,71,85,30,52,203,2977,
20221025,147,150,진례,북부산,1462,47,28,18,37,82,1674,1688,56,24,29,31,91,1919,
20221025,147,244,진례,서부산,1708,104,74,59,84,113,2142,1946,111,81,56,109,102,2405,
20221025,147,245,진례,장유,1113,68,93,134,23,102,1533,1438,59,92,130,25,137,1881,
20221025,147,289,진례,마산,1270,88,72,46,79,75,1630,1306,84,70,55,68,95,1678,
20221025,148,150,서김해,북부산,6695,130,96,103,111,534,7669,6415,133,88,90,75,494,7295,
20221025,148,251,서김해,물금,906,37,23,33,17,81,1097,930,34,22,35,13,92,1126,
20221025,148,289,서김해,마산,1344,33,49,17,7,115,1565,1390,34,59,18,8,111,1620,
20221025,149,150,동김해,북부산,10444,209,197,44,95,878,11867,8994,171,152,48,52,745,10162,
20221025,149,250,동김해,남양산,1117,28,60,11,5,91,1312,932,19,55,8,11,76,1101,
20221025,149,251,동김해,물금,1126,45,14,10,5,129,1329,1131,40,16,8,3,117,1315,
20221025,150,146,북부산,동창원,962,20,14,2,19,77,1094,1032,22,10,6,20,73,1163,
20221025,150,147,북부산,진례,1688,56,24,29,31,91,1919,1462,47,28,18,37,82,1674,
20221025,150,148,북부산,서김해,6415,133,88,90,75,494,7295,6695,130,96,103,111,534,7669,
20221025,150,149,북부산,동김해,8994,171,152,48,52,745,10162,10444,209,197,44,95,878,11867,
20221025,150,245,북부산,장유,3749,38,93,16,41,251,4188,3190,44,74,10,30,229,3577,
20221025,150,289,북부산,마산,2379,24,74,10,26,131,2644,2847,38,73,15,34,166,3173,
20221025,151,115,북대전,대전,893,10,15,3,4,102,1027,1126,9,12,6,3,118,1274,
20221025,151,153,북대전,서대전,1053,17,21,17,7,83,1198,1262,18,21,24,10,93,1428,
20221025,152,115,유성,대전,977,14,20,1,3,67,1082,951,16,13,2,0,78,1060,
20221025,152,154,유성,안영,945,27,32,9,23,62,1098,1048,24,23,7,17,60,1179,
20221025,153,114,서대전,남대전,1730,40,80,60,62,126,2098,1890,54,59,57,66,140,2266,
20221025,153,119,서대전,판암,1779,26,27,105,75,160,2172,1748,22,10,102,82,152,2116,
20221025,153,151,서대전,북대전,1262,18,21,24,10,93,1428,1053,17,21,17,7,83,1198,
20221025,153,154,서대전,안영,1091,40,47,135,53,56,1422,1078,43,45,135,31,59,1391,
20221025,153,579,서대전,남세종,1212,16,16,6,16,98,1364,1064,22,16,9,27,89,1227,
20221025,154,152,안영,유성,1048,24,23,7,17,60,1179,945,27,32,9,23,62,1098,
20221025,154,153,안영,서대전,1078,43,45,135,31,59,1391,1091,40,47,135,53,56,1422,
20221025,159,167,서전주,광주,1248,69,70,50,38,44,1519,1304,85,63,53,39,48,1592,
20221025,166,167,장성,광주,2178,84,84,32,63,103,2544,2595,113,75,35,52,116,2986,
20221025,167,159,광주,서전주,1304,85,63,53,39,48,1592,1248,69,70,50,38,44,1519,
20221025,167,166,광주,장성,2595,113,75,35,52,116,2986,2178,84,84,32,63,103,2544,
20221025,167,567,광주,남고창,1239,35,66,19,23,46,1428,1227,28,57,16,31,49,1408,
20221025,171,101,마성,서울,2550,20,259,57,2,128,3016,2272,19,226,57,5,101,2680,
20221025,172,101,용인,서울,3791,168,129,49,19,259,4415,3459,156,127,43,23,240,4048,
20221025,172,102,용인,동수원,972,29,17,1,1,100,1120,1074,20,23,1,2,90,1210,
20221025,172,173,용인,양지,1925,240,127,141,97,128,2658,1841,188,129,149,107,150,2564,
20221025,172,212,용인,북수원,929,44,13,24,17,63,1090,1168,53,13,17,20,78,1349,
20221025,172,253,용인,서서울,1161,64,30,22,17,61,1355,1081,58,23,38,12,77,1289,
20221025,173,101,양지,서울,4209,385,146,168,112,182,5202,3295,209,122,114,69,137,3946,
20221025,173,102,양지,동수원,1387,45,44,18,7,81,1582,1181,49,28,14,18,55,1345,
20221025,173,172,양지,용인,1841,188,129,149,107,150,2564,1925,240,127,141,97,128,2658,
20221025,173,212,양지,북수원,1160,84,35,55,30,82,1446,1229,112,49,43,41,55,1529,
20221025,173,253,양지,서서울,1282,164,78,129,57,59,1769,931,133,53,107,40,54,1318,
20221025,173,254,양지,군자,762,124,90,175,233,39,1423,704,109,104,180,187,32,1316,
20221025,174,179,춘천,홍천,3193,81,95,53,32,293,3747,3025,80,81,49,26,306,3567,
20221025,174,216,춘천,횡성,998,52,33,25,52,55,1215,1073,49,28,17,26,59,1252,
20221025,174,218,춘천,남원주,1071,29,68,11,12,71,1262,972,22,65,15,10,78,1162,
20221025,174,554,춘천,동홍천,1141,21,25,12,12,87,1298,1148,18,19,9,6,82,1282,
20221025,175,101,덕평,서울,822,116,91,34,55,40,1158,803,59,75,38,58,36,1069,
20221025,176,190,이천,동서울,1555,76,201,174,127,67,2200,1525,67,211,133,85,67,2088,
20221025,179,174,홍천,춘천,3025,80,81,49,26,306,3567,3193,81,95,53,32,293,3747,
20221025,184,189,대관령,강릉,1198,36,59,5,9,84,1391,1274,33,58,4,8,88,1465,
20221025,189,184,강릉,대관령,1274,33,58,4,8,88,1465,1198,36,59,5,9,84,1391,
20221025,190,176,동서울,이천,1525,67,211,133,85,67,2088,1555,76,201,174,127,67,2200,
20221025,190,191,동서울,경기광주,10228,666,452,350,222,692,12610,10114,639,439,350,249,728,12519,
20221025,190,192,동서울,곤지암,6181,481,256,200,110,374,7602,5729,449,204,187,82,347,6998,
20221025,190,193,동서울,일죽,2399,168,186,190,109,80,3132,2269,192,159,255,109,75,3059,
20221025,190,194,동서울,서이천,4256,566,273,253,187,257,5792,3346,432,244,227,120,172,4541,
20221025,190,198,동서울,서청주,950,26,51,28,31,44,1130,859,28,46,25,30,39,1027,
20221025,190,560,동서울,감곡,941,20,41,35,74,31,1142,829,46,35,30,86,29,1055,
20221025,190,705,동서울,남이천,1392,89,67,164,92,43,1847,1585,105,70,126,89,54,2029,
20221025,191,190,경기광주,동서울,10114,639,439,350,249,728,12519,10228,666,452,350,222,692,12610,
20221025,192,190,곤지암,동서울,5729,449,204,187,82,347,6998,6181,481,256,200,110,374,7602,
20221025,192,194,곤지암,서이천,1422,243,114,141,105,103,2128,1149,185,99,116,169,86,1804,
20221025,193,190,일죽,동서울,2269,192,159,255,109,75,3059,2399,168,186,190,109,80,3132,
20221025,194,190,서이천,동서울,3346,432,244,227,120,172,4541,4256,566,273,253,187,257,5792,
20221025,194,192,서이천,곤지암,1149,185,99,116,169,86,1804,1422,243,114,141,105,103,2128,
20221025,196,198,진천,서청주,1320,49,91,52,37,81,1630,1285,33,73,43,28,88,1550,
20221025,198,115,서청주,대전,926,18,5,5,4,67,1025,919,25,12,5,2,63,1026,
20221025,198,190,서청주,동서울,859,28,46,25,30,39,1027,950,26,51,28,31,44,1130,
20221025,198,196,서청주,진천,1285,33,73,43,28,88,1550,1320,49,91,52,37,81,1630,
20221025,201,127,칠곡,서대구,911,16,17,6,4,74,1028,1478,27,26,9,40,91,1671,
20221025,201,203,칠곡,가산,867,35,36,44,103,50,1135,856,45,49,48,113,45,1156,
20221025,203,127,가산,서대구,1988,58,61,46,133,97,2383,2139,67,77,52,109,88,2532,
20221025,203,201,가산,칠곡,856,45,49,48,113,45,1156,867,35,36,44,103,50,1135,
20221025,203,775,가산,동명동호,1693,66,53,49,231,80,2172,1665,68,59,43,206,75,2116,
20221025,212,102,북수원,동수원,4653,41,224,39,23,297,5277,4323,26,225,20,51,269,4914,
20221025,212,172,북수원,용인,1168,53,13,17,20,78,1349,929,44,13,24,17,63,1090,
20221025,212,173,북수원,양지,1229,112,49,43,41,55,1529,1160,84,35,55,30,82,1446,
20221025,212,253,북수원,서서울,2737,56,23,13,20,177,3026,1014,19,10,8,9,54,1114,
20221025,212,254,북수원,군자,1804,34,31,12,27,111,2019,1145,24,20,14,21,68,1292,
20221025,213,102,부곡,동수원,1037,17,18,2,24,89,1187,1102,22,12,11,28,82,1257,
20221025,213,253,부곡,서서울,1431,76,30,29,146,96,1808,1046,43,21,42,122,79,1353,
20221025,213,254,부곡,군자,979,24,25,34,394,70,1526,883,31,20,39,358,48,1379,
20221025,214,102,동군포,동수원,1524,28,21,10,4,103,1690,1507,30,20,16,10,106,1689,
20221025,215,102,군포,동수원,2334,8,46,3,12,171,2574,1636,20,28,4,23,111,1822,
20221025,215,253,군포,서서울,3095,101,73,45,71,227,3612,3741,184,129,192,107,254,4607,
20221025,215,254,군포,군자,2060,82,49,31,65,155,2442,2824,135,103,129,140,193,3524,
20221025,215,255,군포,서안산,1392,48,29,20,12,100,1601,1527,82,69,75,93,120,1966,
20221025,216,174,횡성,춘천,1073,49,28,17,26,59,1252,998,52,33,25,52,55,1215,
20221025,218,174,남원주,춘천,972,22,65,15,10,78,1162,1071,29,68,11,12,71,1262,
20221025,218,240,남원주,제천,2088,55,46,21,44,141,2395,2190,54,49,17,39,135,2484,
20221025,225,291,서진주,사천,980,30,23,10,28,59,1130,1012,27,34,9,34,55,1171,
20221025,229,101,북천안,서울,852,56,39,53,21,46,1067,802,49,45,52,22,32,1002,
20221025,229,108,북천안,천안,3915,106,139,66,63,221,4510,3426,67,124,50,30,197,3894,
20221025,230,127,팔공산,서대구,1103,37,34,19,9,72,1274,1534,47,30,17,6,89,1723,
20221025,230,131,팔공산,경산,1508,69,44,20,24,100,1765,1258,82,43,18,11,92,1504,
20221025,230,524,팔공산,청통와촌,1131,43,36,16,49,54,1329,1030,35,28,8,32,57,1190,
20221025,230,527,팔공산,포항,1397,31,19,12,23,48,1530,1255,28,11,6,20,46,1366,
20221025,231,519,화원옥포,남대구,6451,166,115,164,199,477,7572,6167,162,114,151,103,458,7155,
20221025,232,519,달성,남대구,2726,123,140,39,42,199,3269,2918,135,148,44,23,184,3452,
20221025,233,519,현풍,남대구,4874,234,190,73,116,360,5847,4339,195,182,87,102,315,5220,
20221025,238,239,칠서,칠원,1589,113,117,193,347,89,2448,1568,95,113,158,319,97,2350,
20221025,239,238,칠원,칠서,1568,95,113,158,319,97,2350,1589,113,117,193,347,89,2448,
20221025,239,519,칠원,남대구,1030,52,87,31,122,45,1367,1119,57,87,53,96,42,1454,
20221025,240,218,제천,남원주,2190,54,49,17,39,135,2484,2088,55,46,21,44,141,2395,
20221025,241,519,동고령,남대구,3154,102,82,335,96,164,3933,2915,100,82,272,119,143,3631,
20221025,242,519,고령,남대구,1573,37,46,30,155,62,1903,1608,27,49,19,129,72,1904,
20221025,244,146,서부산,동창원,1242,38,43,23,40,78,1464,1209,25,35,21,31,82,1403,
20221025,244,147,서부산,진례,1946,111,81,56,109,102,2405,1708,104,74,59,84,113,2142,
20221025,244,245,서부산,장유,12760,259,403,164,336,958,14880,12246,237,361,147,389,934,14314,
20221025,244,289,서부산,마산,2843,59,232,45,69,159,3407,2767,82,251,53,63,130,3346,
20221025,245,146,장유,동창원,985,11,18,48,21,88,1171,946,10,21,44,8,93,1122,
20221025,245,147,장유,진례,1438,59,92,130,25,137,1881,1113,68,93,134,23,102,1533,
20221025,245,150,장유,북부산,3190,44,74,10,30,229,3577,3749,38,93,16,41,251,4188,
20221025,245,244,장유,서부산,12246,237,361,147,389,934,14314,12760,259,403,164,336,958,14880,
20221025,245,289,장유,마산,1384,33,33,20,31,123,1624,1419,31,40,27,16,91,1624,
20221025,248,261,순창,동광주,1161,23,29,12,7,40,1272,1199,15,32,15,7,48,1316,
20221025,249,261,담양,동광주,2222,38,136,16,26,95,2533,1796,40,124,23,19,92,2094,
20221025,250,140,남양산,부산,7667,142,212,32,59,645,8757,7957,145,214,28,34,651,9029,
20221025,250,149,남양산,동김해,932,19,55,8,11,76,1101,1117,28,60,11,5,91,1312,
20221025,250,252,남양산,대동,3393,159,111,103,99,238,4103,4078,172,120,94,142,324,4930,
20221025,251,140,물금,부산,1079,97,27,26,43,82,1354,1047,117,29,28,56,85,1362,
20221025,251,148,물금,서김해,930,34,22,35,13,92,1126,906,37,23,33,17,81,1097,
20221025,251,149,물금,동김해,1131,40,16,8,3,117,1315,1126,45,14,10,5,129,1329,
20221025,251,252,물금,대동,3113,214,100,159,488,262,4336,3680,210,104,149,580,279,5002,
20221025,252,135,대동,경주,1082,49,84,43,101,53,1412,863,37,84,55,163,44,1246,
20221025,252,138,대동,양산,3007,317,184,166,324,139,4137,2698,340,189,186,349,129,3891,
20221025,252,139,대동,서울산,837,34,28,34,29,39,1001,813,45,51,32,35,48,1024,
20221025,252,140,대동,부산,1530,39,33,37,99,81,1819,1747,47,50,45,65,89,2043,
20221025,252,250,대동,남양산,4078,172,120,94,142,324,4930,3393,159,111,103,99,238,4103,
20221025,252,251,대동,물금,3680,210,104,149,580,279,5002,3113,214,100,159,488,262,4336,
20221025,252,641,대동,울산,1618,67,96,42,56,89,1968,1321,61,92,44,70,86,1674,
20221025,252,752,대동,기장철마,1887,76,56,39,113,134,2305,1887,79,65,42,67,132,2272,
20221025,252,753,대동,금정,1856,100,84,97,181,113,2431,1101,79,61,58,83,73,1455,
20221025,252,755,대동,광재,2310,86,87,119,329,152,3083,2285,100,75,119,485,138,3202,
20221025,252,756,대동,한림,862,49,32,25,112,42,1122,937,61,39,27,96,37,1197,
20221025,253,102,서서울,동수원,5254,61,65,23,20,339,5762,5758,67,73,23,20,346,6287,
20221025,253,103,서서울,수원신갈,2175,135,108,80,36,125,2659,1930,143,83,70,28,113,2367,
20221025,253,172,서서울,용인,1081,58,23,38,12,77,1289,1161,64,30,22,17,61,1355,
20221025,253,173,서서울,양지,931,133,53,107,40,54,1318,1282,164,78,129,57,59,1769,
20221025,253,212,서서울,북수원,1014,19,10,8,9,54,1114,2737,56,23,13,20,177,3026,
20221025,253,213,서서울,부곡,1046,43,21,42,122,79,1353,1431,76,30,29,146,96,1808,
20221025,253,215,서서울,군포,3741,184,129,192,107,254,4607,3095,101,73,45,71,227,3612,
20221025,253,255,서서울,서안산,15324,559,691,573,360,912,18419,14754,495,631,527,328,909,17644,
20221025,253,256,서서울,안산,8984,165,89,44,21,600,9903,5775,111,65,30,48,436,6465,
20221025,253,281,서서울,매송,3572,58,36,15,21,224,3926,3765,62,39,25,75,261,4227,
20221025,253,282,서서울,비봉,5623,239,269,159,419,328,7037,5471,296,281,165,441,342,6996,
20221025,253,283,서서울,발안,3331,165,162,167,106,201,4132,3518,217,201,193,130,192,4451,
20221025,253,285,서서울,서평택,1461,59,118,264,371,84,2357,1469,107,122,367,525,92,2682,
20221025,253,287,서서울,송악,1678,37,60,68,203,77,2123,1848,48,71,117,438,79,2601,
20221025,253,288,서서울,당진,1255,34,54,28,32,62,1465,1295,33,51,58,63,58,1558,
20221025,253,298,서서울,서산,2140,37,79,49,24,89,2418,2130,31,61,77,58,81,2438,
20221025,253,520,서서울,평택,2303,126,133,200,146,113,3021,2073,143,128,233,128,81,2786,
20221025,253,540,서서울,청북,802,39,65,115,52,43,1116,838,70,48,120,73,44,1193,
20221025,253,741,서서울,평택고덕,971,30,18,25,10,82,1136,922,37,24,32,11,74,1100,
20221025,254,102,군자,동수원,4094,57,73,30,54,241,4549,3896,52,70,18,42,196,4274,
20221025,254,103,군자,수원신갈,1787,131,90,129,114,103,2354,1359,99,85,79,70,80,1772,
20221025,254,173,군자,양지,704,109,104,180,187,32,1316,762,124,90,175,233,39,1423,
20221025,254,212,군자,북수원,1145,24,20,14,21,68,1292,1804,34,31,12,27,111,2019,
20221025,254,213,군자,부곡,883,31,20,39,358,48,1379,979,24,25,34,394,70,1526,
20221025,254,215,군자,군포,2824,135,103,129,140,193,3524,2060,82,49,31,65,155,2442,
20221025,254,255,군자,서안산,9976,418,201,209,302,688,11794,9792,427,200,221,309,663,11612,
20221025,254,256,군자,안산,4609,113,123,44,60,383,5332,5063,126,124,57,81,426,5877,
20221025,254,281,군자,매송,989,32,27,26,74,68,1216,919,20,17,19,69,54,1098,
20221025,254,282,군자,비봉,1343,121,92,91,221,89,1957,1044,100,68,64,198,67,1541,
20221025,254,283,군자,발안,1219,93,50,65,128,75,1630,1052,80,68,45,92,72,1409,
20221025,255,102,서안산,동수원,1987,46,21,13,6,114,2187,1767,38,21,9,6,96,1937,
20221025,255,215,서안산,군포,1527,82,69,75,93,120,1966,1392,48,29,20,12,100,1601,
20221025,255,253,서안산,서서울,14754,495,631,527,328,909,17644,15324,559,691,573,360,912,18419,
20221025,255,254,서안산,군자,9792,427,200,221,309,663,11612,9976,418,201,209,302,688,11794,
20221025,256,253,안산,서서울,5775,111,65,30,48,436,6465,8984,165,89,44,21,600,9903,
20221025,256,254,안산,군자,5063,126,124,57,81,426,5877,4609,113,123,44,60,383,5332,
20221025,261,248,동광주,순창,1199,15,32,15,7,48,1316,1161,23,29,12,7,40,1272,
20221025,261,249,동광주,담양,1796,40,124,23,19,92,2094,2222,38,136,16,26,95,2533,
20221025,261,263,동광주,옥과,2612,31,121,25,61,116,2966,2394,23,108,20,60,91,2696,
20221025,261,265,동광주,곡성,1432,30,43,22,51,59,1637,1211,17,46,16,30,37,1357,
20221025,261,271,동광주,순천,2751,72,77,41,78,90,3109,2359,80,67,16,101,56,2679,
20221025,263,261,옥과,동광주,2394,23,108,20,60,91,2696,2612,31,121,25,61,116,2966,
20221025,265,261,곡성,동광주,1211,17,46,16,30,37,1357,1432,30,43,22,51,59,1637,
20221025,271,261,순천,동광주,2359,80,67,16,101,56,2679,2751,72,77,41,78,90,3109,
20221025,271,569,순천,북광주,930,68,32,25,114,30,1199,915,55,38,22,92,33,1155,
20221025,281,253,매송,서서울,3765,62,39,25,75,261,4227,3572,58,36,15,21,224,3926,
20221025,281,254,매송,군자,919,20,17,19,69,54,1098,989,32,27,26,74,68,1216,
20221025,282,253,비봉,서서울,5471,296,281,165,441,342,6996,5623,239,269,159,419,328,7037,
20221025,282,254,비봉,군자,1044,100,68,64,198,67,1541,1343,121,92,91,221,89,1957,
20221025,283,253,발안,서서울,3518,217,201,193,130,192,4451,3331,165,162,167,106,201,4132,
20221025,283,254,발안,군자,1052,80,68,45,92,72,1409,1219,93,50,65,128,75,1630,
20221025,285,253,서평택,서서울,1469,107,122,367,525,92,2682,1461,59,118,264,371,84,2357,
20221025,285,287,서평택,송악,637,34,71,63,652,46,1503,661,48,86,78,567,44,1484,
20221025,286,140,통도사휴게소,부산,983,5,8,0,1,31,1028,1061,9,7,0,0,44,1121,
20221025,287,253,송악,서서울,1848,48,71,117,438,79,2601,1678,37,60,68,203,77,2123,
20221025,287,285,송악,서평택,661,48,86,78,567,44,1484,637,34,71,63,652,46,1503,
20221025,288,253,당진,서서울,1295,33,51,58,63,58,1558,1255,34,54,28,32,62,1465,
20221025,289,146,마산,동창원,2536,71,85,30,52,203,2977,2599,74,71,42,65,226,3077,
20221025,289,147,마산,진례,1306,84,70,55,68,95,1678,1270,88,72,46,79,75,1630,
20221025,289,148,마산,서김해,1390,34,59,18,8,111,1620,1344,33,49,17,7,115,1565,
20221025,289,150,마산,북부산,2847,38,73,15,34,166,3173,2379,24,74,10,26,131,2644,
20221025,289,244,마산,서부산,2767,82,251,53,63,130,3346,2843,59,232,45,69,159,3407,
20221025,289,245,마산,장유,1419,31,40,27,16,91,1624,1384,33,33,20,31,123,1624,
20221025,289,757,마산,진영,724,45,73,36,86,42,1006,788,46,64,39,48,48,1033,
20221025,291,145,사천,산인,1326,65,63,17,20,65,1556,1116,35,61,17,18,70,1317,
20221025,291,225,사천,서진주,1012,27,34,9,34,55,1171,980,30,23,10,28,59,1130,
20221025,291,292,사천,진주,2755,90,92,49,65,258,3309,3523,94,92,61,60,278,4108,
20221025,292,145,진주,산인,1516,35,132,16,13,89,1801,1301,25,136,13,16,80,1571,
20221025,292,291,진주,사천,3523,94,92,61,60,278,4108,2755,90,92,49,65,258,3309,
20221025,293,145,문산,산인,1145,23,26,14,10,81,1299,1176,27,20,17,4,73,1317,
20221025,298,253,서산,서서울,2130,31,61,77,58,81,2438,2140,37,79,49,24,89,2418,
20221025,508,509,무안,목포,1479,53,44,35,81,72,1764,1920,58,48,47,79,97,2249,
20221025,508,553,무안,동광산,1438,31,40,18,48,46,1621,1475,42,48,28,46,59,1698,
20221025,509,508,목포,무안,1920,58,48,47,79,97,2249,1479,53,44,35,81,72,1764,
20221025,509,553,목포,동광산,6449,186,192,159,390,226,7602,6783,191,218,191,433,247,8063,
20221025,513,515,고성,북통영,1162,30,85,6,19,99,1401,1383,39,68,10,13,101,1614,
20221025,513,516,고성,통영,2861,87,113,103,139,202,3505,2682,82,140,86,143,198,3331,
20221025,514,516,동고성,통영,1210,27,61,39,155,168,1660,1183,24,57,44,154,151,1613,
20221025,515,513,북통영,고성,1383,39,68,10,13,101,1614,1162,30,85,6,19,99,1401,
20221025,516,513,통영,고성,2682,82,140,86,143,198,3331,2861,87,113,103,139,202,3505,
20221025,516,514,통영,동고성,1183,24,57,44,154,151,1613,1210,27,61,39,155,168,1660,
20221025,518,127,칠곡물류,서대구,751,106,67,89,32,54,1099,942,128,86,102,30,52,1340,
20221025,519,231,남대구,화원옥포,6167,162,114,151,103,458,7155,6451,166,115,164,199,477,7572,
20221025,519,232,남대구,달성,2918,135,148,44,23,184,3452,2726,123,140,39,42,199,3269,
20221025,519,233,남대구,현풍,4339,195,182,87,102,315,5220,4874,234,190,73,116,360,5847,
20221025,519,239,남대구,칠원,1119,57,87,53,96,42,1454,1030,52,87,31,122,45,1367,
20221025,519,241,남대구,동고령,2915,100,82,272,119,143,3631,3154,102,82,335,96,164,3933,
20221025,519,242,남대구,고령,1608,27,49,19,129,72,1904,1573,37,46,30,155,62,1903,
20221025,519,730,남대구,유천,2340,54,15,1,5,157,2572,2835,62,15,0,0,213,3125,
20221025,519,731,남대구,북현풍,1975,24,25,0,1,127,2152,1544,30,5,0,0,120,1699,
20221025,520,253,평택,서서울,2073,143,128,233,128,81,2786,2303,126,133,200,146,113,3021,
20221025,520,540,평택,청북,977,92,157,146,91,66,1529,751,93,152,152,91,46,1285,
20221025,520,741,평택,평택고덕,908,17,205,19,26,86,1261,812,9,176,17,25,72,1111,
20221025,524,129,청통와촌,북대구,1180,79,49,19,41,61,1429,961,46,30,11,24,56,1128,
20221025,524,230,청통와촌,팔공산,1030,35,28,8,32,57,1190,1131,43,36,16,49,54,1329,
20221025,527,129,포항,북대구,1871,53,41,30,71,91,2157,1488,29,20,27,61,85,1710,
20221025,527,230,포항,팔공산,1255,28,11,6,20,46,1366,1397,31,19,12,23,48,1530,
20221025,528,101,기흥동탄,서울,7156,69,1298,131,9,332,8995,7165,84,1184,131,10,349,8923,
20221025,528,103,기흥동탄,수원신갈,2151,21,160,8,3,132,2475,1467,13,211,2,6,96,1795,
20221025,528,106,기흥동탄,오산,944,31,56,15,8,82,1136,863,38,40,15,10,70,1036,
20221025,528,107,기흥동탄,안성,1141,24,20,4,11,88,1288,1005,24,18,3,7,87,1144,
20221025,528,108,기흥동탄,천안,1096,25,123,2,14,61,1321,1058,12,102,1,13,60,1246,
20221025,540,253,청북,서서울,838,70,48,120,73,44,1193,802,39,65,115,52,43,1116,
20221025,540,520,청북,평택,751,93,152,152,91,46,1285,977,92,157,146,91,66,1529,
20221025,540,741,청북,평택고덕,883,29,45,59,57,90,1163,887,41,49,64,71,99,1211,
20221025,542,101,서안성,서울,1697,43,75,168,62,85,2130,1147,45,75,104,20,57,1448,
20221025,542,543,서안성,남안성,1079,52,88,100,124,87,1530,1157,41,108,107,94,99,1606,
20221025,543,101,남안성,서울,1212,86,80,86,74,55,1593,1113,58,61,63,47,42,1384,
20221025,543,542,남안성,서안성,1157,41,108,107,94,99,1606,1079,52,88,100,124,87,1530,
20221025,543,555,남안성,북진천,859,105,171,183,145,35,1498,779,90,158,168,175,43,1413,
20221025,548,553,북무안,동광산,1216,31,34,52,60,40,1433,1416,30,44,37,74,44,1645,
20221025,549,553,동함평,동광산,3665,56,87,28,42,144,4022,3657,55,100,29,54,149,4044,
20221025,551,553,나주,동광산,1313,31,24,95,76,73,1612,1305,38,37,97,72,69,1618,
20221025,552,553,서광산,동광산,4383,194,190,237,246,195,5445,5801,219,216,223,189,237,6885,
20221025,553,508,동광산,무안,1475,42,48,28,46,59,1698,1438,31,40,18,48,46,1621,
20221025,553,509,동광산,목포,6783,191,218,191,433,247,8063,6449,186,192,159,390,226,7602,
20221025,553,548,동광산,북무안,1416,30,44,37,74,44,1645,1216,31,34,52,60,40,1433,
20221025,553,549,동광산,동함평,3657,55,100,29,54,149,4044,3665,56,87,28,42,144,4022,
20221025,553,551,동광산,나주,1305,38,37,97,72,69,1618,1313,31,24,95,76,73,1612,
20221025,553,552,동광산,서광산,5801,219,216,223,189,237,6885,4383,194,190,237,246,195,5445,
20221025,554,174,동홍천,춘천,1148,18,19,9,6,82,1282,1141,21,25,12,12,87,1298,
20221025,555,543,북진천,남안성,779,90,158,168,175,43,1413,859,105,171,183,145,35,1498,
20221025,560,190,감곡,동서울,829,46,35,30,86,29,1055,941,20,41,35,74,31,1142,
20221025,567,167,남고창,광주,1227,28,57,16,31,49,1408,1239,35,66,19,23,46,1428,
20221025,569,271,북광주,순천,915,55,38,22,92,33,1155,930,68,32,25,114,30,1199,
20221025,579,115,남세종,대전,1170,20,21,6,7,103,1327,1078,14,14,7,11,100,1224,
20221025,579,153,남세종,서대전,1064,22,16,9,27,89,1227,1212,16,16,6,16,98,1364,
20221025,587,589,오수,상관,1095,30,77,23,45,42,1312,1008,19,70,19,93,39,1248,
20221025,589,587,상관,오수,1008,19,70,19,93,39,1248,1095,30,77,23,45,42,1312,
20221025,597,598,서여주,북여주,1013,44,130,35,59,43,1324,1037,46,96,43,61,52,1335,
20221025,598,597,북여주,서여주,1037,46,96,43,61,52,1335,1013,44,130,35,59,43,1324,
20221025,621,127,동대구,서대구,1284,45,28,34,21,93,1505,1847,47,95,28,25,120,2162,
20221025,621,131,동대구,경산,2454,70,51,108,36,139,2858,2311,58,42,100,54,137,2702,
20221025,621,132,동대구,영천,1180,13,26,2,30,43,1294,1130,13,24,7,27,44,1245,
20221025,625,626,밀양,남밀양,1207,78,61,36,94,60,1536,1195,61,46,50,81,74,1507,
20221025,626,625,남밀양,밀양,1195,61,46,50,81,74,1507,1207,78,61,36,94,60,1536,
20221025,626,627,남밀양,삼랑진,964,29,34,12,49,114,1202,967,35,35,17,34,103,1191,
20221025,627,626,삼랑진,남밀양,967,35,35,17,34,103,1191,964,29,34,12,49,114,1202,
20221025,641,139,울산,서울산,1108,25,56,15,31,64,1299,1085,39,59,21,43,92,1339,
20221025,641,252,울산,대동,1321,61,92,44,70,86,1674,1618,67,96,42,56,89,1968,
20221025,641,643,울산,청량,1209,11,16,11,61,111,1419,1324,9,12,7,23,137,1512,
20221025,641,706,울산,남경주,1147,14,20,17,22,72,1292,1187,10,38,16,19,69,1339,
20221025,641,707,울산,남포항,1070,12,31,17,124,49,1303,1076,23,42,33,128,57,1359,
20221025,643,641,청량,울산,1324,9,12,7,23,137,1512,1209,11,16,11,61,111,1419,
20221025,643,648,청량,해운대,2974,17,46,10,70,188,3305,3168,33,90,41,552,194,4078,
20221025,645,648,장안,해운대,1600,21,17,8,4,90,1740,2833,35,33,324,116,166,3507,
20221025,646,648,기장일광,해운대,4694,26,29,77,50,263,5139,5329,46,41,25,203,303,5947,
20221025,648,643,해운대,청량,3168,33,90,41,552,194,4078,2974,17,46,10,70,188,3305,
20221025,648,645,해운대,장안,2833,35,33,324,116,166,3507,1600,21,17,8,4,90,1740,
20221025,648,646,해운대,기장일광,5329,46,41,25,203,303,5947,4694,26,29,77,50,263,5139,
20221025,651,652,남양주,화도,14145,553,524,510,299,1026,17057,16334,597,560,549,286,1267,19593,
20221025,651,653,남양주,서종,1814,17,14,1,20,85,1951,1857,21,9,4,16,78,1985,
20221025,651,654,남양주,설악,3647,36,72,17,17,144,3933,3675,28,72,15,20,154,3964,
20221025,651,655,남양주,강촌,2300,39,109,25,25,83,2581,2373,25,110,29,34,80,2651,
20221025,651,656,남양주,남춘천,2625,34,49,33,61,79,2881,2171,21,47,11,52,48,2350,
20221025,652,651,화도,남양주,16334,597,560,549,286,1267,19593,14145,553,524,510,299,1026,17057,
20221025,652,653,화도,서종,1432,44,23,38,25,118,1680,1479,45,22,23,25,116,1710,
20221025,652,654,화도,설악,1264,22,20,5,62,95,1468,1219,25,14,22,43,81,1404,
20221025,653,651,서종,남양주,1857,21,9,4,16,78,1985,1814,17,14,1,20,85,1951,
20221025,653,652,서종,화도,1479,45,22,23,25,116,1710,1432,44,23,38,25,118,1680,
20221025,654,651,설악,남양주,3675,28,72,15,20,154,3964,3647,36,72,17,17,144,3933,
20221025,654,652,설악,화도,1219,25,14,22,43,81,1404,1264,22,20,5,62,95,1468,
20221025,655,651,강촌,남양주,2373,25,110,29,34,80,2651,2300,39,109,25,25,83,2581,
20221025,656,651,남춘천,남양주,2171,21,47,11,52,48,2350,2625,34,49,33,61,79,2881,
20221025,671,672,봉담,정남,3309,188,88,106,163,220,4074,3979,187,109,113,215,288,4891,
20221025,671,673,봉담,북오산,1895,61,42,24,17,140,2179,2036,59,52,19,17,157,2340,
20221025,671,676,봉담,향남,1340,102,48,63,33,106,1692,1253,97,44,61,32,100,1587,
20221025,671,677,봉담,북평택,7818,225,253,154,338,435,9223,7480,185,209,142,258,406,8680,
20221025,672,671,정남,봉담,3979,187,109,113,215,288,4891,3309,188,88,106,163,220,4074,
20221025,673,101,북오산,서울,1485,35,107,26,18,92,1763,1479,41,111,25,12,91,1759,
20221025,673,671,북오산,봉담,2036,59,52,19,17,157,2340,1895,61,42,24,17,140,2179,
20221025,673,677,북오산,북평택,2004,41,92,28,29,138,2332,1946,44,58,38,27,125,2238,
20221025,675,676,서오산,향남,3536,125,86,44,261,234,4286,3203,97,71,21,256,230,3878,
20221025,675,677,서오산,북평택,11712,219,432,190,184,806,13543,10705,219,369,199,171,710,12373,
20221025,675,876,서오산,양감,1884,71,41,57,79,115,2247,2169,74,42,33,62,157,2537,
20221025,676,671,향남,봉담,1253,97,44,61,32,100,1587,1340,102,48,63,33,106,1692,
20221025,676,675,향남,서오산,3203,97,71,21,256,230,3878,3536,125,86,44,261,234,4286,
20221025,676,677,향남,북평택,1630,180,183,203,165,100,2461,1436,168,147,180,149,74,2154,
20221025,677,101,북평택,서울,1246,53,264,84,127,66,1840,1580,54,257,93,107,66,2157,
20221025,677,671,북평택,봉담,7480,185,209,142,258,406,8680,7818,225,253,154,338,435,9223,
20221025,677,673,북평택,북오산,1946,44,58,38,27,125,2238,2004,41,92,28,29,138,2332,
20221025,677,675,북평택,서오산,10705,219,369,199,171,710,12373,11712,219,432,190,184,806,13543,
20221025,677,676,북평택,향남,1436,168,147,180,149,74,2154,1630,180,183,203,165,100,2461,
20221025,677,876,북평택,양감,2237,163,189,199,180,151,3119,2087,179,201,230,187,133,3017,
20221025,682,683,조암,송산마도,853,100,92,79,54,40,1218,968,110,95,76,87,48,1384,
20221025,682,684,조암,남안산,1021,144,212,108,106,38,1629,1068,157,165,120,101,42,1653,
20221025,682,685,조암,서시흥,1785,199,169,165,280,99,2697,1923,181,162,155,313,106,2840,
20221025,683,682,송산마도,조암,968,110,95,76,87,48,1384,853,100,92,79,54,40,1218,
20221025,683,684,송산마도,남안산,2561,200,189,121,250,141,3462,2216,174,125,103,129,128,2875,
20221025,683,685,송산마도,서시흥,5235,306,217,206,993,294,7251,4638,288,235,198,1039,244,6642,
20221025,684,682,남안산,조암,1068,157,165,120,101,42,1653,1021,144,212,108,106,38,1629,
20221025,684,683,남안산,송산마도,2216,174,125,103,129,128,2875,2561,200,189,121,250,141,3462,
20221025,684,685,남안산,서시흥,5543,530,328,405,616,401,7823,4817,397,334,361,501,355,6765,
20221025,685,682,서시흥,조암,1923,181,162,155,313,106,2840,1785,199,169,165,280,99,2697,
20221025,685,683,서시흥,송산마도,4638,288,235,198,1039,244,6642,5235,306,217,206,993,294,7251,
20221025,685,684,서시흥,남안산,4817,397,334,361,501,355,6765,5543,530,328,405,616,401,7823,
20221025,705,190,남이천,동서울,1585,105,70,126,89,54,2029,1392,89,67,164,92,43,1847,
20221025,706,641,남경주,울산,1187,10,38,16,19,69,1339,1147,14,20,17,22,72,1292,
20221025,706,707,남경주,남포항,860,33,72,45,266,53,1329,949,24,80,48,228,69,1398,
20221025,707,641,남포항,울산,1076,23,42,33,128,57,1359,1070,12,31,17,124,49,1303,
20221025,707,706,남포항,남경주,949,24,80,48,228,69,1398,860,33,72,45,266,53,1329,
20221025,707,708,남포항,동경주,1317,23,35,25,179,78,1657,1376,27,28,27,230,76,1764,
20221025,708,707,동경주,남포항,1376,27,28,27,230,76,1764,1317,23,35,25,179,78,1657,
20221025,715,716,동안동,청송,1168,18,19,25,29,67,1326,1184,20,14,27,31,55,1331,
20221025,716,715,청송,동안동,1184,20,14,27,31,55,1331,1168,18,19,25,29,67,1326,
20221025,730,519,유천,남대구,2835,62,15,0,0,213,3125,2340,54,15,1,5,157,2572,
20221025,731,519,북현풍,남대구,1544,30,5,0,0,120,1699,1975,24,25,0,1,127,2152,
20221025,741,253,평택고덕,서서울,922,37,24,32,11,74,1100,971,30,18,25,10,82,1136,
20221025,741,520,평택고덕,평택,812,9,176,17,25,72,1111,908,17,205,19,26,86,1261,
20221025,741,540,평택고덕,청북,887,41,49,64,71,99,1211,883,29,45,59,57,90,1163,
20221025,742,107,남사진위,안성,1431,52,58,33,7,106,1687,1202,41,54,22,4,109,1432,
20221025,742,108,남사진위,천안,1096,32,34,28,9,76,1275,1099,30,34,25,6,89,1283,
20221025,752,252,기장철마,대동,1887,79,65,42,67,132,2272,1887,76,56,39,113,134,2305,
20221025,753,252,금정,대동,1101,79,61,58,83,73,1455,1856,100,84,97,181,113,2431,
20221025,755,140,광재,부산,925,13,18,31,29,58,1074,1115,15,18,36,24,68,1276,
20221025,755,252,광재,대동,2285,100,75,119,485,138,3202,2310,86,87,119,329,152,3083,
20221025,756,252,한림,대동,937,61,39,27,96,37,1197,862,49,32,25,112,42,1122,
20221025,757,289,진영,마산,788,46,64,39,48,48,1033,724,45,73,36,86,42,1006,
20221025,772,774,북달성,남칠곡,2475,47,56,48,35,141,2802,2613,58,67,45,23,147,2953,
20221025,773,774,북다사,남칠곡,1339,21,22,11,27,74,1494,1302,32,18,15,20,88,1475,
20221025,774,772,남칠곡,북달성,2613,58,67,45,23,147,2953,2475,47,56,48,35,141,2802,
20221025,774,773,남칠곡,북다사,1302,32,18,15,20,88,1475,1339,21,22,11,27,74,1494,
20221025,775,203,동명동호,가산,1665,68,59,43,206,75,2116,1693,66,53,49,231,80,2172,
20221025,776,777,연경,파군재,3502,47,28,14,38,256,3885,2671,28,31,14,27,175,2946,
20221025,776,779,연경,율암,5746,101,77,76,145,442,6587,5959,119,83,68,130,455,6814,
20221025,777,776,파군재,연경,2671,28,31,14,27,175,2946,3502,47,28,14,38,256,3885,
20221025,777,779,파군재,율암,2524,18,25,21,3,246,2837,2555,17,25,22,1,244,2864,
20221025,779,776,율암,연경,5959,119,83,68,130,455,6814,5746,101,77,76,145,442,6587,
20221025,779,777,율암,파군재,2555,17,25,22,1,244,2864,2524,18,25,21,3,246,2837,
20221025,876,675,양감,서오산,2169,74,42,33,62,157,2537,1884,71,41,57,79,115,2247,
20221025,876,677,양감,북평택,2087,179,201,230,187,133,3017,2237,163,189,199,180,151,3119,
20221025,981,982,서영암,강진무위사,1823,38,72,62,55,94,2144,1793,43,88,89,58,74,2145,
20221025,981,987,서영암,남순천,1639,39,104,69,387,44,2282,1675,42,95,120,401,47,2380,
20221025,982,981,강진무위사,서영암,1793,43,88,89,58,74,2145,1823,38,72,62,55,94,2144,
20221025,984,985,보성,벌교,1331,40,54,46,39,43,1553,1297,44,59,27,28,37,1492,
20221025,984,987,보성,남순천,1755,46,104,72,306,57,2340,1843,46,93,71,281,69,2403,
20221025,985,984,벌교,보성,1297,44,59,27,28,37,1492,1331,40,54,46,39,43,1553,
20221025,986,987,고흥,남순천,3406,61,109,149,277,134,4136,3659,85,123,155,301,155,4478,
20221025,987,981,남순천,서영암,1675,42,95,120,401,47,2380,1639,39,104,69,387,44,2282,
20221025,987,984,남순천,보성,1843,46,93,71,281,69,2403,1755,46,104,72,306,57,2340,
20221025,987,986,남순천,고흥,3659,85,123,155,301,155,4478,3406,61,109,149,277,134,4136,
20221026,101,102,서울,동수원,3705,55,257,8,4,228,4257,4821,58,372,28,8,271,5558,
20221026,101,103,서울,수원신갈,16203,649,1732,396,111,788,19879,14352,660,1690,393,111,663,17869,
20221026,101,105,서울,기흥,7108,111,408,79,24,361,8091,5896,95,364,80,32,282,6749,
20221026,101,106,서울,오산,4003,355,444,163,100,259,5324,4230,410,450,177,106,315,5688,
20221026,101,107,서울,안성,3212,79,309,45,13,187,3845,2929,74,300,62,19,134,3518,
20221026,101,108,서울,천안,3522,65,330,51,14,158,4140,3636,51,340,51,17,172,4267,
20221026,101,111,서울,청주,872,13,185,26,31,37,1164,807,22,215,20,19,27,1110,
20221026,101,171,서울,마성,2257,33,249,51,3,113,2706,2657,27,256,56,4,135,3135,
20221026,101,172,서울,용인,3453,137,117,30,27,196,3960,3747,143,120,49,32,244,4335,
20221026,101,173,서울,양지,3395,230,109,96,83,137,4050,4306,407,137,160,101,161,5272,
20221026,101,175,서울,덕평,753,72,85,56,62,45,1073,797,129,90,38,50,43,1147,
20221026,101,229,서울,북천안,813,50,53,46,25,36,1023,854,52,44,54,26,32,1062,
20221026,101,528,서울,기흥동탄,7261,74,1191,134,18,352,9030,7627,76,1319,122,17,338,9499,
20221026,101,542,서울,서안성,1144,40,77,97,27,66,1451,1745,60,77,165,50,100,2197,
20221026,101,543,서울,남안성,1145,67,64,59,51,49,1435,1237,99,84,99,102,57,1678,
20221026,101,673,서울,북오산,1518,48,122,29,14,99,1830,1564,49,120,26,15,97,1871,
20221026,101,677,서울,북평택,1573,59,275,96,121,88,2212,1304,64,256,94,139,68,1925,
20221026,102,101,동수원,서울,4821,58,372,28,8,271,5558,3705,55,257,8,4,228,4257,
20221026,102,172,동수원,용인,1097,25,14,9,5,93,1243,974,24,22,4,3,96,1123,
20221026,102,173,동수원,양지,1256,50,34,7,17,61,1425,1374,48,27,11,10,79,1549,
20221026,102,212,동수원,북수원,4364,37,236,50,39,255,4981,4811,48,232,52,26,304,5473,
20221026,102,213,동수원,부곡,1050,17,16,6,27,89,1205,1024,21,16,4,23,83,1171,
20221026,102,214,동수원,동군포,1503,26,18,13,4,92,1656,1586,24,17,7,5,97,1736,
20221026,102,215,동수원,군포,1693,22,30,5,15,106,1871,2370,21,47,7,26,174,2645,
20221026,102,253,동수원,서서울,6045,69,68,14,25,368,6589,5297,78,89,21,19,346,5850,
20221026,102,254,동수원,군자,3704,45,73,20,31,198,4071,4073,66,86,23,40,260,4548,
20221026,102,255,동수원,서안산,1803,37,14,9,8,94,1965,1910,37,15,11,6,115,2094,
20221026,103,101,수원신갈,서울,14352,660,1690,393,111,663,17869,16203,649,1732,396,111,788,19879,
20221026,103,105,수원신갈,기흥,1580,27,54,22,30,108,1821,2167,30,33,28,29,130,2417,
20221026,103,106,수원신갈,오산,991,74,52,64,16,75,1272,1334,69,75,85,17,91,1671,
20221026,103,108,수원신갈,천안,903,9,54,10,1,36,1013,1192,12,51,17,1,59,1332,
20221026,103,253,수원신갈,서서울,2021,148,81,64,20,129,2463,2131,153,84,82,35,125,2610,
20221026,103,254,수원신갈,군자,1352,98,63,74,77,85,1749,1779,148,89,126,113,116,2371,
20221026,103,528,수원신갈,기흥동탄,1467,15,208,5,4,87,1786,2086,20,160,2,5,139,2412,
20221026,105,101,기흥,서울,5896,95,364,80,32,282,6749,7108,111,408,79,24,361,8091,
20221026,105,103,기흥,수원신갈,2167,30,33,28,29,130,2417,1580,27,54,22,30,108,1821,
20221026,105,253,기흥,서서울,895,27,9,13,10,49,1003,927,34,10,10,10,52,1043,
20221026,106,101,오산,서울,4230,410,450,177,106,315,5688,4003,355,444,163,100,259,5324,
20221026,106,103,오산,수원신갈,1334,69,75,85,17,91,1671,991,74,52,64,16,75,1272,
20221026,106,107,오산,안성,1743,47,27,25,15,179,2036,1506,47,18,16,8,150,1745,
20221026,106,108,오산,천안,1056,29,29,17,8,63,1202,1005,25,21,13,7,71,1142,
20221026,106,528,오산,기흥동탄,880,34,46,14,33,65,1072,926,33,45,20,34,86,1144,
20221026,107,101,안성,서울,2929,74,300,62,19,134,3518,3212,79,309,45,13,187,3845,
20221026,107,106,안성,오산,1506,47,18,16,8,150,1745,1743,47,27,25,15,179,2036,
20221026,107,108,안성,천안,1542,31,50,8,8,135,1774,1579,39,50,10,6,142,1826,
20221026,107,528,안성,기흥동탄,1007,19,26,2,3,97,1154,1197,19,27,7,4,112,1366,
20221026,107,742,안성,남사진위,1243,35,57,30,4,111,1480,1482,36,60,29,9,127,1743,
20221026,108,101,천안,서울,3636,51,340,51,17,172,4267,3522,65,330,51,14,158,4140,
20221026,108,103,천안,수원신갈,1192,12,51,17,1,59,1332,903,9,54,10,1,36,1013,
20221026,108,106,천안,오산,1005,25,21,13,7,71,1142,1056,29,29,17,8,63,1202,
20221026,108,107,천안,안성,1579,39,50,10,6,142,1826,1542,31,50,8,8,135,1774,
20221026,108,110,천안,목천,1228,29,76,26,37,80,1476,846,19,64,22,36,63,1050,
20221026,108,111,천안,청주,1190,40,63,28,44,71,1436,1141,28,46,28,42,83,1368,
20221026,108,229,천안,북천안,3483,79,129,59,47,208,4005,3985,87,144,69,89,250,4624,
20221026,108,528,천안,기흥동탄,1046,15,108,8,13,60,1250,1125,26,126,1,11,67,1356,
20221026,108,742,천안,남사진위,1165,20,35,30,8,76,1334,1173,28,37,31,9,74,1352,
20221026,110,108,목천,천안,846,19,64,22,36,63,1050,1228,29,76,26,37,80,1476,
20221026,111,101,청주,서울,807,22,215,20,19,27,1110,872,13,185,26,31,37,1164,
20221026,111,108,청주,천안,1141,28,46,28,42,83,1368,1190,40,63,28,44,71,1436,
20221026,112,115,남청주,대전,1606,84,59,6,24,113,1892,1621,96,59,10,6,122,1914,
20221026,113,115,신탄진,대전,973,22,10,7,14,113,1139,1162,32,12,12,8,132,1358,
20221026,113,198,신탄진,서청주,802,29,26,54,27,63,1001,893,27,21,29,16,69,1055,
20221026,114,153,남대전,서대전,1904,51,77,63,48,110,2253,1766,45,83,61,52,117,2124,
20221026,115,112,대전,남청주,1621,96,59,10,6,122,1914,1606,84,59,6,24,113,1892,
20221026,115,113,대전,신탄진,1162,32,12,12,8,132,1358,973,22,10,7,14,113,1139,
20221026,115,116,대전,옥천,2247,105,43,23,31,171,2620,2096,67,45,31,36,160,2435,
20221026,115,151,대전,북대전,1121,14,17,2,4,140,1298,917,11,14,3,8,112,1065,
20221026,115,152,대전,유성,1006,13,23,8,0,70,1120,923,14,25,4,2,76,1044,
20221026,115,153,대전,서대전,899,30,7,4,4,57,1001,931,17,12,3,4,66,1033,
20221026,115,579,대전,남세종,1042,10,14,3,5,93,1167,1055,12,19,4,4,82,1176,
20221026,116,115,옥천,대전,2096,67,45,31,36,160,2435,2247,105,43,23,31,171,2620,
20221026,119,153,판암,서대전,1734,31,17,14,73,149,2018,1757,40,24,9,59,156,2045,
20221026,123,127,구미,서대구,1665,29,24,14,8,95,1835,1712,22,24,23,11,95,1887,
20221026,123,129,구미,북대구,1844,18,55,10,2,80,2009,1897,17,63,6,5,102,2090,
20221026,123,130,구미,동김천,1205,25,30,30,29,72,1391,1174,26,31,24,27,76,1358,
20221026,125,127,남구미,서대구,1917,59,107,40,13,115,2251,2110,63,143,40,18,114,2488,
20221026,125,129,남구미,북대구,1834,20,64,6,12,102,2038,2038,30,84,24,9,114,2299,
20221026,126,127,왜관,서대구,2552,112,65,47,129,150,3055,2836,124,76,41,79,168,3324,
20221026,126,129,왜관,북대구,2966,89,45,20,100,136,3356,3392,114,57,21,68,147,3799,
20221026,127,123,서대구,구미,1712,22,24,23,11,95,1887,1665,29,24,14,8,95,1835,
20221026,127,125,서대구,남구미,2110,63,143,40,18,114,2488,1917,59,107,40,13,115,2251,
20221026,127,126,서대구,왜관,2836,124,76,41,79,168,3324,2552,112,65,47,129,150,3055,
20221026,127,131,서대구,경산,2508,204,140,114,62,149,3177,1908,161,99,79,62,116,2425,
20221026,127,203,서대구,가산,2098,82,74,44,115,92,2505,1944,67,64,26,147,84,2332,
20221026,127,230,서대구,팔공산,1444,42,18,17,6,102,1629,1037,26,22,16,7,84,1192,
20221026,127,518,서대구,칠곡물류,889,133,82,110,33,44,1291,746,89,60,94,26,45,1060,
20221026,127,621,서대구,동대구,1787,45,66,30,34,124,2086,1287,39,33,27,18,98,1502,
20221026,129,123,북대구,구미,1897,17,63,6,5,102,2090,1844,18,55,10,2,80,2009,
20221026,129,125,북대구,남구미,2038,30,84,24,9,114,2299,1834,20,64,6,12,102,2038,
20221026,129,126,북대구,왜관,3392,114,57,21,68,147,3799,2966,89,45,20,100,136,3356,
20221026,129,131,북대구,경산,2339,145,98,54,35,137,2808,2912,179,116,71,41,159,3478,
20221026,129,524,북대구,청통와촌,922,39,21,8,15,37,1042,1168,77,29,18,29,57,1378,
20221026,129,527,북대구,포항,1478,39,17,25,63,75,1697,1966,62,30,22,76,84,2240,
20221026,130,123,동김천,구미,1174,26,31,24,27,76,1358,1205,25,30,30,29,72,1391,
20221026,131,127,경산,서대구,1908,161,99,79,62,116,2425,2508,204,140,114,62,149,3177,
20221026,131,129,경산,북대구,2912,179,116,71,41,159,3478,2339,145,98,54,35,137,2808,
20221026,131,132,경산,영천,932,45,59,38,63,37,1174,871,40,63,41,37,46,1098,
20221026,131,230,경산,팔공산,1270,87,35,21,15,83,1511,1520,83,56,43,23,87,1812,
20221026,131,621,경산,동대구,2320,71,39,102,43,138,2713,2384,80,46,105,37,132,2784,
20221026,132,131,영천,경산,871,40,63,41,37,46,1098,932,45,59,38,63,37,1174,
20221026,132,621,영천,동대구,1137,13,25,2,26,44,1247,1198,15,24,3,12,50,1302,
20221026,135,140,경주,부산,1097,17,56,14,35,51,1270,1246,15,40,12,40,66,1419,
20221026,135,252,경주,대동,886,28,89,48,153,44,1248,1156,44,93,45,104,48,1490,
20221026,138,140,양산,부산,5132,255,175,85,269,278,6194,5324,291,186,108,260,289,6458,
20221026,138,252,양산,대동,2664,283,201,173,385,118,3824,2993,285,217,173,372,156,4196,
20221026,139,140,서울산,부산,1326,43,23,11,23,76,1502,1298,52,27,12,23,52,1464,
20221026,139,252,서울산,대동,823,49,63,26,44,50,1055,827,26,38,34,42,57,1024,
20221026,139,641,서울산,울산,1166,44,71,29,43,90,1443,1097,35,61,14,39,72,1318,
20221026,140,135,부산,경주,1246,15,40,12,40,66,1419,1097,17,56,14,35,51,1270,
20221026,140,138,부산,양산,5324,291,186,108,260,289,6458,5132,255,175,85,269,278,6194,
20221026,140,139,부산,서울산,1298,52,27,12,23,52,1464,1326,43,23,11,23,76,1502,
20221026,140,250,부산,남양산,7924,132,222,36,42,619,8975,7891,136,220,26,50,645,8968,
20221026,140,251,부산,물금,1068,119,27,29,74,70,1387,1005,103,28,23,56,68,1283,
20221026,140,252,부산,대동,1625,50,47,45,58,77,1902,1527,48,41,41,90,94,1841,
20221026,140,755,부산,광재,1103,16,28,5,54,68,1274,898,15,14,1,32,56,1016,
20221026,142,145,군북,산인,3989,69,117,46,139,301,4661,3747,50,125,47,104,279,4352,
20221026,143,145,장지,산인,1266,23,36,29,79,95,1528,1236,16,24,34,81,85,1476,
20221026,144,145,함안,산인,1978,46,36,29,66,130,2285,1885,49,35,20,68,135,2192,
20221026,145,142,산인,군북,3747,50,125,47,104,279,4352,3989,69,117,46,139,301,4661,
20221026,145,143,산인,장지,1236,16,24,34,81,85,1476,1266,23,36,29,79,95,1528,
20221026,145,144,산인,함안,1885,49,35,20,68,135,2192,1978,46,36,29,66,130,2285,
20221026,145,291,산인,사천,1129,31,54,15,25,49,1303,1377,66,66,20,38,65,1632,
20221026,145,292,산인,진주,1308,37,143,18,26,81,1613,1679,25,145,24,28,106,2007,
20221026,145,293,산인,문산,1223,23,23,12,4,71,1356,1216,31,23,15,9,70,1364,
20221026,146,150,동창원,북부산,1060,19,16,6,33,62,1196,938,13,19,10,24,66,1070,
20221026,146,244,동창원,서부산,1146,22,44,17,52,80,1361,1201,29,45,17,84,82,1458,
20221026,146,245,동창원,장유,942,18,13,6,24,79,1082,955,22,14,3,9,94,1097,
20221026,146,289,동창원,마산,2725,84,74,66,100,229,3278,2568,91,79,67,49,206,3060,
20221026,147,150,진례,북부산,1444,40,28,18,34,90,1654,1636,37,29,17,27,88,1834,
20221026,147,244,진례,서부산,1721,109,83,61,102,107,2183,1842,113,86,62,95,102,2300,
20221026,147,245,진례,장유,1104,62,96,46,16,104,1428,1466,52,101,47,26,136,1828,
20221026,147,289,진례,마산,1283,85,72,51,83,86,1660,1309,103,99,54,72,86,1723,
20221026,148,150,서김해,북부산,6531,127,91,88,88,546,7471,6385,126,76,97,58,499,7241,
20221026,148,251,서김해,물금,872,40,15,31,9,97,1064,864,45,13,34,16,89,1061,
20221026,148,289,서김해,마산,1361,25,64,13,9,101,1573,1526,40,62,19,20,86,1753,
20221026,149,150,동김해,북부산,10776,204,185,48,91,949,12253,9113,166,138,34,72,747,10270,
20221026,149,250,동김해,남양산,1173,26,62,6,5,96,1368,995,21,49,7,8,82,1162,
20221026,149,251,동김해,물금,1147,35,13,8,7,112,1322,1127,27,17,10,4,128,1313,
20221026,150,146,북부산,동창원,938,13,19,10,24,66,1070,1060,19,16,6,33,62,1196,
20221026,150,147,북부산,진례,1636,37,29,17,27,88,1834,1444,40,28,18,34,90,1654,
20221026,150,148,북부산,서김해,6385,126,76,97,58,499,7241,6531,127,91,88,88,546,7471,
20221026,150,149,북부산,동김해,9113,166,138,34,72,747,10270,10776,204,185,48,91,949,12253,
20221026,150,245,북부산,장유,3691,35,82,20,37,255,4120,3221,31,71,10,36,204,3573,
20221026,150,289,북부산,마산,2382,25,83,14,38,130,2672,3034,40,86,20,62,152,3394,
20221026,151,115,북대전,대전,917,11,14,3,8,112,1065,1121,14,17,2,4,140,1298,
20221026,151,153,북대전,서대전,1066,14,23,15,9,79,1206,1215,14,24,23,6,89,1371,
20221026,152,115,유성,대전,923,14,25,4,2,76,1044,1006,13,23,8,0,70,1120,
20221026,152,154,유성,안영,969,17,31,11,19,61,1108,1227,25,26,13,23,73,1387,
20221026,153,114,서대전,남대전,1766,45,83,61,52,117,2124,1904,51,77,63,48,110,2253,
20221026,153,115,서대전,대전,931,17,12,3,4,66,1033,899,30,7,4,4,57,1001,
20221026,153,119,서대전,판암,1757,40,24,9,59,156,2045,1734,31,17,14,73,149,2018,
20221026,153,151,서대전,북대전,1215,14,24,23,6,89,1371,1066,14,23,15,9,79,1206,
20221026,153,154,서대전,안영,1075,30,33,30,129,70,1367,1059,33,51,26,116,67,1352,
20221026,153,579,서대전,남세종,1201,17,19,12,8,91,1348,1017,14,25,6,13,81,1156,
20221026,154,152,안영,유성,1227,25,26,13,23,73,1387,969,17,31,11,19,61,1108,
20221026,154,153,안영,서대전,1059,33,51,26,116,67,1352,1075,30,33,30,129,70,1367,
20221026,159,167,서전주,광주,1318,50,71,47,41,42,1569,1298,70,65,56,28,41,1558,
20221026,166,167,장성,광주,2164,77,58,32,56,102,2489,2585,115,72,35,33,114,2954,
20221026,167,159,광주,서전주,1298,70,65,56,28,41,1558,1318,50,71,47,41,42,1569,
20221026,167,166,광주,장성,2585,115,72,35,33,114,2954,2164,77,58,32,56,102,2489,
20221026,167,567,광주,남고창,1258,33,56,15,29,48,1439,1295,31,53,12,34,46,1471,
20221026,171,101,마성,서울,2657,27,256,56,4,135,3135,2257,33,249,51,3,113,2706,
20221026,172,101,용인,서울,3747,143,120,49,32,244,4335,3453,137,117,30,27,196,3960,
20221026,172,102,용인,동수원,974,24,22,4,3,96,1123,1097,25,14,9,5,93,1243,
20221026,172,173,용인,양지,1948,237,136,140,57,134,2652,1807,182,153,142,73,146,2503,
20221026,172,212,용인,북수원,915,28,16,21,18,57,1055,1153,56,19,15,15,62,1320,
20221026,172,253,용인,서서울,1130,65,33,26,16,69,1339,1080,57,23,26,14,64,1264,
20221026,173,101,양지,서울,4306,407,137,160,101,161,5272,3395,230,109,96,83,137,4050,
20221026,173,102,양지,동수원,1374,48,27,11,10,79,1549,1256,50,34,7,17,61,1425,
20221026,173,172,양지,용인,1807,182,153,142,73,146,2503,1948,237,136,140,57,134,2652,
20221026,173,212,양지,북수원,1183,91,35,62,70,65,1506,1272,86,54,46,83,63,1604,
20221026,173,253,양지,서서울,1196,153,60,107,59,58,1633,940,123,60,115,53,47,1338,
20221026,173,254,양지,군자,723,122,85,186,230,35,1381,687,107,87,179,204,34,1298,
20221026,174,179,춘천,홍천,3077,75,88,49,20,321,3630,2980,84,83,42,26,314,3529,
20221026,174,216,춘천,횡성,1036,50,49,27,32,57,1251,1090,43,39,20,19,60,1271,
20221026,174,218,춘천,남원주,1120,22,71,16,24,70,1323,1009,20,72,12,25,61,1199,
20221026,174,554,춘천,동홍천,1140,22,17,14,2,87,1282,1130,10,19,8,1,80,1248,
20221026,175,101,덕평,서울,797,129,90,38,50,43,1147,753,72,85,56,62,45,1073,
20221026,176,190,이천,동서울,1461,58,188,164,111,75,2057,1491,57,187,136,80,74,2025,
20221026,179,174,홍천,춘천,2980,84,83,42,26,314,3529,3077,75,88,49,20,321,3630,
20221026,184,189,대관령,강릉,1182,44,64,6,7,94,1397,1284,41,56,6,7,94,1488,
20221026,189,184,강릉,대관령,1284,41,56,6,7,94,1488,1182,44,64,6,7,94,1397,
20221026,190,176,동서울,이천,1491,57,187,136,80,74,2025,1461,58,188,164,111,75,2057,
20221026,190,191,동서울,경기광주,10695,702,474,367,256,731,13225,9728,652,439,331,251,681,12082,
20221026,190,192,동서울,곤지암,6253,525,229,199,89,379,7674,5531,441,171,183,81,372,6779,
20221026,190,193,동서울,일죽,2361,175,198,201,116,82,3133,2380,164,176,245,113,75,3153,
20221026,190,194,동서울,서이천,4293,553,296,265,145,239,5791,3070,409,241,225,128,177,4250,
20221026,190,198,동서울,서청주,903,23,52,25,28,36,1067,901,23,39,41,22,36,1062,
20221026,190,560,동서울,감곡,972,28,37,36,78,35,1186,871,36,34,24,88,37,1090,
20221026,190,705,동서울,남이천,1477,92,51,130,89,43,1882,1660,106,49,116,79,47,2057,
20221026,191,190,경기광주,동서울,9728,652,439,331,251,681,12082,10695,702,474,367,256,731,13225,
20221026,192,190,곤지암,동서울,5531,441,171,183,81,372,6779,6253,525,229,199,89,379,7674,
20221026,192,194,곤지암,서이천,1352,259,123,155,111,92,2092,1058,180,101,104,163,92,1698,
20221026,193,190,일죽,동서울,2380,164,176,245,113,75,3153,2361,175,198,201,116,82,3133,
20221026,194,190,서이천,동서울,3070,409,241,225,128,177,4250,4293,553,296,265,145,239,5791,
20221026,194,192,서이천,곤지암,1058,180,101,104,163,92,1698,1352,259,123,155,111,92,2092,
20221026,196,198,진천,서청주,1268,38,93,58,32,87,1576,1331,33,83,37,33,98,1615,
20221026,198,113,서청주,신탄진,893,27,21,29,16,69,1055,802,29,26,54,27,63,1001,
20221026,198,190,서청주,동서울,901,23,39,41,22,36,1062,903,23,52,25,28,36,1067,
20221026,198,196,서청주,진천,1331,33,83,37,33,98,1615,1268,38,93,58,32,87,1576,
20221026,201,203,칠곡,가산,835,44,27,37,124,51,1118,838,46,42,37,128,52,1143,
20221026,203,127,가산,서대구,1944,67,64,26,147,84,2332,2098,82,74,44,115,92,2505,
20221026,203,201,가산,칠곡,838,46,42,37,128,52,1143,835,44,27,37,124,51,1118,
20221026,203,775,가산,동명동호,1655,59,64,50,285,80,2193,1579,69,55,43,221,74,2041,
20221026,212,102,북수원,동수원,4811,48,232,52,26,304,5473,4364,37,236,50,39,255,4981,
20221026,212,172,북수원,용인,1153,56,19,15,15,62,1320,915,28,16,21,18,57,1055,
20221026,212,173,북수원,양지,1272,86,54,46,83,63,1604,1183,91,35,62,70,65,1506,
20221026,212,253,북수원,서서울,2705,60,26,20,17,153,2981,1013,29,11,10,9,70,1142,
20221026,212,254,북수원,군자,1694,31,32,20,25,92,1894,1059,25,21,12,19,62,1198,
20221026,213,102,부곡,동수원,1024,21,16,4,23,83,1171,1050,17,16,6,27,89,1205,
20221026,213,253,부곡,서서울,1437,93,34,34,171,97,1866,1043,55,33,45,133,76,1385,
20221026,213,254,부곡,군자,931,30,27,50,457,62,1557,864,33,27,37,427,55,1443,
20221026,214,102,동군포,동수원,1586,24,17,7,5,97,1736,1503,26,18,13,4,92,1656,
20221026,215,102,군포,동수원,2370,21,47,7,26,174,2645,1693,22,30,5,15,106,1871,
20221026,215,253,군포,서서울,3183,101,47,31,60,230,3652,3816,166,160,171,112,272,4697,
20221026,215,254,군포,군자,2006,60,54,45,105,133,2403,2768,126,96,127,174,179,3470,
20221026,215,255,군포,서안산,1288,45,35,17,15,97,1497,1469,68,77,70,86,113,1883,
20221026,216,174,횡성,춘천,1090,43,39,20,19,60,1271,1036,50,49,27,32,57,1251,
20221026,218,174,남원주,춘천,1009,20,72,12,25,61,1199,1120,22,71,16,24,70,1323,
20221026,218,240,남원주,제천,2126,48,49,18,58,139,2438,2107,55,40,24,40,130,2396,
20221026,225,291,서진주,사천,976,30,24,12,24,77,1143,1020,20,28,7,28,76,1179,
20221026,229,101,북천안,서울,854,52,44,54,26,32,1062,813,50,53,46,25,36,1023,
20221026,229,108,북천안,천안,3985,87,144,69,89,250,4624,3483,79,129,59,47,208,4005,
20221026,230,127,팔공산,서대구,1037,26,22,16,7,84,1192,1444,42,18,17,6,102,1629,
20221026,230,131,팔공산,경산,1520,83,56,43,23,87,1812,1270,87,35,21,15,83,1511,
20221026,230,524,팔공산,청통와촌,1159,41,35,12,23,53,1323,1010,42,28,7,25,55,1167,
20221026,230,527,팔공산,포항,1459,30,17,11,22,55,1594,1307,29,13,14,17,49,1429,
20221026,231,519,화원옥포,남대구,6441,183,90,107,167,505,7493,6258,151,102,104,107,493,7215,
20221026,232,519,달성,남대구,2783,125,154,53,43,191,3349,2905,135,157,55,29,189,3470,
20221026,233,519,현풍,남대구,4978,231,195,68,112,336,5920,4403,193,180,94,107,297,5274,
20221026,238,239,칠서,칠원,1796,102,115,122,475,111,2721,1649,99,99,93,410,106,2456,
20221026,239,238,칠원,칠서,1649,99,99,93,410,106,2456,1796,102,115,122,475,111,2721,
20221026,239,519,칠원,남대구,1039,41,81,32,104,44,1341,1233,57,93,52,95,53,1583,
20221026,240,218,제천,남원주,2107,55,40,24,40,130,2396,2126,48,49,18,58,139,2438,
20221026,241,519,동고령,남대구,3072,93,81,227,136,130,3739,2954,97,83,216,162,147,3659,
20221026,242,519,고령,남대구,1538,33,41,23,202,83,1920,1691,38,45,13,199,71,2057,
20221026,244,146,서부산,동창원,1201,29,45,17,84,82,1458,1146,22,44,17,52,80,1361,
20221026,244,147,서부산,진례,1842,113,86,62,95,102,2300,1721,109,83,61,102,107,2183,
20221026,244,245,서부산,장유,12888,248,409,137,326,945,14953,12600,248,404,146,345,957,14700,
20221026,244,289,서부산,마산,2861,56,267,50,89,139,3462,3105,88,274,62,88,146,3763,
20221026,245,146,장유,동창원,955,22,14,3,9,94,1097,942,18,13,6,24,79,1082,
20221026,245,147,장유,진례,1466,52,101,47,26,136,1828,1104,62,96,46,16,104,1428,
20221026,245,150,장유,북부산,3221,31,71,10,36,204,3573,3691,35,82,20,37,255,4120,
20221026,245,244,장유,서부산,12600,248,404,146,345,957,14700,12888,248,409,137,326,945,14953,
20221026,245,289,장유,마산,1347,31,43,17,14,116,1568,1466,37,54,28,15,117,1717,
20221026,248,261,순창,동광주,1146,19,22,5,10,40,1242,1323,21,36,13,6,56,1455,
20221026,249,261,담양,동광주,2219,32,135,44,29,93,2552,1897,30,126,49,22,78,2202,
20221026,250,140,남양산,부산,7891,136,220,26,50,645,8968,7924,132,222,36,42,619,8975,
20221026,250,149,남양산,동김해,995,21,49,7,8,82,1162,1173,26,62,6,5,96,1368,
20221026,250,252,남양산,대동,3440,149,116,143,129,242,4219,4094,179,125,140,139,296,4973,
20221026,251,140,물금,부산,1005,103,28,23,56,68,1283,1068,119,27,29,74,70,1387,
20221026,251,148,물금,서김해,864,45,13,34,16,89,1061,872,40,15,31,9,97,1064,
20221026,251,149,물금,동김해,1127,27,17,10,4,128,1313,1147,35,13,8,7,112,1322,
20221026,251,252,물금,대동,3121,217,95,153,516,259,4361,3793,221,110,132,579,306,5141,
20221026,252,135,대동,경주,1156,44,93,45,104,48,1490,886,28,89,48,153,44,1248,
20221026,252,138,대동,양산,2993,285,217,173,372,156,4196,2664,283,201,173,385,118,3824,
20221026,252,139,대동,서울산,827,26,38,34,42,57,1024,823,49,63,26,44,50,1055,
20221026,252,140,대동,부산,1527,48,41,41,90,94,1841,1625,50,47,45,58,77,1902,
20221026,252,250,대동,남양산,4094,179,125,140,139,296,4973,3440,149,116,143,129,242,4219,
20221026,252,251,대동,물금,3793,221,110,132,579,306,5141,3121,217,95,153,516,259,4361,
20221026,252,641,대동,울산,1596,67,88,38,67,102,1958,1251,64,93,36,60,71,1575,
20221026,252,752,대동,기장철마,1930,55,54,50,116,137,2342,1889,67,58,47,74,153,2288,
20221026,252,753,대동,금정,1869,105,112,102,199,129,2516,1043,89,65,84,111,69,1461,
20221026,252,755,대동,광재,2338,90,94,92,337,159,3110,2057,71,63,76,380,127,2774,
20221026,252,756,대동,한림,887,42,34,29,101,41,1134,879,45,34,31,100,38,1127,
20221026,253,102,서서울,동수원,5297,78,89,21,19,346,5850,6045,69,68,14,25,368,6589,
20221026,253,103,서서울,수원신갈,2131,153,84,82,35,125,2610,2021,148,81,64,20,129,2463,
20221026,253,105,서서울,기흥,927,34,10,10,10,52,1043,895,27,9,13,10,49,1003,
20221026,253,172,서서울,용인,1080,57,23,26,14,64,1264,1130,65,33,26,16,69,1339,
20221026,253,173,서서울,양지,940,123,60,115,53,47,1338,1196,153,60,107,59,58,1633,
20221026,253,212,서서울,북수원,1013,29,11,10,9,70,1142,2705,60,26,20,17,153,2981,
20221026,253,213,서서울,부곡,1043,55,33,45,133,76,1385,1437,93,34,34,171,97,1866,
20221026,253,215,서서울,군포,3816,166,160,171,112,272,4697,3183,101,47,31,60,230,3652,
20221026,253,255,서서울,서안산,15215,531,700,610,324,898,18278,14764,538,648,552,298,894,17694,
20221026,253,256,서서울,안산,8813,166,94,36,24,651,9784,5819,123,85,34,49,417,6527,
20221026,253,281,서서울,매송,3370,53,32,15,16,222,3708,3998,68,47,20,63,268,4464,
20221026,253,282,서서울,비봉,5229,235,231,147,355,317,6514,5733,304,269,188,386,390,7270,
20221026,253,283,서서울,발안,3259,176,167,168,109,197,4076,3711,210,185,202,118,230,4656,
20221026,253,285,서서울,서평택,1424,57,115,271,369,104,2340,1557,92,139,365,501,114,2768,
20221026,253,287,서서울,송악,1649,44,71,65,206,69,2104,1885,53,57,119,428,72,2614,
20221026,253,288,서서울,당진,1228,37,50,35,18,64,1432,1262,26,51,50,62,55,1506,
20221026,253,298,서서울,서산,2008,29,79,55,21,84,2276,2135,24,78,90,56,80,2463,
20221026,253,520,서서울,평택,2046,95,116,184,146,95,2682,1880,102,109,240,132,82,2545,
20221026,253,540,서서울,청북,807,43,68,103,64,51,1136,775,68,48,104,91,46,1132,
20221026,253,741,서서울,평택고덕,900,38,13,14,14,62,1041,859,33,22,36,12,71,1033,
20221026,254,102,군자,동수원,4073,66,86,23,40,260,4548,3704,45,73,20,31,198,4071,
20221026,254,103,군자,수원신갈,1779,148,89,126,113,116,2371,1352,98,63,74,77,85,1749,
20221026,254,173,군자,양지,687,107,87,179,204,34,1298,723,122,85,186,230,35,1381,
20221026,254,212,군자,북수원,1059,25,21,12,19,62,1198,1694,31,32,20,25,92,1894,
20221026,254,213,군자,부곡,864,33,27,37,427,55,1443,931,30,27,50,457,62,1557,
20221026,254,215,군자,군포,2768,126,96,127,174,179,3470,2006,60,54,45,105,133,2403,
20221026,254,255,군자,서안산,9760,419,215,229,277,701,11601,9366,381,199,211,284,658,11099,
20221026,254,256,군자,안산,4543,132,119,41,63,384,5282,4924,131,117,57,65,380,5674,
20221026,254,281,군자,매송,979,36,16,18,56,57,1162,927,31,15,14,50,60,1097,
20221026,254,282,군자,비봉,1256,108,84,66,205,85,1804,1061,94,83,55,176,76,1545,
20221026,254,283,군자,발안,1129,87,74,73,149,70,1582,994,76,60,65,115,56,1366,
20221026,255,102,서안산,동수원,1910,37,15,11,6,115,2094,1803,37,14,9,8,94,1965,
20221026,255,215,서안산,군포,1469,68,77,70,86,113,1883,1288,45,35,17,15,97,1497,
20221026,255,253,서안산,서서울,14764,538,648,552,298,894,17694,15215,531,700,610,324,898,18278,
20221026,255,254,서안산,군자,9366,381,199,211,284,658,11099,9760,419,215,229,277,701,11601,
20221026,256,253,안산,서서울,5819,123,85,34,49,417,6527,8813,166,94,36,24,651,9784,
20221026,256,254,안산,군자,4924,131,117,57,65,380,5674,4543,132,119,41,63,384,5282,
20221026,261,248,동광주,순창,1323,21,36,13,6,56,1455,1146,19,22,5,10,40,1242,
20221026,261,249,동광주,담양,1897,30,126,49,22,78,2202,2219,32,135,44,29,93,2552,
20221026,261,263,동광주,옥과,2785,33,136,17,88,134,3193,2442,17,115,7,94,104,2779,
20221026,261,265,동광주,곡성,1392,29,59,26,39,50,1595,1256,12,48,14,30,39,1399,
20221026,261,271,동광주,순천,2945,87,71,31,100,104,3338,2454,83,65,17,99,61,2779,
20221026,263,261,옥과,동광주,2442,17,115,7,94,104,2779,2785,33,136,17,88,134,3193,
20221026,265,261,곡성,동광주,1256,12,48,14,30,39,1399,1392,29,59,26,39,50,1595,
20221026,271,261,순천,동광주,2454,83,65,17,99,61,2779,2945,87,71,31,100,104,3338,
20221026,271,569,순천,북광주,809,74,36,23,135,21,1098,780,61,37,26,111,17,1032,
20221026,281,253,매송,서서울,3998,68,47,20,63,268,4464,3370,53,32,15,16,222,3708,
20221026,281,254,매송,군자,927,31,15,14,50,60,1097,979,36,16,18,56,57,1162,
20221026,282,253,비봉,서서울,5733,304,269,188,386,390,7270,5229,235,231,147,355,317,6514,
20221026,282,254,비봉,군자,1061,94,83,55,176,76,1545,1256,108,84,66,205,85,1804,
20221026,283,253,발안,서서울,3711,210,185,202,118,230,4656,3259,176,167,168,109,197,4076,
20221026,283,254,발안,군자,994,76,60,65,115,56,1366,1129,87,74,73,149,70,1582,
20221026,285,253,서평택,서서울,1557,92,139,365,501,114,2768,1424,57,115,271,369,104,2340,
20221026,285,287,서평택,송악,634,40,80,63,585,42,1444,663,50,84,74,519,44,1434,
20221026,285,520,서평택,평택,659,38,67,83,98,65,1010,746,42,66,75,115,74,1118,
20221026,287,253,송악,서서울,1885,53,57,119,428,72,2614,1649,44,71,65,206,69,2104,
20221026,287,285,송악,서평택,663,50,84,74,519,44,1434,634,40,80,63,585,42,1444,
20221026,288,253,당진,서서울,1262,26,51,50,62,55,1506,1228,37,50,35,18,64,1432,
20221026,289,146,마산,동창원,2568,91,79,67,49,206,3060,2725,84,74,66,100,229,3278,
20221026,289,147,마산,진례,1309,103,99,54,72,86,1723,1283,85,72,51,83,86,1660,
20221026,289,148,마산,서김해,1526,40,62,19,20,86,1753,1361,25,64,13,9,101,1573,
20221026,289,150,마산,북부산,3034,40,86,20,62,152,3394,2382,25,83,14,38,130,2672,
20221026,289,244,마산,서부산,3105,88,274,62,88,146,3763,2861,56,267,50,89,139,3462,
20221026,289,245,마산,장유,1466,37,54,28,15,117,1717,1347,31,43,17,14,116,1568,
20221026,289,757,마산,진영,759,47,64,39,89,50,1048,830,61,51,49,73,51,1115,
20221026,291,145,사천,산인,1377,66,66,20,38,65,1632,1129,31,54,15,25,49,1303,
20221026,291,225,사천,서진주,1020,20,28,7,28,76,1179,976,30,24,12,24,77,1143,
20221026,291,292,사천,진주,2709,69,91,44,38,287,3238,3423,87,110,53,55,312,4040,
20221026,292,145,진주,산인,1679,25,145,24,28,106,2007,1308,37,143,18,26,81,1613,
20221026,292,291,진주,사천,3423,87,110,53,55,312,4040,2709,69,91,44,38,287,3238,
20221026,293,145,문산,산인,1216,31,23,15,9,70,1364,1223,23,23,12,4,71,1356,
20221026,298,253,서산,서서울,2135,24,78,90,56,80,2463,2008,29,79,55,21,84,2276,
20221026,508,509,무안,목포,1440,48,50,31,77,78,1724,1758,45,47,29,65,83,2027,
20221026,508,553,무안,동광산,1538,36,53,13,18,61,1719,1561,31,59,19,23,70,1763,
20221026,509,508,목포,무안,1758,45,47,29,65,83,2027,1440,48,50,31,77,78,1724,
20221026,509,553,목포,동광산,6673,164,241,134,396,256,7864,6683,149,240,189,420,237,7918,
20221026,513,515,고성,북통영,1414,38,68,15,31,98,1664,1516,39,70,14,28,108,1775,
20221026,513,516,고성,통영,2947,87,159,89,137,218,3637,2831,94,147,85,113,217,3487,
20221026,514,516,동고성,통영,1283,17,69,47,128,170,1714,1276,12,81,50,125,163,1707,
20221026,515,513,북통영,고성,1516,39,70,14,28,108,1775,1414,38,68,15,31,98,1664,
20221026,516,513,통영,고성,2831,94,147,85,113,217,3487,2947,87,159,89,137,218,3637,
20221026,516,514,통영,동고성,1276,12,81,50,125,163,1707,1283,17,69,47,128,170,1714,
20221026,517,598,양평,북여주,1005,32,26,51,79,45,1238,883,21,16,36,28,36,1020,
20221026,518,127,칠곡물류,서대구,746,89,60,94,26,45,1060,889,133,82,110,33,44,1291,
20221026,519,231,남대구,화원옥포,6258,151,102,104,107,493,7215,6441,183,90,107,167,505,7493,
20221026,519,232,남대구,달성,2905,135,157,55,29,189,3470,2783,125,154,53,43,191,3349,
20221026,519,233,남대구,현풍,4403,193,180,94,107,297,5274,4978,231,195,68,112,336,5920,
20221026,519,239,남대구,칠원,1233,57,93,52,95,53,1583,1039,41,81,32,104,44,1341,
20221026,519,241,남대구,동고령,2954,97,83,216,162,147,3659,3072,93,81,227,136,130,3739,
20221026,519,242,남대구,고령,1691,38,45,13,199,71,2057,1538,33,41,23,202,83,1920,
20221026,519,730,남대구,유천,2482,52,17,0,11,166,2728,2819,57,11,0,1,191,3079,
20221026,519,731,남대구,북현풍,1899,26,26,0,1,130,2082,1513,18,4,0,0,121,1656,
20221026,520,253,평택,서서울,1880,102,109,240,132,82,2545,2046,95,116,184,146,95,2682,
20221026,520,285,평택,서평택,746,42,66,75,115,74,1118,659,38,67,83,98,65,1010,
20221026,520,540,평택,청북,1083,106,176,129,110,70,1674,840,101,159,135,96,36,1367,
20221026,520,741,평택,평택고덕,955,10,201,14,17,73,1270,819,14,173,19,28,73,1126,
20221026,524,129,청통와촌,북대구,1168,77,29,18,29,57,1378,922,39,21,8,15,37,1042,
20221026,524,230,청통와촌,팔공산,1010,42,28,7,25,55,1167,1159,41,35,12,23,53,1323,
20221026,526,527,서포항,포항,881,11,24,8,27,72,1023,1005,16,21,9,19,88,1158,
20221026,527,129,포항,북대구,1966,62,30,22,76,84,2240,1478,39,17,25,63,75,1697,
20221026,527,230,포항,팔공산,1307,29,13,14,17,49,1429,1459,30,17,11,22,55,1594,
20221026,527,526,포항,서포항,1005,16,21,9,19,88,1158,881,11,24,8,27,72,1023,
20221026,528,101,기흥동탄,서울,7627,76,1319,122,17,338,9499,7261,74,1191,134,18,352,9030,
20221026,528,103,기흥동탄,수원신갈,2086,20,160,2,5,139,2412,1467,15,208,5,4,87,1786,
20221026,528,106,기흥동탄,오산,926,33,45,20,34,86,1144,880,34,46,14,33,65,1072,
20221026,528,107,기흥동탄,안성,1197,19,27,7,4,112,1366,1007,19,26,2,3,97,1154,
20221026,528,108,기흥동탄,천안,1125,26,126,1,11,67,1356,1046,15,108,8,13,60,1250,
20221026,540,253,청북,서서울,775,68,48,104,91,46,1132,807,43,68,103,64,51,1136,
20221026,540,520,청북,평택,840,101,159,135,96,36,1367,1083,106,176,129,110,70,1674,
20221026,540,741,청북,평택고덕,890,33,49,48,109,86,1215,976,42,58,52,136,98,1362,
20221026,542,101,서안성,서울,1745,60,77,165,50,100,2197,1144,40,77,97,27,66,1451,
20221026,542,543,서안성,남안성,1097,42,99,115,119,105,1577,1234,47,96,99,93,97,1666,
20221026,543,101,남안성,서울,1237,99,84,99,102,57,1678,1145,67,64,59,51,49,1435,
20221026,543,542,남안성,서안성,1234,47,96,99,93,97,1666,1097,42,99,115,119,105,1577,
20221026,543,555,남안성,북진천,814,104,165,181,169,41,1474,788,110,164,185,182,50,1479,
20221026,548,553,북무안,동광산,1247,27,32,30,38,36,1410,1413,24,35,44,56,38,1610,
20221026,549,553,동함평,동광산,3652,35,76,29,56,140,3988,3663,44,87,40,51,140,4025,
20221026,551,553,나주,동광산,1341,32,25,158,55,69,1680,1370,28,35,155,48,65,1701,
20221026,552,553,서광산,동광산,4421,194,198,237,240,174,5464,6034,215,230,232,221,226,7158,
20221026,553,508,동광산,무안,1561,31,59,19,23,70,1763,1538,36,53,13,18,61,1719,
20221026,553,509,동광산,목포,6683,149,240,189,420,237,7918,6673,164,241,134,396,256,7864,
20221026,553,548,동광산,북무안,1413,24,35,44,56,38,1610,1247,27,32,30,38,36,1410,
20221026,553,549,동광산,동함평,3663,44,87,40,51,140,4025,3652,35,76,29,56,140,3988,
20221026,553,551,동광산,나주,1370,28,35,155,48,65,1701,1341,32,25,158,55,69,1680,
20221026,553,552,동광산,서광산,6034,215,230,232,221,226,7158,4421,194,198,237,240,174,5464,
20221026,554,174,동홍천,춘천,1130,10,19,8,1,80,1248,1140,22,17,14,2,87,1282,
20221026,555,543,북진천,남안성,788,110,164,185,182,50,1479,814,104,165,181,169,41,1474,
20221026,560,190,감곡,동서울,871,36,34,24,88,37,1090,972,28,37,36,78,35,1186,
20221026,567,167,남고창,광주,1295,31,53,12,34,46,1471,1258,33,56,15,29,48,1439,
20221026,569,271,북광주,순천,780,61,37,26,111,17,1032,809,74,36,23,135,21,1098,
20221026,579,115,남세종,대전,1055,12,19,4,4,82,1176,1042,10,14,3,5,93,1167,
20221026,579,153,남세종,서대전,1017,14,25,6,13,81,1156,1201,17,19,12,8,91,1348,
20221026,587,589,오수,상관,1073,17,50,32,43,41,1256,1182,20,57,23,98,39,1419,
20221026,589,587,상관,오수,1182,20,57,23,98,39,1419,1073,17,50,32,43,41,1256,
20221026,597,598,서여주,북여주,1028,50,116,34,62,49,1339,1016,22,91,34,61,51,1275,
20221026,598,517,북여주,양평,883,21,16,36,28,36,1020,1005,32,26,51,79,45,1238,
20221026,598,597,북여주,서여주,1016,22,91,34,61,51,1275,1028,50,116,34,62,49,1339,
20221026,621,127,동대구,서대구,1287,39,33,27,18,98,1502,1787,45,66,30,34,124,2086,
20221026,621,131,동대구,경산,2384,80,46,105,37,132,2784,2320,71,39,102,43,138,2713,
20221026,621,132,동대구,영천,1198,15,24,3,12,50,1302,1137,13,25,2,26,44,1247,
20221026,625,626,밀양,남밀양,1198,80,60,42,73,60,1513,1541,61,63,42,61,89,1857,
20221026,626,625,남밀양,밀양,1541,61,63,42,61,89,1857,1198,80,60,42,73,60,1513,
20221026,626,627,남밀양,삼랑진,971,25,45,20,61,95,1217,972,30,25,20,46,82,1175,
20221026,627,626,삼랑진,남밀양,972,30,25,20,46,82,1175,971,25,45,20,61,95,1217,
20221026,641,139,울산,서울산,1097,35,61,14,39,72,1318,1166,44,71,29,43,90,1443,
20221026,641,252,울산,대동,1251,64,93,36,60,71,1575,1596,67,88,38,67,102,1958,
20221026,641,643,울산,청량,1246,11,15,17,66,123,1478,1322,10,15,17,30,138,1532,
20221026,641,648,울산,해운대,941,3,12,1,0,64,1021,1092,11,20,2,3,80,1208,
20221026,641,706,울산,남경주,1076,6,25,9,21,68,1205,1120,6,29,18,20,54,1247,
20221026,641,707,울산,남포항,1098,21,29,13,138,50,1349,1052,20,26,24,148,48,1318,
20221026,643,641,청량,울산,1322,10,15,17,30,138,1532,1246,11,15,17,66,123,1478,
20221026,643,648,청량,해운대,2932,17,34,19,39,198,3239,3221,34,80,60,562,201,4158,
20221026,645,648,장안,해운대,1631,9,17,3,6,99,1765,2920,32,24,98,104,171,3349,
20221026,646,648,기장일광,해운대,4681,19,29,8,21,256,5014,5380,40,46,21,206,309,6002,
20221026,648,641,해운대,울산,1092,11,20,2,3,80,1208,941,3,12,1,0,64,1021,
20221026,648,643,해운대,청량,3221,34,80,60,562,201,4158,2932,17,34,19,39,198,3239,
20221026,648,645,해운대,장안,2920,32,24,98,104,171,3349,1631,9,17,3,6,99,1765,
20221026,648,646,해운대,기장일광,5380,40,46,21,206,309,6002,4681,19,29,8,21,256,5014,
20221026,651,652,남양주,화도,14149,534,547,489,281,1064,17064,16256,569,623,535,287,1261,19531,
20221026,651,653,남양주,서종,1758,15,6,3,22,93,1897,1887,17,9,5,18,80,2016,
20221026,651,654,남양주,설악,3711,33,80,23,21,145,4013,3499,31,71,16,10,122,3749,
20221026,651,655,남양주,강촌,2411,36,117,26,32,71,2693,2372,28,117,27,34,74,2652,
20221026,651,656,남양주,남춘천,2603,40,55,29,78,88,2893,2148,24,44,15,56,58,2345,
20221026,652,651,화도,남양주,16256,569,623,535,287,1261,19531,14149,534,547,489,281,1064,17064,
20221026,652,653,화도,서종,1432,42,22,41,21,111,1669,1469,33,22,39,18,117,1698,
20221026,652,654,화도,설악,1309,21,20,6,53,83,1492,1218,19,27,19,43,88,1414,
20221026,653,651,서종,남양주,1887,17,9,5,18,80,2016,1758,15,6,3,22,93,1897,
20221026,653,652,서종,화도,1469,33,22,39,18,117,1698,1432,42,22,41,21,111,1669,
20221026,654,651,설악,남양주,3499,31,71,16,10,122,3749,3711,33,80,23,21,145,4013,
20221026,654,652,설악,화도,1218,19,27,19,43,88,1414,1309,21,20,6,53,83,1492,
20221026,655,651,강촌,남양주,2372,28,117,27,34,74,2652,2411,36,117,26,32,71,2693,
20221026,656,651,남춘천,남양주,2148,24,44,15,56,58,2345,2603,40,55,29,78,88,2893,
20221026,671,672,봉담,정남,3256,185,95,130,142,266,4074,3737,178,85,168,193,286,4647,
20221026,671,673,봉담,북오산,2030,65,50,24,13,163,2345,2149,53,57,28,24,168,2479,
20221026,671,675,봉담,서오산,934,31,21,5,10,66,1067,969,22,20,4,16,77,1108,
20221026,671,676,봉담,향남,1358,101,54,35,34,103,1685,1183,95,40,26,42,85,1471,
20221026,671,677,봉담,북평택,7932,213,218,154,315,478,9310,7425,170,220,147,233,435,8630,
20221026,672,671,정남,봉담,3737,178,85,168,193,286,4647,3256,185,95,130,142,266,4074,
20221026,673,101,북오산,서울,1564,49,120,26,15,97,1871,1518,48,122,29,14,99,1830,
20221026,673,671,북오산,봉담,2149,53,57,28,24,168,2479,2030,65,50,24,13,163,2345,
20221026,673,677,북오산,북평택,2080,36,93,35,38,130,2412,2015,37,52,22,34,138,2298,
20221026,675,671,서오산,봉담,969,22,20,4,16,77,1108,934,31,21,5,10,66,1067,
20221026,675,676,서오산,향남,3587,116,78,46,174,248,4249,3072,98,74,36,137,189,3606,
20221026,675,677,서오산,북평택,11359,264,420,172,170,782,13167,10801,245,375,190,171,696,12478,
20221026,675,876,서오산,양감,1867,71,40,35,103,118,2234,2215,58,36,28,95,166,2598,
20221026,676,671,향남,봉담,1183,95,40,26,42,85,1471,1358,101,54,35,34,103,1685,
20221026,676,675,향남,서오산,3072,98,74,36,137,189,3606,3587,116,78,46,174,248,4249,
20221026,676,677,향남,북평택,1683,162,179,221,146,83,2474,1513,143,120,201,109,87,2173,
20221026,677,101,북평택,서울,1304,64,256,94,139,68,1925,1573,59,275,96,121,88,2212,
20221026,677,671,북평택,봉담,7425,170,220,147,233,435,8630,7932,213,218,154,315,478,9310,
20221026,677,673,북평택,북오산,2015,37,52,22,34,138,2298,2080,36,93,35,38,130,2412,
20221026,677,675,북평택,서오산,10801,245,375,190,171,696,12478,11359,264,420,172,170,782,13167,
20221026,677,676,북평택,향남,1513,143,120,201,109,87,2173,1683,162,179,221,146,83,2474,
20221026,677,876,북평택,양감,2182,157,195,182,188,163,3067,2135,154,178,197,182,165,3011,
20221026,682,683,조암,송산마도,812,80,109,94,47,41,1183,962,99,115,97,52,42,1367,
20221026,682,684,조암,남안산,1035,179,178,99,108,50,1649,1072,150,167,111,85,45,1630,
20221026,682,685,조암,서시흥,1745,204,177,167,295,94,2682,1819,185,184,153,329,109,2779,
20221026,683,682,송산마도,조암,962,99,115,97,52,42,1367,812,80,109,94,47,41,1183,
20221026,683,684,송산마도,남안산,2591,189,185,113,294,152,3524,2269,183,135,98,233,123,3041,
20221026,683,685,송산마도,서시흥,5128,299,232,203,1014,265,7141,4536,286,229,234,976,271,6532,
20221026,684,682,남안산,조암,1072,150,167,111,85,45,1630,1035,179,178,99,108,50,1649,
20221026,684,683,남안산,송산마도,2269,183,135,98,233,123,3041,2591,189,185,113,294,152,3524,
20221026,684,685,남안산,서시흥,5443,547,306,430,582,378,7686,4884,391,354,353,431,338,6751,
20221026,685,682,서시흥,조암,1819,185,184,153,329,109,2779,1745,204,177,167,295,94,2682,
20221026,685,683,서시흥,송산마도,4536,286,229,234,976,271,6532,5128,299,232,203,1014,265,7141,
20221026,685,684,서시흥,남안산,4884,391,354,353,431,338,6751,5443,547,306,430,582,378,7686,
20221026,705,190,남이천,동서울,1660,106,49,116,79,47,2057,1477,92,51,130,89,43,1882,
20221026,706,641,남경주,울산,1120,6,29,18,20,54,1247,1076,6,25,9,21,68,1205,
20221026,706,707,남경주,남포항,959,32,70,36,256,60,1413,1040,40,80,33,184,57,1434,
20221026,707,641,남포항,울산,1052,20,26,24,148,48,1318,1098,21,29,13,138,50,1349,
20221026,707,706,남포항,남경주,1040,40,80,33,184,57,1434,959,32,70,36,256,60,1413,
20221026,707,708,남포항,동경주,1367,27,32,23,212,84,1745,1321,35,40,26,248,79,1749,
20221026,708,707,동경주,남포항,1321,35,40,26,248,79,1749,1367,27,32,23,212,84,1745,
20221026,715,716,동안동,청송,1177,14,14,17,23,55,1300,1141,23,14,19,25,58,1280,
20221026,716,715,청송,동안동,1141,23,14,19,25,58,1280,1177,14,14,17,23,55,1300,
20221026,730,519,유천,남대구,2819,57,11,0,1,191,3079,2482,52,17,0,11,166,2728,
20221026,731,519,북현풍,남대구,1513,18,4,0,0,121,1656,1899,26,26,0,1,130,2082,
20221026,741,253,평택고덕,서서울,859,33,22,36,12,71,1033,900,38,13,14,14,62,1041,
20221026,741,520,평택고덕,평택,819,14,173,19,28,73,1126,955,10,201,14,17,73,1270,
20221026,741,540,평택고덕,청북,976,42,58,52,136,98,1362,890,33,49,48,109,86,1215,
20221026,742,107,남사진위,안성,1482,36,60,29,9,127,1743,1243,35,57,30,4,111,1480,
20221026,742,108,남사진위,천안,1173,28,37,31,9,74,1352,1165,20,35,30,8,76,1334,
20221026,752,252,기장철마,대동,1889,67,58,47,74,153,2288,1930,55,54,50,116,137,2342,
20221026,753,252,금정,대동,1043,89,65,84,111,69,1461,1869,105,112,102,199,129,2516,
20221026,755,140,광재,부산,898,15,14,1,32,56,1016,1103,16,28,5,54,68,1274,
20221026,755,252,광재,대동,2057,71,63,76,380,127,2774,2338,90,94,92,337,159,3110,
20221026,756,252,한림,대동,879,45,34,31,100,38,1127,887,42,34,29,101,41,1134,
20221026,757,289,진영,마산,830,61,51,49,73,51,1115,759,47,64,39,89,50,1048,
20221026,772,774,북달성,남칠곡,2548,58,64,35,27,141,2873,2535,57,62,36,24,139,2853,
20221026,773,774,북다사,남칠곡,1357,29,22,12,21,92,1533,1242,28,24,12,11,93,1410,
20221026,774,772,남칠곡,북달성,2535,57,62,36,24,139,2853,2548,58,64,35,27,141,2873,
20221026,774,773,남칠곡,북다사,1242,28,24,12,11,93,1410,1357,29,22,12,21,92,1533,
20221026,775,203,동명동호,가산,1579,69,55,43,221,74,2041,1655,59,64,50,285,80,2193,
20221026,776,777,연경,파군재,3588,44,34,12,33,288,3999,2625,32,27,19,23,171,2897,
20221026,776,779,연경,율암,5707,92,96,64,180,438,6577,6045,109,91,65,161,463,6934,
20221026,777,776,파군재,연경,2625,32,27,19,23,171,2897,3588,44,34,12,33,288,3999,
20221026,777,779,파군재,율암,2619,17,21,5,2,233,2897,2654,17,16,8,9,215,2919,
20221026,779,776,율암,연경,6045,109,91,65,161,463,6934,5707,92,96,64,180,438,6577,
20221026,779,777,율암,파군재,2654,17,16,8,9,215,2919,2619,17,21,5,2,233,2897,
20221026,876,675,양감,서오산,2215,58,36,28,95,166,2598,1867,71,40,35,103,118,2234,
20221026,876,677,양감,북평택,2135,154,178,197,182,165,3011,2182,157,195,182,188,163,3067,
20221026,981,982,서영암,강진무위사,1804,36,83,58,62,73,2116,1802,45,86,72,70,76,2151,
20221026,981,987,서영암,남순천,1459,39,111,68,343,40,2060,1572,35,131,133,362,39,2272,
20221026,982,981,강진무위사,서영암,1802,45,86,72,70,76,2151,1804,36,83,58,62,73,2116,
20221026,984,985,보성,벌교,1389,28,47,44,53,37,1598,1315,38,43,32,40,33,1501,
20221026,984,987,보성,남순천,1720,51,103,76,289,60,2299,1843,51,100,59,265,59,2377,
20221026,985,984,벌교,보성,1315,38,43,32,40,33,1501,1389,28,47,44,53,37,1598,
20221026,986,987,고흥,남순천,3347,62,107,139,281,120,4056,3745,71,126,157,292,134,4525,
20221026,987,981,남순천,서영암,1572,35,131,133,362,39,2272,1459,39,111,68,343,40,2060,
20221026,987,984,남순천,보성,1843,51,100,59,265,59,2377,1720,51,103,76,289,60,2299,
20221026,987,986,남순천,고흥,3745,71,126,157,292,134,4525,3347,62,107,139,281,120,4056,
20221027,101,102,서울,동수원,3491,55,260,12,4,214,4036,4827,55,394,24,14,259,5573,
20221027,101,103,서울,수원신갈,15318,625,1715,433,113,767,18971,14587,681,1716,404,126,659,18173,
20221027,101,105,서울,기흥,7342,96,420,83,23,348,8312,6062,98,360,104,27,301,6952,
20221027,101,106,서울,오산,4101,365,441,164,92,249,5412,4246,480,480,190,75,265,5736,
20221027,101,107,서울,안성,3277,80,318,47,14,198,3934,2911,70,292,50,20,163,3506,
20221027,101,108,서울,천안,3795,75,354,37,10,150,4421,3866,59,342,47,19,144,4477,
20221027,101,111,서울,청주,892,13,177,27,26,37,1172,779,15,197,27,22,29,1069,
20221027,101,171,서울,마성,2361,21,279,49,2,136,2848,2681,20,334,56,1,138,3230,
20221027,101,172,서울,용인,3464,160,119,40,28,229,4040,3884,175,131,62,43,224,4519,
20221027,101,173,서울,양지,3362,216,139,82,85,124,4008,4349,380,158,146,125,188,5346,
20221027,101,528,서울,기흥동탄,6662,82,1175,121,14,345,8399,7163,67,1323,119,19,338,9029,
20221027,101,542,서울,서안성,1198,47,99,90,19,52,1505,1751,40,92,167,57,84,2191,
20221027,101,543,서울,남안성,1076,71,60,71,71,32,1381,1167,82,75,102,95,54,1575,
20221027,101,673,서울,북오산,1504,48,127,21,8,102,1810,1556,46,128,29,13,110,1882,
20221027,101,677,서울,북평택,1457,52,261,70,98,67,2005,1249,64,240,82,129,57,1821,
20221027,102,101,동수원,서울,4827,55,394,24,14,259,5573,3491,55,260,12,4,214,4036,
20221027,102,172,동수원,용인,1095,29,23,4,12,101,1264,1069,27,23,3,1,89,1212,
20221027,102,173,동수원,양지,1251,35,30,6,20,64,1406,1391,51,34,17,8,73,1574,
20221027,102,212,동수원,북수원,4341,36,247,16,37,252,4929,4965,43,248,13,20,289,5578,
20221027,102,213,동수원,부곡,1040,23,11,9,29,77,1189,1021,19,12,4,26,70,1152,
20221027,102,214,동수원,동군포,1415,19,19,15,3,97,1568,1703,22,21,12,4,109,1871,
20221027,102,215,동수원,군포,1634,21,23,9,23,95,1805,2339,20,55,7,46,170,2637,
20221027,102,253,동수원,서서울,5717,64,66,16,13,380,6256,5216,62,73,9,23,307,5690,
20221027,102,254,동수원,군자,3756,49,66,15,41,217,4144,4254,66,64,20,37,250,4691,
20221027,102,255,동수원,서안산,1721,41,12,8,7,88,1877,1969,42,21,12,6,122,2172,
20221027,103,101,수원신갈,서울,14587,681,1716,404,126,659,18173,15318,625,1715,433,113,767,18971,
20221027,103,105,수원신갈,기흥,1692,26,44,23,38,110,1933,2168,25,32,22,32,123,2402,
20221027,103,106,수원신갈,오산,1003,70,53,35,17,53,1231,1328,76,67,48,15,82,1616,
20221027,103,107,수원신갈,안성,898,18,40,7,3,70,1036,1005,26,46,5,4,61,1147,
20221027,103,108,수원신갈,천안,1001,7,51,16,1,40,1116,1277,12,46,15,1,58,1409,
20221027,103,253,수원신갈,서서울,2005,154,74,72,21,113,2439,2084,125,87,89,40,132,2557,
20221027,103,254,수원신갈,군자,1485,105,68,97,94,81,1930,1872,137,86,122,123,98,2438,
20221027,103,528,수원신갈,기흥동탄,1371,9,191,2,2,87,1662,2034,21,145,6,1,122,2329,
20221027,105,101,기흥,서울,6062,98,360,104,27,301,6952,7342,96,420,83,23,348,8312,
20221027,105,103,기흥,수원신갈,2168,25,32,22,32,123,2402,1692,26,44,23,38,110,1933,
20221027,105,253,기흥,서서울,906,24,10,15,14,61,1030,975,20,12,15,13,64,1099,
20221027,106,101,오산,서울,4246,480,480,190,75,265,5736,4101,365,441,164,92,249,5412,
20221027,106,103,오산,수원신갈,1328,76,67,48,15,82,1616,1003,70,53,35,17,53,1231,
20221027,106,107,오산,안성,1712,49,40,24,17,170,2012,1512,42,29,23,9,146,1761,
20221027,106,108,오산,천안,1054,20,18,15,6,53,1166,1114,28,21,16,8,61,1248,
20221027,106,528,오산,기흥동탄,931,33,39,21,32,75,1131,967,40,51,15,30,89,1192,
20221027,107,101,안성,서울,2911,70,292,50,20,163,3506,3277,80,318,47,14,198,3934,
20221027,107,103,안성,수원신갈,1005,26,46,5,4,61,1147,898,18,40,7,3,70,1036,
20221027,107,106,안성,오산,1512,42,29,23,9,146,1761,1712,49,40,24,17,170,2012,
20221027,107,108,안성,천안,1523,22,44,6,7,121,1723,1604,25,40,14,10,131,1824,
20221027,107,528,안성,기흥동탄,1049,16,26,6,5,94,1196,1259,20,30,5,3,108,1425,
20221027,107,742,안성,남사진위,1367,46,55,32,3,101,1604,1477,44,54,34,9,112,1730,
20221027,108,101,천안,서울,3866,59,342,47,19,144,4477,3795,75,354,37,10,150,4421,
20221027,108,103,천안,수원신갈,1277,12,46,15,1,58,1409,1001,7,51,16,1,40,1116,
20221027,108,106,천안,오산,1114,28,21,16,8,61,1248,1054,20,18,15,6,53,1166,
20221027,108,107,천안,안성,1604,25,40,14,10,131,1824,1523,22,44,6,7,121,1723,
20221027,108,110,천안,목천,1213,30,76,28,43,96,1486,831,19,70,22,35,56,1033,
20221027,108,111,천안,청주,1105,45,63,24,47,79,1363,1090,31,55,27,31,73,1307,
20221027,108,229,천안,북천안,3572,79,129,42,39,210,4071,3832,77,138,54,80,222,4403,
20221027,108,528,천안,기흥동탄,1141,13,108,8,15,65,1350,1140,24,125,2,11,76,1378,
20221027,108,742,천안,남사진위,1246,26,47,19,5,79,1422,1041,33,54,27,9,60,1224,
20221027,110,108,목천,천안,831,19,70,22,35,56,1033,1213,30,76,28,43,96,1486,
20221027,111,101,청주,서울,779,15,197,27,22,29,1069,892,13,177,27,26,37,1172,
20221027,111,108,청주,천안,1090,31,55,27,31,73,1307,1105,45,63,24,47,79,1363,
20221027,112,115,남청주,대전,1509,76,65,4,41,130,1825,1625,94,63,14,12,151,1959,
20221027,113,115,신탄진,대전,951,23,11,7,21,108,1121,1128,21,13,5,11,109,1287,
20221027,114,153,남대전,서대전,1909,49,82,55,56,125,2276,1721,35,91,56,54,111,2068,
20221027,115,112,대전,남청주,1625,94,63,14,12,151,1959,1509,76,65,4,41,130,1825,
20221027,115,113,대전,신탄진,1128,21,13,5,11,109,1287,951,23,11,7,21,108,1121,
20221027,115,116,대전,옥천,2495,95,57,21,27,172,2867,2025,62,52,28,21,160,2348,
20221027,115,151,대전,북대전,1110,9,16,3,3,111,1252,868,7,14,1,4,111,1005,
20221027,115,152,대전,유성,1014,13,16,0,0,88,1131,910,8,18,4,2,64,1006,
20221027,115,579,대전,남세종,1012,12,17,7,8,95,1151,1076,13,13,6,28,80,1216,
20221027,116,115,옥천,대전,2025,62,52,28,21,160,2348,2495,95,57,21,27,172,2867,
20221027,119,153,판암,서대전,1723,30,17,18,42,148,1978,1845,31,22,15,31,166,2110,
20221027,123,127,구미,서대구,1627,32,26,18,6,86,1795,1696,31,24,21,11,101,1884,
20221027,123,129,구미,북대구,1987,17,58,14,6,94,2176,2003,21,64,10,4,113,2215,
20221027,123,130,구미,동김천,1219,31,39,39,26,75,1429,1188,34,28,45,25,74,1394,
20221027,125,127,남구미,서대구,1987,37,98,53,11,116,2302,2142,58,119,48,25,138,2530,
20221027,125,129,남구미,북대구,1838,24,78,16,10,96,2062,2060,24,83,30,5,94,2296,
20221027,126,127,왜관,서대구,2563,110,67,47,129,135,3051,2854,134,58,38,71,162,3317,
20221027,126,129,왜관,북대구,2959,90,45,29,84,134,3341,3416,95,58,25,77,161,3832,
20221027,127,123,서대구,구미,1696,31,24,21,11,101,1884,1627,32,26,18,6,86,1795,
20221027,127,125,서대구,남구미,2142,58,119,48,25,138,2530,1987,37,98,53,11,116,2302,
20221027,127,126,서대구,왜관,2854,134,58,38,71,162,3317,2563,110,67,47,129,135,3051,
20221027,127,131,서대구,경산,2483,186,140,100,91,152,3152,1830,158,91,66,64,124,2333,
20221027,127,203,서대구,가산,2179,64,84,36,136,100,2599,1925,65,76,38,151,97,2352,
20221027,127,230,서대구,팔공산,1515,48,30,16,4,95,1708,1032,25,21,15,8,81,1182,
20221027,127,518,서대구,칠곡물류,893,115,105,113,28,44,1298,755,100,71,84,22,53,1085,
20221027,127,527,서대구,포항,1074,47,39,25,76,55,1316,829,33,33,11,63,55,1024,
20221027,127,621,서대구,동대구,1833,52,72,28,39,138,2162,1347,43,28,23,37,91,1569,
20221027,129,123,북대구,구미,2003,21,64,10,4,113,2215,1987,17,58,14,6,94,2176,
20221027,129,125,북대구,남구미,2060,24,83,30,5,94,2296,1838,24,78,16,10,96,2062,
20221027,129,126,북대구,왜관,3416,95,58,25,77,161,3832,2959,90,45,29,84,134,3341,
20221027,129,131,북대구,경산,2330,166,80,46,33,118,2773,2920,198,119,63,45,155,3500,
20221027,129,524,북대구,청통와촌,960,39,25,14,26,42,1106,1179,73,29,22,24,46,1373,
20221027,129,527,북대구,포항,1547,35,32,26,66,73,1779,2008,51,27,26,87,90,2289,
20221027,130,123,동김천,구미,1188,34,28,45,25,74,1394,1219,31,39,39,26,75,1429,
20221027,131,127,경산,서대구,1830,158,91,66,64,124,2333,2483,186,140,100,91,152,3152,
20221027,131,129,경산,북대구,2920,198,119,63,45,155,3500,2330,166,80,46,33,118,2773,
20221027,131,132,경산,영천,879,41,47,42,62,55,1126,818,44,56,49,42,49,1058,
20221027,131,230,경산,팔공산,1327,83,48,17,14,100,1589,1540,82,56,31,25,90,1824,
20221027,131,621,경산,동대구,2279,73,41,216,52,126,2787,2401,75,51,222,35,124,2908,
20221027,132,131,영천,경산,818,44,56,49,42,49,1058,879,41,47,42,62,55,1126,
20221027,132,621,영천,동대구,1131,15,24,5,29,47,1251,1180,14,23,4,30,53,1304,
20221027,135,140,경주,부산,1220,19,55,7,35,62,1398,1341,14,60,15,29,62,1521,
20221027,135,252,경주,대동,928,31,83,53,202,53,1350,1072,52,91,46,122,54,1437,
20221027,138,140,양산,부산,4982,258,170,304,281,297,6292,5298,279,191,310,253,291,6622,
20221027,138,252,양산,대동,2685,314,195,189,310,128,3821,3006,321,210,175,356,145,4213,
20221027,139,140,서울산,부산,1392,41,32,11,16,78,1570,1438,54,33,9,19,81,1634,
20221027,139,252,서울산,대동,870,43,65,33,47,49,1107,925,48,24,37,46,55,1135,
20221027,139,641,서울산,울산,1195,45,61,26,41,117,1485,1090,24,57,11,33,91,1306,
20221027,140,135,부산,경주,1341,14,60,15,29,62,1521,1220,19,55,7,35,62,1398,
20221027,140,138,부산,양산,5298,279,191,310,253,291,6622,4982,258,170,304,281,297,6292,
20221027,140,139,부산,서울산,1438,54,33,9,19,81,1634,1392,41,32,11,16,78,1570,
20221027,140,250,부산,남양산,7932,154,219,37,43,643,9028,7704,136,210,30,46,641,8767,
20221027,140,251,부산,물금,1039,127,28,25,58,74,1351,1068,98,37,16,57,60,1336,
20221027,140,252,부산,대동,1721,44,54,59,65,85,2028,1495,44,54,50,91,84,1818,
20221027,142,145,군북,산인,3964,68,112,59,150,290,4643,4052,72,118,62,154,301,4759,
20221027,143,145,장지,산인,1220,31,30,27,50,85,1443,1257,30,24,37,42,85,1475,
20221027,144,145,함안,산인,1964,59,57,46,89,132,2347,1905,53,69,44,72,132,2275,
20221027,145,142,산인,군북,4052,72,118,62,154,301,4759,3964,68,112,59,150,290,4643,
20221027,145,143,산인,장지,1257,30,24,37,42,85,1475,1220,31,30,27,50,85,1443,
20221027,145,144,산인,함안,1905,53,69,44,72,132,2275,1964,59,57,46,89,132,2347,
20221027,145,291,산인,사천,1275,47,51,20,16,65,1474,1330,68,61,20,25,73,1577,
20221027,145,292,산인,진주,1506,33,152,15,30,116,1852,1594,38,143,24,35,105,1939,
20221027,145,293,산인,문산,1306,33,21,14,12,85,1471,1227,33,29,16,14,77,1396,
20221027,146,150,동창원,북부산,1038,26,26,5,32,79,1206,916,19,27,2,27,71,1062,
20221027,146,244,동창원,서부산,1216,29,29,25,48,87,1434,1248,36,34,21,101,71,1511,
20221027,146,245,동창원,장유,920,16,13,4,4,80,1037,999,14,16,3,12,77,1121,
20221027,146,289,동창원,마산,2758,88,68,90,88,245,3337,2571,77,71,71,63,214,3067,
20221027,147,150,진례,북부산,1432,37,38,22,47,80,1656,1651,46,26,22,20,85,1850,
20221027,147,244,진례,서부산,1735,96,71,73,106,102,2183,1859,106,74,61,127,116,2343,
20221027,147,245,진례,장유,1122,60,90,113,23,112,1520,1446,60,91,101,35,151,1884,
20221027,147,289,진례,마산,1375,116,105,64,86,95,1841,1373,112,101,58,77,85,1806,
20221027,148,150,서김해,북부산,6694,133,86,66,125,552,7656,6537,141,65,52,56,512,7363,
20221027,148,251,서김해,물금,926,36,21,27,11,101,1122,916,43,22,33,17,101,1132,
20221027,148,289,서김해,마산,1457,39,64,18,8,91,1677,1412,30,79,24,14,93,1652,
20221027,149,150,동김해,북부산,10654,202,178,79,86,893,12092,9229,176,145,54,58,756,10418,
20221027,149,250,동김해,남양산,1158,25,53,10,8,91,1345,951,21,47,5,8,77,1109,
20221027,149,251,동김해,물금,1197,42,10,8,3,131,1391,1114,33,12,15,3,116,1293,
20221027,149,289,동김해,마산,841,32,38,17,14,62,1004,865,39,44,15,9,64,1036,
20221027,150,146,북부산,동창원,916,19,27,2,27,71,1062,1038,26,26,5,32,79,1206,
20221027,150,147,북부산,진례,1651,46,26,22,20,85,1850,1432,37,38,22,47,80,1656,
20221027,150,148,북부산,서김해,6537,141,65,52,56,512,7363,6694,133,86,66,125,552,7656,
20221027,150,149,북부산,동김해,9229,176,145,54,58,756,10418,10654,202,178,79,86,893,12092,
20221027,150,245,북부산,장유,3701,44,80,14,36,251,4126,3188,55,77,4,25,230,3579,
20221027,150,289,북부산,마산,2670,35,85,17,44,134,2985,2802,46,96,25,75,145,3189,
20221027,151,115,북대전,대전,868,7,14,1,4,111,1005,1110,9,16,3,3,111,1252,
20221027,151,153,북대전,서대전,1050,17,23,15,21,87,1213,1262,16,35,21,11,100,1445,
20221027,152,115,유성,대전,910,8,18,4,2,64,1006,1014,13,16,0,0,88,1131,
20221027,152,154,유성,안영,911,17,30,11,76,76,1121,1078,22,31,21,64,68,1284,
20221027,153,114,서대전,남대전,1721,35,91,56,54,111,2068,1909,49,82,55,56,125,2276,
20221027,153,119,서대전,판암,1845,31,22,15,31,166,2110,1723,30,17,18,42,148,1978,
20221027,153,151,서대전,북대전,1262,16,35,21,11,100,1445,1050,17,23,15,21,87,1213,
20221027,153,154,서대전,안영,1119,33,34,36,100,67,1389,1113,32,40,44,91,62,1382,
20221027,153,579,서대전,남세종,1240,19,16,14,7,100,1396,1067,15,23,16,16,80,1217,
20221027,154,152,안영,유성,1078,22,31,21,64,68,1284,911,17,30,11,76,76,1121,
20221027,154,153,안영,서대전,1113,32,40,44,91,62,1382,1119,33,34,36,100,67,1389,
20221027,159,167,서전주,광주,1435,78,86,46,49,47,1741,1385,72,69,42,36,50,1654,
20221027,166,167,장성,광주,2315,75,69,34,61,111,2665,2690,115,78,50,40,110,3083,
20221027,167,159,광주,서전주,1385,72,69,42,36,50,1654,1435,78,86,46,49,47,1741,
20221027,167,166,광주,장성,2690,115,78,50,40,110,3083,2315,75,69,34,61,111,2665,
20221027,167,567,광주,남고창,1315,36,56,28,35,39,1509,1349,35,51,14,42,40,1531,
20221027,171,101,마성,서울,2681,20,334,56,1,138,3230,2361,21,279,49,2,136,2848,
20221027,172,101,용인,서울,3884,175,131,62,43,224,4519,3464,160,119,40,28,229,4040,
20221027,172,102,용인,동수원,1069,27,23,3,1,89,1212,1095,29,23,4,12,101,1264,
20221027,172,173,용인,양지,1963,246,126,129,91,149,2704,1763,191,145,138,102,156,2495,
20221027,172,212,용인,북수원,898,33,12,17,15,50,1025,1112,49,17,18,25,92,1313,
20221027,172,253,용인,서서울,1087,71,18,29,22,67,1294,1045,78,32,29,25,45,1254,
20221027,173,101,양지,서울,4349,380,158,146,125,188,5346,3362,216,139,82,85,124,4008,
20221027,173,102,양지,동수원,1391,51,34,17,8,73,1574,1251,35,30,6,20,64,1406,
20221027,173,172,양지,용인,1763,191,145,138,102,156,2495,1963,246,126,129,91,149,2704,
20221027,173,212,양지,북수원,1186,86,38,58,57,70,1495,1250,110,38,39,84,65,1586,
20221027,173,253,양지,서서울,1252,148,67,118,51,48,1684,909,125,57,84,36,45,1256,
20221027,173,254,양지,군자,782,123,78,179,214,46,1422,732,111,99,159,210,41,1352,
20221027,174,179,춘천,홍천,3272,65,79,33,36,312,3797,3083,76,75,36,31,305,3606,
20221027,174,216,춘천,횡성,1110,55,42,21,35,66,1329,1188,49,37,16,20,62,1372,
20221027,174,218,춘천,남원주,1159,28,65,16,12,72,1352,1071,21,70,21,12,71,1266,
20221027,174,554,춘천,동홍천,1106,15,16,17,6,67,1227,1136,15,19,9,5,77,1261,
20221027,176,190,이천,동서울,1625,75,201,150,109,76,2236,1668,59,212,136,78,69,2222,
20221027,177,190,여주,동서울,885,21,37,41,53,20,1057,910,19,34,33,28,27,1051,
20221027,179,174,홍천,춘천,3083,76,75,36,31,305,3606,3272,65,79,33,36,312,3797,
20221027,184,189,대관령,강릉,1153,29,66,3,11,78,1340,1313,28,61,6,13,89,1510,
20221027,189,184,강릉,대관령,1313,28,61,6,13,89,1510,1153,29,66,3,11,78,1340,
20221027,190,176,동서울,이천,1668,59,212,136,78,69,2222,1625,75,201,150,109,76,2236,
20221027,190,177,동서울,여주,910,19,34,33,28,27,1051,885,21,37,41,53,20,1057,
20221027,190,191,동서울,경기광주,10566,690,486,357,260,727,13086,9998,623,443,314,273,700,12351,
20221027,190,192,동서울,곤지암,6518,461,239,207,89,380,7894,5843,431,196,194,67,358,7089,
20221027,190,193,동서울,일죽,2517,161,194,189,109,103,3273,2265,177,196,239,101,92,3070,
20221027,190,194,동서울,서이천,4215,565,333,272,165,244,5794,3228,429,255,230,125,182,4449,
20221027,190,560,동서울,감곡,910,18,28,31,74,31,1092,946,37,26,25,99,32,1165,
20221027,190,705,동서울,남이천,1438,92,72,113,125,52,1892,1627,104,59,104,82,56,2032,
20221027,191,190,경기광주,동서울,9998,623,443,314,273,700,12351,10566,690,486,357,260,727,13086,
20221027,192,190,곤지암,동서울,5843,431,196,194,67,358,7089,6518,461,239,207,89,380,7894,
20221027,192,194,곤지암,서이천,1301,239,110,157,112,111,2030,1107,162,80,115,180,81,1725,
20221027,193,190,일죽,동서울,2265,177,196,239,101,92,3070,2517,161,194,189,109,103,3273,
20221027,194,190,서이천,동서울,3228,429,255,230,125,182,4449,4215,565,333,272,165,244,5794,
20221027,194,192,서이천,곤지암,1107,162,80,115,180,81,1725,1301,239,110,157,112,111,2030,
20221027,196,198,진천,서청주,1218,43,84,41,34,82,1502,1315,30,77,38,32,84,1576,
20221027,198,196,서청주,진천,1315,30,77,38,32,84,1576,1218,43,84,41,34,82,1502,
20221027,201,203,칠곡,가산,908,41,37,38,115,54,1193,908,44,51,37,136,54,1230,
20221027,203,127,가산,서대구,1925,65,76,38,151,97,2352,2179,64,84,36,136,100,2599,
20221027,203,201,가산,칠곡,908,44,51,37,136,54,1230,908,41,37,38,115,54,1193,
20221027,203,775,가산,동명동호,1755,71,52,62,312,77,2329,1748,62,41,55,241,87,2234,
20221027,212,102,북수원,동수원,4965,43,248,13,20,289,5578,4341,36,247,16,37,252,4929,
20221027,212,172,북수원,용인,1112,49,17,18,25,92,1313,898,33,12,17,15,50,1025,
20221027,212,173,북수원,양지,1250,110,38,39,84,65,1586,1186,86,38,58,57,70,1495,
20221027,212,253,북수원,서서울,2767,64,32,19,18,159,3059,993,34,13,10,5,64,1119,
20221027,212,254,북수원,군자,1888,41,38,22,24,120,2133,1157,37,28,14,17,74,1327,
20221027,213,102,부곡,동수원,1021,19,12,4,26,70,1152,1040,23,11,9,29,77,1189,
20221027,213,253,부곡,서서울,1494,74,40,34,154,100,1896,1012,50,26,41,160,59,1348,
20221027,213,254,부곡,군자,996,31,25,53,458,58,1621,898,41,24,36,327,61,1387,
20221027,214,102,동군포,동수원,1703,22,21,12,4,109,1871,1415,19,19,15,3,97,1568,
20221027,215,102,군포,동수원,2339,20,55,7,46,170,2637,1634,21,23,9,23,95,1805,
20221027,215,253,군포,서서울,3113,92,56,39,78,211,3589,3880,156,136,185,111,276,4744,
20221027,215,254,군포,군자,2009,56,54,46,78,135,2378,3113,141,114,127,192,224,3911,
20221027,215,255,군포,서안산,1328,42,23,27,16,94,1530,1487,70,65,83,81,98,1884,
20221027,216,174,횡성,춘천,1188,49,37,16,20,62,1372,1110,55,42,21,35,66,1329,
20221027,218,174,남원주,춘천,1071,21,70,21,12,71,1266,1159,28,65,16,12,72,1352,
20221027,218,240,남원주,제천,2010,48,54,23,47,138,2320,2174,70,47,22,29,135,2477,
20221027,225,291,서진주,사천,1041,25,24,9,30,81,1210,1072,19,32,9,29,74,1235,
20221027,229,108,북천안,천안,3832,77,138,54,80,222,4403,3572,79,129,42,39,210,4071,
20221027,230,127,팔공산,서대구,1032,25,21,15,8,81,1182,1515,48,30,16,4,95,1708,
20221027,230,131,팔공산,경산,1540,82,56,31,25,90,1824,1327,83,48,17,14,100,1589,
20221027,230,524,팔공산,청통와촌,1159,43,39,14,13,60,1328,960,46,31,5,19,57,1118,
20221027,230,527,팔공산,포항,1545,25,28,11,12,68,1689,1365,24,17,7,22,57,1492,
20221027,231,519,화원옥포,남대구,6268,189,114,161,221,455,7408,6070,152,120,158,133,445,7078,
20221027,232,519,달성,남대구,2847,111,150,59,41,203,3411,2949,123,143,48,27,191,3481,
20221027,233,519,현풍,남대구,4854,201,205,65,121,357,5803,4476,191,196,87,99,317,5366,
20221027,237,239,남지,칠원,849,27,43,17,76,69,1081,884,29,51,31,94,78,1167,
20221027,238,239,칠서,칠원,1600,94,129,202,466,110,2601,1677,109,125,172,447,116,2646,
20221027,239,237,칠원,남지,884,29,51,31,94,78,1167,849,27,43,17,76,69,1081,
20221027,239,238,칠원,칠서,1677,109,125,172,447,116,2646,1600,94,129,202,466,110,2601,
20221027,239,519,칠원,남대구,1171,61,114,44,98,50,1538,1239,65,137,42,81,47,1611,
20221027,240,218,제천,남원주,2174,70,47,22,29,135,2477,2010,48,54,23,47,138,2320,
20221027,241,519,동고령,남대구,3032,106,80,318,139,153,3828,2910,113,85,285,127,151,3671,
20221027,242,519,고령,남대구,1700,42,54,22,140,78,2036,1682,35,61,19,139,76,2012,
20221027,244,146,서부산,동창원,1248,36,34,21,101,71,1511,1216,29,29,25,48,87,1434,
20221027,244,147,서부산,진례,1859,106,74,61,127,116,2343,1735,96,71,73,106,102,2183,
20221027,244,245,서부산,장유,13065,251,387,202,326,981,15212,12833,232,395,182,348,972,14962,
20221027,244,289,서부산,마산,3308,83,272,84,127,160,4034,3081,75,245,54,122,155,3732,
20221027,245,146,장유,동창원,999,14,16,3,12,77,1121,920,16,13,4,4,80,1037,
20221027,245,147,장유,진례,1446,60,91,101,35,151,1884,1122,60,90,113,23,112,1520,
20221027,245,150,장유,북부산,3188,55,77,4,25,230,3579,3701,44,80,14,36,251,4126,
20221027,245,244,장유,서부산,12833,232,395,182,348,972,14962,13065,251,387,202,326,981,15212,
20221027,245,289,장유,마산,1534,32,58,24,29,117,1794,1474,39,53,27,17,112,1722,
20221027,248,261,순창,동광주,1187,20,26,6,26,48,1313,1351,15,41,10,19,56,1492,
20221027,249,261,담양,동광주,2332,43,118,20,63,91,2667,1974,33,116,24,57,84,2288,
20221027,250,140,남양산,부산,7704,136,210,30,46,641,8767,7932,154,219,37,43,643,9028,
20221027,250,149,남양산,동김해,951,21,47,5,8,77,1109,1158,25,53,10,8,91,1345,
20221027,250,252,남양산,대동,3341,146,115,96,125,249,4072,4082,162,129,113,115,289,4890,
20221027,251,140,물금,부산,1068,98,37,16,57,60,1336,1039,127,28,25,58,74,1351,
20221027,251,148,물금,서김해,916,43,22,33,17,101,1132,926,36,21,27,11,101,1122,
20221027,251,149,물금,동김해,1114,33,12,15,3,116,1293,1197,42,10,8,3,131,1391,
20221027,251,252,물금,대동,3238,202,120,197,465,240,4462,3910,195,116,210,548,310,5289,
20221027,252,135,대동,경주,1072,52,91,46,122,54,1437,928,31,83,53,202,53,1350,
20221027,252,138,대동,양산,3006,321,210,175,356,145,4213,2685,314,195,189,310,128,3821,
20221027,252,139,대동,서울산,925,48,24,37,46,55,1135,870,43,65,33,47,49,1107,
20221027,252,140,대동,부산,1495,44,54,50,91,84,1818,1721,44,54,59,65,85,2028,
20221027,252,250,대동,남양산,4082,162,129,113,115,289,4890,3341,146,115,96,125,249,4072,
20221027,252,251,대동,물금,3910,195,116,210,548,310,5289,3238,202,120,197,465,240,4462,
20221027,252,641,대동,울산,1676,69,107,36,50,96,2034,1338,76,91,33,56,77,1671,
20221027,252,752,대동,기장철마,1900,70,70,43,105,129,2317,1902,69,69,37,47,130,2254,
20221027,252,753,대동,금정,1896,86,106,101,151,121,2461,1176,69,59,63,73,74,1514,
20221027,252,755,대동,광재,2369,87,89,75,319,152,3091,2089,70,66,74,383,137,2819,
20221027,252,756,대동,한림,884,49,33,24,68,42,1100,837,49,31,24,90,44,1075,
20221027,253,102,서서울,동수원,5216,62,73,9,23,307,5690,5717,64,66,16,13,380,6256,
20221027,253,103,서서울,수원신갈,2084,125,87,89,40,132,2557,2005,154,74,72,21,113,2439,
20221027,253,105,서서울,기흥,975,20,12,15,13,64,1099,906,24,10,15,14,61,1030,
20221027,253,172,서서울,용인,1045,78,32,29,25,45,1254,1087,71,18,29,22,67,1294,
20221027,253,173,서서울,양지,909,125,57,84,36,45,1256,1252,148,67,118,51,48,1684,
20221027,253,212,서서울,북수원,993,34,13,10,5,64,1119,2767,64,32,19,18,159,3059,
20221027,253,213,서서울,부곡,1012,50,26,41,160,59,1348,1494,74,40,34,154,100,1896,
20221027,253,215,서서울,군포,3880,156,136,185,111,276,4744,3113,92,56,39,78,211,3589,
20221027,253,255,서서울,서안산,15092,491,704,595,336,902,18120,14700,511,631,530,306,881,17559,
20221027,253,256,서서울,안산,8825,160,110,51,26,658,9830,5833,103,64,37,62,422,6521,
20221027,253,281,서서울,매송,3509,64,32,18,27,205,3855,3757,63,38,28,74,247,4207,
20221027,253,282,서서울,비봉,5410,236,282,159,459,297,6843,5540,289,283,188,520,349,7169,
20221027,253,283,서서울,발안,3244,163,178,164,120,189,4058,3579,208,187,201,122,204,4501,
20221027,253,285,서서울,서평택,1335,58,118,276,394,87,2268,1485,94,136,357,513,84,2669,
20221027,253,287,서서울,송악,1722,41,58,67,193,73,2154,1928,51,62,108,415,88,2652,
20221027,253,288,서서울,당진,1249,23,51,34,37,65,1459,1334,28,62,49,56,57,1586,
20221027,253,298,서서울,서산,2118,34,76,64,23,81,2396,2178,30,61,86,52,79,2486,
20221027,253,520,서서울,평택,1983,100,101,179,149,85,2597,2533,107,133,251,138,107,3269,
20221027,253,540,서서울,청북,751,40,73,112,57,42,1075,907,64,64,119,66,36,1256,
20221027,253,741,서서울,평택고덕,889,25,17,21,11,68,1031,1025,35,24,24,15,66,1189,
20221027,254,102,군자,동수원,4254,66,64,20,37,250,4691,3756,49,66,15,41,217,4144,
20221027,254,103,군자,수원신갈,1872,137,86,122,123,98,2438,1485,105,68,97,94,81,1930,
20221027,254,173,군자,양지,732,111,99,159,210,41,1352,782,123,78,179,214,46,1422,
20221027,254,212,군자,북수원,1157,37,28,14,17,74,1327,1888,41,38,22,24,120,2133,
20221027,254,213,군자,부곡,898,41,24,36,327,61,1387,996,31,25,53,458,58,1621,
20221027,254,215,군자,군포,3113,141,114,127,192,224,3911,2009,56,54,46,78,135,2378,
20221027,254,255,군자,서안산,10386,513,247,255,340,730,12471,9518,424,196,230,302,623,11293,
20221027,254,256,군자,안산,4844,140,103,43,73,372,5575,5004,134,110,47,75,394,5764,
20221027,254,281,군자,매송,1007,27,22,23,60,81,1220,868,26,15,16,51,64,1040,
20221027,254,282,군자,비봉,1340,115,89,67,209,91,1911,1043,98,73,59,177,91,1541,
20221027,254,283,군자,발안,1152,81,61,72,136,72,1574,998,71,66,65,128,68,1396,
20221027,255,102,서안산,동수원,1969,42,21,12,6,122,2172,1721,41,12,8,7,88,1877,
20221027,255,215,서안산,군포,1487,70,65,83,81,98,1884,1328,42,23,27,16,94,1530,
20221027,255,253,서안산,서서울,14700,511,631,530,306,881,17559,15092,491,704,595,336,902,18120,
20221027,255,254,서안산,군자,9518,424,196,230,302,623,11293,10386,513,247,255,340,730,12471,
20221027,256,253,안산,서서울,5833,103,64,37,62,422,6521,8825,160,110,51,26,658,9830,
20221027,256,254,안산,군자,5004,134,110,47,75,394,5764,4844,140,103,43,73,372,5575,
20221027,261,248,동광주,순창,1351,15,41,10,19,56,1492,1187,20,26,6,26,48,1313,
20221027,261,249,동광주,담양,1974,33,116,24,57,84,2288,2332,43,118,20,63,91,2667,
20221027,261,271,동광주,순천,2882,82,110,29,96,91,3290,2401,85,84,17,81,75,2743,
20221027,271,261,순천,동광주,2401,85,84,17,81,75,2743,2882,82,110,29,96,91,3290,
20221027,271,569,순천,북광주,805,62,42,22,114,24,1069,798,53,39,33,93,29,1045,
20221027,280,519,거창,남대구,894,24,45,8,4,34,1009,908,26,55,6,9,32,1036,
20221027,281,253,매송,서서울,3757,63,38,28,74,247,4207,3509,64,32,18,27,205,3855,
20221027,281,254,매송,군자,868,26,15,16,51,64,1040,1007,27,22,23,60,81,1220,
20221027,282,253,비봉,서서울,5540,289,283,188,520,349,7169,5410,236,282,159,459,297,6843,
20221027,282,254,비봉,군자,1043,98,73,59,177,91,1541,1340,115,89,67,209,91,1911,
20221027,283,253,발안,서서울,3579,208,187,201,122,204,4501,3244,163,178,164,120,189,4058,
20221027,283,254,발안,군자,998,71,66,65,128,68,1396,1152,81,61,72,136,72,1574,
20221027,285,253,서평택,서서울,1485,94,136,357,513,84,2669,1335,58,118,276,394,87,2268,
20221027,285,287,서평택,송악,708,31,85,62,624,44,1554,717,41,86,67,489,49,1449,
20221027,285,520,서평택,평택,701,37,61,86,109,58,1052,852,40,72,94,137,69,1264,
20221027,287,253,송악,서서울,1928,51,62,108,415,88,2652,1722,41,58,67,193,73,2154,
20221027,287,285,송악,서평택,717,41,86,67,489,49,1449,708,31,85,62,624,44,1554,
20221027,288,253,당진,서서울,1334,28,62,49,56,57,1586,1249,23,51,34,37,65,1459,
20221027,289,146,마산,동창원,2571,77,71,71,63,214,3067,2758,88,68,90,88,245,3337,
20221027,289,147,마산,진례,1373,112,101,58,77,85,1806,1375,116,105,64,86,95,1841,
20221027,289,148,마산,서김해,1412,30,79,24,14,93,1652,1457,39,64,18,8,91,1677,
20221027,289,149,마산,동김해,865,39,44,15,9,64,1036,841,32,38,17,14,62,1004,
20221027,289,150,마산,북부산,2802,46,96,25,75,145,3189,2670,35,85,17,44,134,2985,
20221027,289,244,마산,서부산,3081,75,245,54,122,155,3732,3308,83,272,84,127,160,4034,
20221027,289,245,마산,장유,1474,39,53,27,17,112,1722,1534,32,58,24,29,117,1794,
20221027,289,757,마산,진영,739,37,85,39,95,39,1034,875,49,61,44,97,44,1170,
20221027,291,145,사천,산인,1330,68,61,20,25,73,1577,1275,47,51,20,16,65,1474,
20221027,291,225,사천,서진주,1072,19,32,9,29,74,1235,1041,25,24,9,30,81,1210,
20221027,291,292,사천,진주,2765,61,85,55,47,259,3272,3473,89,85,57,60,280,4044,
20221027,292,145,진주,산인,1594,38,143,24,35,105,1939,1506,33,152,15,30,116,1852,
20221027,292,291,진주,사천,3473,89,85,57,60,280,4044,2765,61,85,55,47,259,3272,
20221027,293,145,문산,산인,1227,33,29,16,14,77,1396,1306,33,21,14,12,85,1471,
20221027,298,253,서산,서서울,2178,30,61,86,52,79,2486,2118,34,76,64,23,81,2396,
20221027,508,509,무안,목포,1552,47,48,27,63,60,1797,1836,61,50,35,72,71,2125,
20221027,508,553,무안,동광산,1481,27,40,26,25,71,1670,1520,32,40,34,33,54,1713,
20221027,509,508,목포,무안,1836,61,50,35,72,71,2125,1552,47,48,27,63,60,1797,
20221027,509,553,목포,동광산,7023,200,224,148,306,263,8164,7047,176,221,179,353,275,8251,
20221027,513,515,고성,북통영,1445,39,91,14,37,109,1735,1630,41,77,15,26,114,1903,
20221027,513,516,고성,통영,3206,103,160,92,174,206,3941,3070,100,159,68,164,207,3768,
20221027,514,516,동고성,통영,1154,23,56,43,127,141,1544,1159,15,63,45,137,147,1566,
20221027,515,513,북통영,고성,1630,41,77,15,26,114,1903,1445,39,91,14,37,109,1735,
20221027,516,513,통영,고성,3070,100,159,68,164,207,3768,3206,103,160,92,174,206,3941,
20221027,516,514,통영,동고성,1159,15,63,45,137,147,1566,1154,23,56,43,127,141,1544,
20221027,517,598,양평,북여주,1081,30,24,21,84,40,1280,1015,24,11,24,37,43,1154,
20221027,518,127,칠곡물류,서대구,755,100,71,84,22,53,1085,893,115,105,113,28,44,1298,
20221027,519,231,남대구,화원옥포,6070,152,120,158,133,445,7078,6268,189,114,161,221,455,7408,
20221027,519,232,남대구,달성,2949,123,143,48,27,191,3481,2847,111,150,59,41,203,3411,
20221027,519,233,남대구,현풍,4476,191,196,87,99,317,5366,4854,201,205,65,121,357,5803,
20221027,519,239,남대구,칠원,1239,65,137,42,81,47,1611,1171,61,114,44,98,50,1538,
20221027,519,241,남대구,동고령,2910,113,85,285,127,151,3671,3032,106,80,318,139,153,3828,
20221027,519,242,남대구,고령,1682,35,61,19,139,76,2012,1700,42,54,22,140,78,2036,
20221027,519,280,남대구,거창,908,26,55,6,9,32,1036,894,24,45,8,4,34,1009,
20221027,519,730,남대구,유천,2473,53,12,1,14,160,2713,2919,65,14,0,0,189,3187,
20221027,519,731,남대구,북현풍,1910,26,32,0,3,140,2111,1512,21,3,0,0,118,1654,
20221027,520,253,평택,서서울,2533,107,133,251,138,107,3269,1983,100,101,179,149,85,2597,
20221027,520,285,평택,서평택,852,40,72,94,137,69,1264,701,37,61,86,109,58,1052,
20221027,520,540,평택,청북,1170,87,139,142,98,54,1690,831,99,152,152,104,46,1384,
20221027,524,129,청통와촌,북대구,1179,73,29,22,24,46,1373,960,39,25,14,26,42,1106,
20221027,524,230,청통와촌,팔공산,960,46,31,5,19,57,1118,1159,43,39,14,13,60,1328,
20221027,526,527,서포항,포항,886,12,23,7,37,77,1042,1080,18,22,9,37,81,1247,
20221027,527,127,포항,서대구,829,33,33,11,63,55,1024,1074,47,39,25,76,55,1316,
20221027,527,129,포항,북대구,2008,51,27,26,87,90,2289,1547,35,32,26,66,73,1779,
20221027,527,230,포항,팔공산,1365,24,17,7,22,57,1492,1545,25,28,11,12,68,1689,
20221027,527,526,포항,서포항,1080,18,22,9,37,81,1247,886,12,23,7,37,77,1042,
20221027,528,101,기흥동탄,서울,7163,67,1323,119,19,338,9029,6662,82,1175,121,14,345,8399,
20221027,528,103,기흥동탄,수원신갈,2034,21,145,6,1,122,2329,1371,9,191,2,2,87,1662,
20221027,528,106,기흥동탄,오산,967,40,51,15,30,89,1192,931,33,39,21,32,75,1131,
20221027,528,107,기흥동탄,안성,1259,20,30,5,3,108,1425,1049,16,26,6,5,94,1196,
20221027,528,108,기흥동탄,천안,1140,24,125,2,11,76,1378,1141,13,108,8,15,65,1350,
20221027,540,253,청북,서서울,907,64,64,119,66,36,1256,751,40,73,112,57,42,1075,
20221027,540,520,청북,평택,831,99,152,152,104,46,1384,1170,87,139,142,98,54,1690,
20221027,540,741,청북,평택고덕,907,21,58,60,114,87,1247,957,35,63,64,133,88,1340,
20221027,542,101,서안성,서울,1751,40,92,167,57,84,2191,1198,47,99,90,19,52,1505,
20221027,542,543,서안성,남안성,1090,48,76,110,123,114,1561,1230,44,90,109,113,114,1700,
20221027,543,101,남안성,서울,1167,82,75,102,95,54,1575,1076,71,60,71,71,32,1381,
20221027,543,542,남안성,서안성,1230,44,90,109,113,114,1700,1090,48,76,110,123,114,1561,
20221027,543,555,남안성,북진천,830,91,152,147,158,50,1428,817,104,132,161,156,46,1416,
20221027,548,553,북무안,동광산,1354,15,23,22,81,43,1538,1537,28,41,36,107,50,1799,
20221027,549,553,동함평,동광산,3942,41,74,38,56,157,4308,4069,53,62,36,44,141,4405,
20221027,551,553,나주,동광산,1428,21,30,66,48,73,1666,1368,23,32,51,46,74,1594,
20221027,552,553,서광산,동광산,4374,184,185,232,233,175,5383,5884,224,213,244,197,220,6982,
20221027,553,508,동광산,무안,1520,32,40,34,33,54,1713,1481,27,40,26,25,71,1670,
20221027,553,509,동광산,목포,7047,176,221,179,353,275,8251,7023,200,224,148,306,263,8164,
20221027,553,548,동광산,북무안,1537,28,41,36,107,50,1799,1354,15,23,22,81,43,1538,
20221027,553,549,동광산,동함평,4069,53,62,36,44,141,4405,3942,41,74,38,56,157,4308,
20221027,553,551,동광산,나주,1368,23,32,51,46,74,1594,1428,21,30,66,48,73,1666,
20221027,553,552,동광산,서광산,5884,224,213,244,197,220,6982,4374,184,185,232,233,175,5383,
20221027,554,174,동홍천,춘천,1136,15,19,9,5,77,1261,1106,15,16,17,6,67,1227,
20221027,555,543,북진천,남안성,817,104,132,161,156,46,1416,830,91,152,147,158,50,1428,
20221027,560,190,감곡,동서울,946,37,26,25,99,32,1165,910,18,28,31,74,31,1092,
20221027,567,167,남고창,광주,1349,35,51,14,42,40,1531,1315,36,56,28,35,39,1509,
20221027,569,271,북광주,순천,798,53,39,33,93,29,1045,805,62,42,22,114,24,1069,
20221027,579,115,남세종,대전,1076,13,13,6,28,80,1216,1012,12,17,7,8,95,1151,
20221027,579,153,남세종,서대전,1067,15,23,16,16,80,1217,1240,19,16,14,7,100,1396,
20221027,587,589,오수,상관,1083,21,46,38,43,50,1281,1184,22,66,29,131,52,1484,
20221027,589,587,상관,오수,1184,22,66,29,131,52,1484,1083,21,46,38,43,50,1281,
20221027,597,598,서여주,북여주,996,52,133,43,52,45,1321,1074,45,114,31,59,38,1361,
20221027,598,517,북여주,양평,1015,24,11,24,37,43,1154,1081,30,24,21,84,40,1280,
20221027,598,597,북여주,서여주,1074,45,114,31,59,38,1361,996,52,133,43,52,45,1321,
20221027,621,127,동대구,서대구,1347,43,28,23,37,91,1569,1833,52,72,28,39,138,2162,
20221027,621,131,동대구,경산,2401,75,51,222,35,124,2908,2279,73,41,216,52,126,2787,
20221027,621,132,동대구,영천,1180,14,23,4,30,53,1304,1131,15,24,5,29,47,1251,
20221027,625,626,밀양,남밀양,1243,63,49,48,69,58,1530,1266,43,59,51,65,65,1549,
20221027,626,625,남밀양,밀양,1266,43,59,51,65,65,1549,1243,63,49,48,69,58,1530,
20221027,626,627,남밀양,삼랑진,1024,28,31,15,49,107,1254,1000,28,21,14,40,92,1195,
20221027,627,626,삼랑진,남밀양,1000,28,21,14,40,92,1195,1024,28,31,15,49,107,1254,
20221027,641,139,울산,서울산,1090,24,57,11,33,91,1306,1195,45,61,26,41,117,1485,
20221027,641,252,울산,대동,1338,76,91,33,56,77,1671,1676,69,107,36,50,96,2034,
20221027,641,643,울산,청량,1195,7,19,15,49,116,1401,1345,11,10,5,20,143,1534,
20221027,641,648,울산,해운대,934,3,12,3,1,57,1010,1081,9,13,2,3,93,1201,
20221027,641,706,울산,남경주,1201,16,37,12,23,59,1348,1198,6,35,17,21,70,1347,
20221027,641,707,울산,남포항,1036,18,44,12,138,43,1291,1110,20,36,27,141,61,1395,
20221027,643,641,청량,울산,1345,11,10,5,20,143,1534,1195,7,19,15,49,116,1401,
20221027,643,648,청량,해운대,2934,19,44,17,47,203,3264,3320,40,95,47,582,224,4308,
20221027,645,648,장안,해운대,1657,7,21,7,1,99,1792,2987,30,50,91,84,192,3434,
20221027,646,648,기장일광,해운대,4719,20,26,7,24,286,5082,5403,38,33,33,249,327,6083,
20221027,648,641,해운대,울산,1081,9,13,2,3,93,1201,934,3,12,3,1,57,1010,
20221027,648,643,해운대,청량,3320,40,95,47,582,224,4308,2934,19,44,17,47,203,3264,
20221027,648,645,해운대,장안,2987,30,50,91,84,192,3434,1657,7,21,7,1,99,1792,
20221027,648,646,해운대,기장일광,5403,38,33,33,249,327,6083,4719,20,26,7,24,286,5082,
20221027,651,652,남양주,화도,14216,524,535,474,283,1085,17117,16295,564,621,540,232,1284,19536,
20221027,651,653,남양주,서종,1929,17,7,8,44,78,2083,1975,16,7,6,56,87,2147,
20221027,651,654,남양주,설악,3936,27,97,14,19,123,4216,3326,17,76,11,17,112,3559,
20221027,651,655,남양주,강촌,2410,33,113,30,34,76,2696,2440,30,116,27,32,85,2730,
20221027,651,656,남양주,남춘천,2812,29,78,36,80,69,3104,2145,22,47,14,71,47,2346,
20221027,652,651,화도,남양주,16295,564,621,540,232,1284,19536,14216,524,535,474,283,1085,17117,
20221027,652,653,화도,서종,1504,30,23,53,18,110,1738,1501,33,32,44,26,109,1745,
20221027,652,654,화도,설악,1420,20,13,6,61,77,1597,1149,23,16,16,44,67,1315,
20221027,653,651,서종,남양주,1975,16,7,6,56,87,2147,1929,17,7,8,44,78,2083,
20221027,653,652,서종,화도,1501,33,32,44,26,109,1745,1504,30,23,53,18,110,1738,
20221027,654,651,설악,남양주,3326,17,76,11,17,112,3559,3936,27,97,14,19,123,4216,
20221027,654,652,설악,화도,1149,23,16,16,44,67,1315,1420,20,13,6,61,77,1597,
20221027,655,651,강촌,남양주,2440,30,116,27,32,85,2730,2410,33,113,30,34,76,2696,
20221027,656,651,남춘천,남양주,2145,22,47,14,71,47,2346,2812,29,78,36,80,69,3104,
20221027,671,672,봉담,정남,3262,169,87,86,168,225,3997,3989,158,85,69,206,292,4799,
20221027,671,673,봉담,북오산,2009,67,42,28,14,157,2317,2123,68,51,27,18,149,2436,
20221027,671,675,봉담,서오산,900,22,19,7,11,63,1022,980,26,12,5,16,79,1118,
20221027,671,676,봉담,향남,1361,115,50,57,35,105,1723,1315,112,49,53,29,98,1656,
20221027,671,677,봉담,북평택,7839,197,260,153,280,451,9180,7670,190,200,129,214,440,8843,
20221027,672,671,정남,봉담,3989,158,85,69,206,292,4799,3262,169,87,86,168,225,3997,
20221027,673,101,북오산,서울,1556,46,128,29,13,110,1882,1504,48,127,21,8,102,1810,
20221027,673,671,북오산,봉담,2123,68,51,27,18,149,2436,2009,67,42,28,14,157,2317,
20221027,673,677,북오산,북평택,2046,42,93,37,44,136,2398,1938,47,66,34,34,139,2258,
20221027,675,671,서오산,봉담,980,26,12,5,16,79,1118,900,22,19,7,11,63,1022,
20221027,675,676,서오산,향남,3617,140,102,36,91,244,4230,3195,101,73,38,82,209,3698,
20221027,675,677,서오산,북평택,11783,232,415,177,216,775,13598,11016,226,357,184,216,722,12721,
20221027,675,876,서오산,양감,1835,65,44,56,134,116,2250,2205,61,40,57,93,154,2610,
20221027,676,671,향남,봉담,1315,112,49,53,29,98,1656,1361,115,50,57,35,105,1723,
20221027,676,675,향남,서오산,3195,101,73,38,82,209,3698,3617,140,102,36,91,244,4230,
20221027,676,677,향남,북평택,1719,177,194,208,136,114,2548,1466,143,147,190,115,94,2155,
20221027,677,101,북평택,서울,1249,64,240,82,129,57,1821,1457,52,261,70,98,67,2005,
20221027,677,671,북평택,봉담,7670,190,200,129,214,440,8843,7839,197,260,153,280,451,9180,
20221027,677,673,북평택,북오산,1938,47,66,34,34,139,2258,2046,42,93,37,44,136,2398,
20221027,677,675,북평택,서오산,11016,226,357,184,216,722,12721,11783,232,415,177,216,775,13598,
20221027,677,676,북평택,향남,1466,143,147,190,115,94,2155,1719,177,194,208,136,114,2548,
20221027,677,876,북평택,양감,2192,157,201,231,165,147,3093,2100,148,187,303,190,147,3075,
20221027,682,683,조암,송산마도,784,107,93,81,50,38,1153,962,123,93,73,77,52,1380,
20221027,682,684,조암,남안산,1013,153,184,98,82,27,1557,1041,133,157,94,68,37,1530,
20221027,682,685,조암,서시흥,1678,193,157,138,270,99,2535,1714,165,162,158,261,100,2560,
20221027,683,682,송산마도,조암,962,123,93,73,77,52,1380,784,107,93,81,50,38,1153,
20221027,683,684,송산마도,남안산,2556,216,177,105,284,132,3470,2166,175,134,111,205,114,2905,
20221027,683,685,송산마도,서시흥,5245,312,245,226,885,281,7194,4324,263,210,219,790,234,6040,
20221027,684,682,남안산,조암,1041,133,157,94,68,37,1530,1013,153,184,98,82,27,1557,
20221027,684,683,남안산,송산마도,2166,175,134,111,205,114,2905,2556,216,177,105,284,132,3470,
20221027,684,685,남안산,서시흥,5461,536,318,414,563,425,7717,4453,368,338,371,419,311,6260,
20221027,685,682,서시흥,조암,1714,165,162,158,261,100,2560,1678,193,157,138,270,99,2535,
20221027,685,683,서시흥,송산마도,4324,263,210,219,790,234,6040,5245,312,245,226,885,281,7194,
20221027,685,684,서시흥,남안산,4453,368,338,371,419,311,6260,5461,536,318,414,563,425,7717,
20221027,705,190,남이천,동서울,1627,104,59,104,82,56,2032,1438,92,72,113,125,52,1892,
20221027,706,641,남경주,울산,1198,6,35,17,21,70,1347,1201,16,37,12,23,59,1348,
20221027,706,707,남경주,남포항,974,30,65,33,275,57,1434,1066,33,69,34,212,67,1481,
20221027,707,641,남포항,울산,1110,20,36,27,141,61,1395,1036,18,44,12,138,43,1291,
20221027,707,706,남포항,남경주,1066,33,69,34,212,67,1481,974,30,65,33,275,57,1434,
20221027,707,708,남포항,동경주,1323,28,31,21,229,73,1705,1386,30,30,23,298,81,1848,
20221027,708,707,동경주,남포항,1386,30,30,23,298,81,1848,1323,28,31,21,229,73,1705,
20221027,715,716,동안동,청송,1191,22,15,16,31,66,1341,1145,28,13,19,36,64,1305,
20221027,716,715,청송,동안동,1145,28,13,19,36,64,1305,1191,22,15,16,31,66,1341,
20221027,730,519,유천,남대구,2919,65,14,0,0,189,3187,2473,53,12,1,14,160,2713,
20221027,731,519,북현풍,남대구,1512,21,3,0,0,118,1654,1910,26,32,0,3,140,2111,
20221027,741,253,평택고덕,서서울,1025,35,24,24,15,66,1189,889,25,17,21,11,68,1031,
20221027,741,540,평택고덕,청북,957,35,63,64,133,88,1340,907,21,58,60,114,87,1247,
20221027,742,107,남사진위,안성,1477,44,54,34,9,112,1730,1367,46,55,32,3,101,1604,
20221027,742,108,남사진위,천안,1041,33,54,27,9,60,1224,1246,26,47,19,5,79,1422,
20221027,752,252,기장철마,대동,1902,69,69,37,47,130,2254,1900,70,70,43,105,129,2317,
20221027,753,252,금정,대동,1176,69,59,63,73,74,1514,1896,86,106,101,151,121,2461,
20221027,755,252,광재,대동,2089,70,66,74,383,137,2819,2369,87,89,75,319,152,3091,
20221027,756,252,한림,대동,837,49,31,24,90,44,1075,884,49,33,24,68,42,1100,
20221027,757,289,진영,마산,875,49,61,44,97,44,1170,739,37,85,39,95,39,1034,
20221027,772,774,북달성,남칠곡,2459,40,56,44,45,159,2803,2579,48,61,39,32,144,2903,
20221027,773,774,북다사,남칠곡,1324,22,25,15,30,92,1508,1268,25,25,15,30,99,1462,
20221027,774,772,남칠곡,북달성,2579,48,61,39,32,144,2903,2459,40,56,44,45,159,2803,
20221027,774,773,남칠곡,북다사,1268,25,25,15,30,99,1462,1324,22,25,15,30,92,1508,
20221027,775,203,동명동호,가산,1748,62,41,55,241,87,2234,1755,71,52,62,312,77,2329,
20221027,776,777,연경,파군재,3562,52,40,13,29,241,3937,2662,46,32,14,21,193,2968,
20221027,776,779,연경,율암,5859,93,85,84,197,446,6764,6098,96,78,82,164,476,6994,
20221027,777,776,파군재,연경,2662,46,32,14,21,193,2968,3562,52,40,13,29,241,3937,
20221027,777,779,파군재,율암,2661,25,19,8,4,247,2964,2582,31,22,9,6,246,2896,
20221027,779,776,율암,연경,6098,96,78,82,164,476,6994,5859,93,85,84,197,446,6764,
20221027,779,777,율암,파군재,2582,31,22,9,6,246,2896,2661,25,19,8,4,247,2964,
20221027,876,675,양감,서오산,2205,61,40,57,93,154,2610,1835,65,44,56,134,116,2250,
20221027,876,677,양감,북평택,2100,148,187,303,190,147,3075,2192,157,201,231,165,147,3093,
20221027,981,982,서영암,강진무위사,1801,37,68,68,50,78,2102,1856,48,88,100,51,80,2223,
20221027,981,987,서영암,남순천,1440,30,86,66,317,51,1990,1601,48,116,98,367,44,2274,
20221027,982,981,강진무위사,서영암,1856,48,88,100,51,80,2223,1801,37,68,68,50,78,2102,
20221027,984,985,보성,벌교,1338,46,53,48,57,34,1576,1318,47,59,36,38,39,1537,
20221027,984,987,보성,남순천,1902,40,85,70,300,66,2463,1948,43,92,56,264,54,2457,
20221027,985,984,벌교,보성,1318,47,59,36,38,39,1537,1338,46,53,48,57,34,1576,
20221027,986,987,고흥,남순천,3535,69,144,176,269,124,4317,3865,74,160,164,295,132,4690,
20221027,987,981,남순천,서영암,1601,48,116,98,367,44,2274,1440,30,86,66,317,51,1990,
20221027,987,984,남순천,보성,1948,43,92,56,264,54,2457,1902,40,85,70,300,66,2463,
20221027,987,986,남순천,고흥,3865,74,160,164,295,132,4690,3535,69,144,176,269,124,4317,
20221028,101,102,서울,동수원,3476,55,256,10,9,210,4016,4883,58,373,27,21,284,5646,
20221028,101,103,서울,수원신갈,15185,641,1726,428,135,733,18848,15067,695,1721,399,122,716,18720,
20221028,101,105,서울,기흥,6913,106,406,86,33,324,7868,6016,92,360,105,35,282,6890,
20221028,101,106,서울,오산,4002,353,423,166,76,261,5281,4791,448,458,182,90,321,6290,
20221028,101,107,서울,안성,3329,82,310,54,18,176,3969,3125,69,304,53,32,185,3768,
20221028,101,108,서울,천안,4190,65,365,44,11,197,4872,4533,64,379,48,18,212,5254,
20221028,101,111,서울,청주,998,12,210,27,20,35,1302,824,14,246,23,22,26,1155,
20221028,101,171,서울,마성,2790,27,217,53,1,109,3197,2857,19,238,58,1,141,3314,
20221028,101,172,서울,용인,3453,143,115,38,34,207,3990,4085,194,124,55,43,239,4740,
20221028,101,173,서울,양지,3506,205,138,94,76,145,4164,4518,391,139,147,106,204,5505,
20221028,101,229,서울,북천안,873,52,46,45,31,33,1080,975,65,62,64,19,43,1228,
20221028,101,528,서울,기흥동탄,6612,79,1240,126,8,329,8394,7373,73,1389,131,11,347,9324,
20221028,101,542,서울,서안성,1146,36,95,102,27,56,1462,1826,44,68,149,55,94,2236,
20221028,101,543,서울,남안성,1135,71,73,63,64,41,1447,1076,93,88,101,84,49,1491,
20221028,101,673,서울,북오산,1485,37,112,24,12,91,1761,1388,28,117,27,12,108,1680,
20221028,101,677,서울,북평택,1597,56,284,77,108,72,2194,1233,60,200,86,145,63,1787,
20221028,102,101,동수원,서울,4883,58,373,27,21,284,5646,3476,55,256,10,9,210,4016,
20221028,102,172,동수원,용인,1085,28,11,3,8,92,1227,1050,36,10,2,0,95,1193,
20221028,102,173,동수원,양지,1297,37,27,7,30,74,1472,1400,37,28,10,5,82,1562,
20221028,102,212,동수원,북수원,4294,31,232,36,29,259,4881,4860,47,240,31,16,319,5513,
20221028,102,213,동수원,부곡,1102,15,13,7,29,89,1255,1043,22,17,4,31,89,1206,
20221028,102,214,동수원,동군포,1562,27,24,11,9,110,1743,1814,22,16,7,4,122,1985,
20221028,102,215,동수원,군포,1598,23,32,11,6,106,1776,2252,21,43,10,5,157,2488,
20221028,102,253,동수원,서서울,5716,68,76,12,15,362,6249,4631,56,62,16,22,286,5073,
20221028,102,254,동수원,군자,3856,52,66,19,27,198,4218,4155,66,86,31,28,257,4623,
20221028,102,255,동수원,서안산,1755,41,25,15,5,85,1926,1850,40,21,21,4,100,2036,
20221028,103,101,수원신갈,서울,15067,695,1721,399,122,716,18720,15185,641,1726,428,135,733,18848,
20221028,103,105,수원신갈,기흥,1831,25,59,65,40,123,2143,2281,37,43,66,32,133,2592,
20221028,103,106,수원신갈,오산,974,70,56,28,14,77,1219,1306,76,66,52,10,97,1607,
20221028,103,108,수원신갈,천안,971,7,49,8,3,50,1088,1251,13,50,12,1,57,1384,
20221028,103,253,수원신갈,서서울,2019,154,95,63,25,119,2475,1874,141,79,82,26,103,2305,
20221028,103,254,수원신갈,군자,1565,108,57,72,73,80,1955,1852,119,88,128,100,105,2392,
20221028,103,528,수원신갈,기흥동탄,1492,20,200,4,2,107,1825,2119,16,152,7,4,110,2408,
20221028,105,101,기흥,서울,6016,92,360,105,35,282,6890,6913,106,406,86,33,324,7868,
20221028,105,103,기흥,수원신갈,2281,37,43,66,32,133,2592,1831,25,59,65,40,123,2143,
20221028,106,101,오산,서울,4791,448,458,182,90,321,6290,4002,353,423,166,76,261,5281,
20221028,106,103,오산,수원신갈,1306,76,66,52,10,97,1607,974,70,56,28,14,77,1219,
20221028,106,107,오산,안성,1823,53,40,22,11,174,2123,1503,52,30,20,9,134,1748,
20221028,106,108,오산,천안,1204,25,24,18,4,60,1335,1202,24,23,21,5,62,1337,
20221028,106,528,오산,기흥동탄,881,33,44,17,16,70,1061,954,40,39,18,7,79,1137,
20221028,107,101,안성,서울,3125,69,304,53,32,185,3768,3329,82,310,54,18,176,3969,
20221028,107,106,안성,오산,1503,52,30,20,9,134,1748,1823,53,40,22,11,174,2123,
20221028,107,108,안성,천안,1511,29,47,6,6,110,1709,1671,40,50,15,3,128,1907,
20221028,107,528,안성,기흥동탄,1027,11,28,6,4,84,1160,1207,20,29,4,3,89,1352,
20221028,107,742,안성,남사진위,1458,35,47,34,4,103,1681,1550,41,48,39,9,103,1790,
20221028,108,101,천안,서울,4533,64,379,48,18,212,5254,4190,65,365,44,11,197,4872,
20221028,108,103,천안,수원신갈,1251,13,50,12,1,57,1384,971,7,49,8,3,50,1088,
20221028,108,106,천안,오산,1202,24,23,21,5,62,1337,1204,25,24,18,4,60,1335,
20221028,108,107,천안,안성,1671,40,50,15,3,128,1907,1511,29,47,6,6,110,1709,
20221028,108,110,천안,목천,1196,24,66,35,31,60,1412,1004,18,57,21,30,59,1189,
20221028,108,111,천안,청주,1062,44,62,26,40,82,1316,1098,30,54,28,41,69,1320,
20221028,108,229,천안,북천안,3873,76,127,78,56,229,4439,3732,84,135,78,80,227,4336,
20221028,108,528,천안,기흥동탄,1141,13,114,5,12,71,1356,1166,20,122,3,13,76,1400,
20221028,108,742,천안,남사진위,1539,26,27,21,9,98,1720,1180,34,36,28,13,70,1361,
20221028,110,108,목천,천안,1004,18,57,21,30,59,1189,1196,24,66,35,31,60,1412,
20221028,111,101,청주,서울,824,14,246,23,22,26,1155,998,12,210,27,20,35,1302,
20221028,111,108,청주,천안,1098,30,54,28,41,69,1320,1062,44,62,26,40,82,1316,
20221028,112,115,남청주,대전,1691,91,59,7,49,113,2010,1761,86,63,9,26,128,2073,
20221028,113,115,신탄진,대전,981,37,16,5,10,114,1163,1218,25,11,3,5,120,1382,
20221028,113,198,신탄진,서청주,800,28,29,49,40,62,1008,940,36,21,27,26,60,1110,
20221028,114,153,남대전,서대전,1889,50,61,50,26,131,2207,1752,42,83,56,30,111,2074,
20221028,115,112,대전,남청주,1761,86,63,9,26,128,2073,1691,91,59,7,49,113,2010,
20221028,115,113,대전,신탄진,1218,25,11,3,5,120,1382,981,37,16,5,10,114,1163,
20221028,115,116,대전,옥천,2457,104,49,22,26,158,2816,2118,58,45,34,19,151,2425,
20221028,115,153,대전,서대전,1003,24,14,3,1,68,1113,949,18,14,2,5,78,1066,
20221028,115,198,대전,서청주,898,20,6,5,3,75,1007,918,13,5,5,1,88,1030,
20221028,115,579,대전,남세종,1094,14,18,3,18,81,1228,999,17,19,4,27,60,1126,
20221028,116,115,옥천,대전,2118,58,45,34,19,151,2425,2457,104,49,22,26,158,2816,
20221028,119,153,판암,서대전,1808,27,24,55,32,157,2103,1950,32,27,56,19,144,2228,
20221028,123,127,구미,서대구,1732,33,30,22,7,118,1942,1705,28,32,22,8,102,1897,
20221028,123,129,구미,북대구,1943,16,66,8,5,92,2130,1955,6,60,11,5,97,2134,
20221028,123,130,구미,동김천,1338,25,23,29,34,77,1526,1165,19,28,27,30,83,1352,
20221028,125,127,남구미,서대구,2034,53,107,36,20,121,2371,2138,66,137,40,23,131,2535,
20221028,125,129,남구미,북대구,1933,20,67,11,9,93,2133,2042,21,81,12,9,115,2280,
20221028,126,127,왜관,서대구,2574,106,82,35,122,151,3070,2927,130,70,49,81,167,3424,
20221028,126,129,왜관,북대구,3014,99,64,15,86,141,3419,3586,106,92,30,64,165,4043,
20221028,127,123,서대구,구미,1705,28,32,22,8,102,1897,1732,33,30,22,7,118,1942,
20221028,127,125,서대구,남구미,2138,66,137,40,23,131,2535,2034,53,107,36,20,121,2371,
20221028,127,126,서대구,왜관,2927,130,70,49,81,167,3424,2574,106,82,35,122,151,3070,
20221028,127,131,서대구,경산,2530,211,140,113,85,133,3212,1727,166,104,67,67,113,2244,
20221028,127,201,서대구,칠곡,1426,30,27,8,21,91,1603,897,27,13,4,7,72,1020,
20221028,127,203,서대구,가산,2333,61,77,45,108,114,2738,2123,63,69,44,106,94,2499,
20221028,127,230,서대구,팔공산,1555,36,39,16,8,95,1749,1127,33,37,16,9,91,1313,
20221028,127,527,서대구,포항,1250,26,45,25,78,60,1484,957,35,32,16,51,35,1126,
20221028,127,621,서대구,동대구,1821,51,74,36,54,137,2173,1244,35,34,29,46,105,1493,
20221028,129,123,북대구,구미,1955,6,60,11,5,97,2134,1943,16,66,8,5,92,2130,
20221028,129,125,북대구,남구미,2042,21,81,12,9,115,2280,1933,20,67,11,9,93,2133,
20221028,129,126,북대구,왜관,3586,106,92,30,64,165,4043,3014,99,64,15,86,141,3419,
20221028,129,131,북대구,경산,2353,155,88,43,35,132,2806,3019,215,125,66,52,178,3655,
20221028,129,524,북대구,청통와촌,962,45,22,13,18,38,1098,1166,74,34,16,36,51,1377,
20221028,129,527,북대구,포항,1650,28,22,23,59,66,1848,2263,46,32,24,70,115,2550,
20221028,130,123,동김천,구미,1165,19,28,27,30,83,1352,1338,25,23,29,34,77,1526,
20221028,131,127,경산,서대구,1727,166,104,67,67,113,2244,2530,211,140,113,85,133,3212,
20221028,131,129,경산,북대구,3019,215,125,66,52,178,3655,2353,155,88,43,35,132,2806,
20221028,131,132,경산,영천,906,42,45,45,61,45,1144,906,43,60,42,42,51,1144,
20221028,131,230,경산,팔공산,1434,98,37,17,16,85,1687,1530,91,51,20,19,95,1806,
20221028,131,621,경산,동대구,2180,74,34,150,67,116,2621,2450,79,49,157,58,114,2907,
20221028,132,131,영천,경산,906,43,60,42,42,51,1144,906,42,45,45,61,45,1144,
20221028,132,621,영천,동대구,1187,16,24,4,39,63,1333,1210,16,26,0,39,72,1363,
20221028,135,140,경주,부산,1494,8,46,10,49,72,1679,1636,12,42,8,39,79,1816,
20221028,135,252,경주,대동,1143,49,96,42,180,52,1562,1499,44,95,43,107,73,1861,
20221028,137,140,통도사,부산,776,34,27,14,106,45,1002,885,27,36,22,133,61,1164,
20221028,138,140,양산,부산,4954,253,181,117,294,273,6072,5295,291,204,124,250,294,6458,
20221028,138,252,양산,대동,2663,317,181,255,319,128,3863,2997,305,199,256,344,154,4255,
20221028,139,140,서울산,부산,1496,43,26,11,26,91,1693,1697,49,29,9,21,78,1883,
20221028,139,252,서울산,대동,885,30,46,32,58,49,1100,1072,32,35,34,48,55,1276,
20221028,139,641,서울산,울산,1427,46,80,38,32,104,1727,1305,23,65,20,30,93,1536,
20221028,140,135,부산,경주,1636,12,42,8,39,79,1816,1494,8,46,10,49,72,1679,
20221028,140,137,부산,통도사,885,27,36,22,133,61,1164,776,34,27,14,106,45,1002,
20221028,140,138,부산,양산,5295,291,204,124,250,294,6458,4954,253,181,117,294,273,6072,
20221028,140,139,부산,서울산,1697,49,29,9,21,78,1883,1496,43,26,11,26,91,1693,
20221028,140,250,부산,남양산,8085,146,227,103,45,637,9243,7924,135,202,105,41,679,9086,
20221028,140,251,부산,물금,1028,122,29,17,60,66,1322,1058,102,41,24,52,72,1349,
20221028,140,252,부산,대동,1738,61,55,28,54,113,2049,1477,49,49,37,88,98,1798,
20221028,140,289,부산,마산,1075,15,17,18,7,48,1180,1114,13,13,11,8,40,1199,
20221028,140,755,부산,광재,1128,12,26,6,10,75,1257,957,10,22,8,12,67,1076,
20221028,142,145,군북,산인,4704,70,140,57,84,318,5373,4672,58,122,54,79,297,5282,
20221028,143,145,장지,산인,1276,22,27,20,117,91,1553,1298,29,26,29,123,86,1591,
20221028,144,145,함안,산인,2061,50,43,26,82,160,2422,2177,53,41,14,55,159,2499,
20221028,145,142,산인,군북,4672,58,122,54,79,297,5282,4704,70,140,57,84,318,5373,
20221028,145,143,산인,장지,1298,29,26,29,123,86,1591,1276,22,27,20,117,91,1553,
20221028,145,144,산인,함안,2177,53,41,14,55,159,2499,2061,50,43,26,82,160,2422,
20221028,145,272,산인,광양,897,13,50,17,35,25,1037,987,21,49,21,12,19,1109,
20221028,145,291,산인,사천,1660,44,56,15,24,69,1868,1747,52,47,22,25,81,1974,
20221028,145,292,산인,진주,1817,28,152,11,19,105,2132,1948,39,153,21,18,107,2286,
20221028,145,293,산인,문산,1419,24,23,12,9,76,1563,1512,26,24,8,6,87,1663,
20221028,146,150,동창원,북부산,1108,14,17,0,28,61,1228,978,16,13,3,21,86,1117,
20221028,146,244,동창원,서부산,1326,27,36,12,35,90,1526,1367,31,42,25,83,86,1634,
20221028,146,245,동창원,장유,1006,16,10,11,13,86,1142,993,12,10,13,16,98,1142,
20221028,146,289,동창원,마산,2919,85,65,57,91,241,3458,2713,101,70,63,62,204,3213,
20221028,147,150,진례,북부산,1394,43,29,18,33,92,1609,1641,56,25,24,18,95,1859,
20221028,147,244,진례,서부산,1853,104,77,69,80,92,2275,1877,116,71,63,107,107,2341,
20221028,147,245,진례,장유,1063,61,92,102,12,94,1424,1460,64,91,99,22,145,1881,
20221028,147,289,진례,마산,1379,89,86,55,93,93,1795,1357,102,93,55,75,99,1781,
20221028,148,150,서김해,북부산,6551,125,76,52,104,514,7422,6475,128,74,40,79,511,7307,
20221028,148,251,서김해,물금,944,39,24,35,12,91,1145,876,42,21,43,19,75,1076,
20221028,148,289,서김해,마산,1708,29,63,9,8,122,1939,1650,27,66,15,14,114,1886,
20221028,149,150,동김해,북부산,10541,196,182,60,87,843,11909,9271,169,136,54,70,705,10405,
20221028,149,250,동김해,남양산,1184,31,52,9,4,90,1370,1027,20,50,5,6,93,1201,
20221028,149,251,동김해,물금,1122,40,23,7,5,97,1294,1103,29,21,6,5,108,1272,
20221028,149,289,동김해,마산,974,38,40,25,11,68,1156,1063,35,40,24,10,79,1251,
20221028,150,146,북부산,동창원,978,16,13,3,21,86,1117,1108,14,17,0,28,61,1228,
20221028,150,147,북부산,진례,1641,56,25,24,18,95,1859,1394,43,29,18,33,92,1609,
20221028,150,148,북부산,서김해,6475,128,74,40,79,511,7307,6551,125,76,52,104,514,7422,
20221028,150,149,북부산,동김해,9271,169,136,54,70,705,10405,10541,196,182,60,87,843,11909,
20221028,150,245,북부산,장유,3896,42,89,18,40,245,4330,3439,41,84,11,40,240,3855,
20221028,150,289,북부산,마산,3256,39,97,14,26,140,3572,3574,35,106,12,29,160,3916,
20221028,151,153,북대전,서대전,1078,16,24,23,23,85,1249,1149,16,21,27,29,82,1324,
20221028,152,154,유성,안영,1010,14,38,25,72,65,1224,1205,30,35,24,65,72,1431,
20221028,153,114,서대전,남대전,1752,42,83,56,30,111,2074,1889,50,61,50,26,131,2207,
20221028,153,115,서대전,대전,949,18,14,2,5,78,1066,1003,24,14,3,1,68,1113,
20221028,153,119,서대전,판암,1950,32,27,56,19,144,2228,1808,27,24,55,32,157,2103,
20221028,153,151,서대전,북대전,1149,16,21,27,29,82,1324,1078,16,24,23,23,85,1249,
20221028,153,154,서대전,안영,1142,28,35,62,60,63,1390,1167,31,35,60,47,77,1417,
20221028,153,579,서대전,남세종,1267,18,11,5,13,97,1411,1091,24,22,7,22,99,1265,
20221028,154,152,안영,유성,1205,30,35,24,65,72,1431,1010,14,38,25,72,65,1224,
20221028,154,153,안영,서대전,1167,31,35,60,47,77,1417,1142,28,35,62,60,63,1390,
20221028,159,167,서전주,광주,1646,62,76,54,53,47,1938,1655,74,68,43,50,56,1946,
20221028,163,167,정읍,광주,862,29,46,31,18,26,1012,878,44,55,28,18,19,1042,
20221028,166,167,장성,광주,2314,94,77,31,60,93,2669,2882,120,79,39,33,126,3279,
20221028,167,159,광주,서전주,1655,74,68,43,50,56,1946,1646,62,76,54,53,47,1938,
20221028,167,163,광주,정읍,878,44,55,28,18,19,1042,862,29,46,31,18,26,1012,
20221028,167,166,광주,장성,2882,120,79,39,33,126,3279,2314,94,77,31,60,93,2669,
20221028,167,567,광주,남고창,1445,34,44,17,28,51,1619,1383,27,43,17,38,44,1552,
20221028,171,101,마성,서울,2857,19,238,58,1,141,3314,2790,27,217,53,1,109,3197,
20221028,172,101,용인,서울,4085,194,124,55,43,239,4740,3453,143,115,38,34,207,3990,
20221028,172,102,용인,동수원,1050,36,10,2,0,95,1193,1085,28,11,3,8,92,1227,
20221028,172,173,용인,양지,2081,250,109,145,42,161,2788,1792,182,131,164,48,152,2469,
20221028,172,212,용인,북수원,1011,34,18,19,30,52,1164,1227,56,22,15,28,83,1431,
20221028,172,253,용인,서서울,1091,62,28,37,16,76,1310,1008,54,20,32,11,60,1185,
20221028,173,101,양지,서울,4518,391,139,147,106,204,5505,3506,205,138,94,76,145,4164,
20221028,173,102,양지,동수원,1400,37,28,10,5,82,1562,1297,37,27,7,30,74,1472,
20221028,173,172,양지,용인,1792,182,131,164,48,152,2469,2081,250,109,145,42,161,2788,
20221028,173,212,양지,북수원,1199,101,60,60,66,78,1564,1288,90,51,52,68,67,1616,
20221028,173,253,양지,서서울,1366,144,75,110,46,65,1806,938,126,63,83,34,41,1285,
20221028,173,254,양지,군자,886,110,79,176,213,42,1506,757,108,86,164,196,28,1339,
20221028,174,179,춘천,홍천,3411,74,93,62,41,327,4008,3382,69,98,58,38,328,3973,
20221028,174,216,춘천,횡성,1238,50,39,18,42,70,1457,1322,46,30,16,23,93,1530,
20221028,174,218,춘천,남원주,1406,29,72,15,7,92,1621,1375,17,70,13,5,94,1574,
20221028,174,554,춘천,동홍천,1164,21,18,11,7,79,1300,1470,18,21,4,7,110,1630,
20221028,176,190,이천,동서울,1884,51,183,134,80,87,2419,1474,52,199,126,54,82,1987,
20221028,179,174,홍천,춘천,3382,69,98,58,38,328,3973,3411,74,93,62,41,327,4008,
20221028,184,189,대관령,강릉,1276,31,52,6,14,87,1466,1345,30,46,9,7,98,1535,
20221028,189,184,강릉,대관령,1345,30,46,9,7,98,1535,1276,31,52,6,14,87,1466,
20221028,190,176,동서울,이천,1474,52,199,126,54,82,1987,1884,51,183,134,80,87,2419,
20221028,190,191,동서울,경기광주,10297,615,464,348,269,669,12662,10285,675,432,317,281,733,12723,
20221028,190,192,동서울,곤지암,6089,456,224,177,86,334,7366,5151,404,163,183,66,312,6279,
20221028,190,193,동서울,일죽,2779,152,183,183,134,102,3533,2319,157,167,239,113,100,3095,
20221028,190,194,동서울,서이천,4074,566,319,275,152,259,5645,3166,425,241,222,122,186,4362,
20221028,190,560,동서울,감곡,1068,15,30,36,62,28,1239,910,36,26,30,77,29,1108,
20221028,190,705,동서울,남이천,1633,98,59,103,88,44,2025,2158,115,55,104,81,72,2585,
20221028,191,190,경기광주,동서울,10285,675,432,317,281,733,12723,10297,615,464,348,269,669,12662,
20221028,192,190,곤지암,동서울,5151,404,163,183,66,312,6279,6089,456,224,177,86,334,7366,
20221028,192,194,곤지암,서이천,1409,267,133,244,122,97,2272,1169,177,106,214,169,98,1933,
20221028,193,190,일죽,동서울,2319,157,167,239,113,100,3095,2779,152,183,183,134,102,3533,
20221028,194,190,서이천,동서울,3166,425,241,222,122,186,4362,4074,566,319,275,152,259,5645,
20221028,194,192,서이천,곤지암,1169,177,106,214,169,98,1933,1409,267,133,244,122,97,2272,
20221028,196,198,진천,서청주,1143,36,70,41,26,76,1392,1343,37,78,33,30,89,1610,
20221028,198,113,서청주,신탄진,940,36,21,27,26,60,1110,800,28,29,49,40,62,1008,
20221028,198,115,서청주,대전,918,13,5,5,1,88,1030,898,20,6,5,3,75,1007,
20221028,198,196,서청주,진천,1343,37,78,33,30,89,1610,1143,36,70,41,26,76,1392,
20221028,201,127,칠곡,서대구,897,27,13,4,7,72,1020,1426,30,27,8,21,91,1603,
20221028,201,203,칠곡,가산,891,40,35,39,147,58,1210,860,47,51,28,169,43,1198,
20221028,201,730,칠곡,유천,1057,11,4,0,3,65,1140,937,4,4,0,0,67,1012,
20221028,203,127,가산,서대구,2123,63,69,44,106,94,2499,2333,61,77,45,108,114,2738,
20221028,203,201,가산,칠곡,860,47,51,28,169,43,1198,891,40,35,39,147,58,1210,
20221028,203,775,가산,동명동호,1762,66,51,51,326,80,2336,1786,62,42,52,269,83,2294,
20221028,212,102,북수원,동수원,4860,47,240,31,16,319,5513,4294,31,232,36,29,259,4881,
20221028,212,172,북수원,용인,1227,56,22,15,28,83,1431,1011,34,18,19,30,52,1164,
20221028,212,173,북수원,양지,1288,90,51,52,68,67,1616,1199,101,60,60,66,78,1564,
20221028,212,254,북수원,군자,1824,30,36,16,22,104,2032,1008,34,27,17,16,62,1164,
20221028,213,102,부곡,동수원,1043,22,17,4,31,89,1206,1102,15,13,7,29,89,1255,
20221028,213,253,부곡,서서울,1567,76,42,28,148,109,1970,807,51,21,38,111,63,1091,
20221028,213,254,부곡,군자,961,25,25,32,379,49,1471,782,33,23,34,313,40,1225,
20221028,214,102,동군포,동수원,1814,22,16,7,4,122,1985,1562,27,24,11,9,110,1743,
20221028,215,102,군포,동수원,2252,21,43,10,5,157,2488,1598,23,32,11,6,106,1776,
20221028,215,253,군포,서서울,3792,96,71,32,56,257,4304,3564,166,141,138,63,231,4303,
20221028,215,254,군포,군자,2279,71,65,37,75,143,2670,2924,125,116,126,159,188,3638,
20221028,215,255,군포,서안산,1344,38,30,18,18,90,1538,1510,74,59,77,64,117,1901,
20221028,216,174,횡성,춘천,1322,46,30,16,23,93,1530,1238,50,39,18,42,70,1457,
20221028,218,174,남원주,춘천,1375,17,70,13,5,94,1574,1406,29,72,15,7,92,1621,
20221028,218,240,남원주,제천,2121,50,43,24,49,141,2428,2411,53,46,34,40,164,2748,
20221028,225,291,서진주,사천,1083,18,24,27,36,86,1274,1131,25,37,27,30,87,1337,
20221028,229,101,북천안,서울,975,65,62,64,19,43,1228,873,52,46,45,31,33,1080,
20221028,229,108,북천안,천안,3732,84,135,78,80,227,4336,3873,76,127,78,56,229,4439,
20221028,230,127,팔공산,서대구,1127,33,37,16,9,91,1313,1555,36,39,16,8,95,1749,
20221028,230,131,팔공산,경산,1530,91,51,20,19,95,1806,1434,98,37,17,16,85,1687,
20221028,230,524,팔공산,청통와촌,1152,48,36,8,13,65,1322,1050,43,31,10,28,62,1224,
20221028,230,527,팔공산,포항,1558,26,16,12,24,69,1705,1555,27,14,10,30,59,1695,
20221028,231,519,화원옥포,남대구,6569,182,101,147,206,474,7679,6201,146,106,138,171,489,7251,
20221028,232,519,달성,남대구,2864,123,169,42,32,198,3428,2960,129,141,45,26,194,3495,
20221028,233,519,현풍,남대구,5103,216,221,83,144,372,6139,4524,176,201,100,95,310,5406,
20221028,237,239,남지,칠원,886,27,50,18,43,79,1103,870,25,52,18,37,81,1083,
20221028,238,239,칠서,칠원,1726,83,126,135,418,100,2588,1697,89,116,107,420,113,2542,
20221028,239,237,칠원,남지,870,25,52,18,37,81,1083,886,27,50,18,43,79,1103,
20221028,239,238,칠원,칠서,1697,89,116,107,420,113,2542,1726,83,126,135,418,100,2588,
20221028,239,519,칠원,남대구,1498,55,91,39,116,71,1870,1564,53,80,52,77,56,1882,
20221028,240,218,제천,남원주,2411,53,46,34,40,164,2748,2121,50,43,24,49,141,2428,
20221028,241,519,동고령,남대구,3088,85,77,230,215,161,3856,3099,88,93,217,214,156,3867,
20221028,242,519,고령,남대구,1919,36,59,20,153,96,2283,1956,34,65,20,149,83,2307,
20221028,244,146,서부산,동창원,1367,31,42,25,83,86,1634,1326,27,36,12,35,90,1526,
20221028,244,147,서부산,진례,1877,116,71,63,107,107,2341,1853,104,77,69,80,92,2275,
20221028,244,245,서부산,장유,13543,261,393,157,393,979,15726,13591,265,404,169,447,970,15846,
20221028,244,289,서부산,마산,3808,72,286,44,78,184,4472,3852,73,256,53,63,179,4476,
20221028,245,146,장유,동창원,993,12,10,13,16,98,1142,1006,16,10,11,13,86,1142,
20221028,245,147,장유,진례,1460,64,91,99,22,145,1881,1063,61,92,102,12,94,1424,
20221028,245,150,장유,북부산,3439,41,84,11,40,240,3855,3896,42,89,18,40,245,4330,
20221028,245,244,장유,서부산,13591,265,404,169,447,970,15846,13543,261,393,157,393,979,15726,
20221028,245,289,장유,마산,1710,37,45,14,18,132,1956,1761,33,41,20,14,118,1987,
20221028,249,261,담양,동광주,2351,28,129,10,99,89,2706,2086,39,139,18,69,83,2434,
20221028,250,140,남양산,부산,7924,135,202,105,41,679,9086,8085,146,227,103,45,637,9243,
20221028,250,149,남양산,동김해,1027,20,50,5,6,93,1201,1184,31,52,9,4,90,1370,
20221028,250,252,남양산,대동,3335,147,97,106,126,244,4055,4183,163,128,96,133,315,5018,
20221028,251,140,물금,부산,1058,102,41,24,52,72,1349,1028,122,29,17,60,66,1322,
20221028,251,148,물금,서김해,876,42,21,43,19,75,1076,944,39,24,35,12,91,1145,
20221028,251,149,물금,동김해,1103,29,21,6,5,108,1272,1122,40,23,7,5,97,1294,
20221028,251,252,물금,대동,3147,213,101,163,447,209,4280,3832,203,101,185,645,272,5238,
20221028,252,135,대동,경주,1499,44,95,43,107,73,1861,1143,49,96,42,180,52,1562,
20221028,252,138,대동,양산,2997,305,199,256,344,154,4255,2663,317,181,255,319,128,3863,
20221028,252,139,대동,서울산,1072,32,35,34,48,55,1276,885,30,46,32,58,49,1100,
20221028,252,140,대동,부산,1477,49,49,37,88,98,1798,1738,61,55,28,54,113,2049,
20221028,252,250,대동,남양산,4183,163,128,96,133,315,5018,3335,147,97,106,126,244,4055,
20221028,252,251,대동,물금,3832,203,101,185,645,272,5238,3147,213,101,163,447,209,4280,
20221028,252,641,대동,울산,1783,75,101,38,50,112,2159,1513,70,101,32,77,86,1879,
20221028,252,752,대동,기장철마,1877,67,45,44,135,120,2288,1951,66,59,44,61,150,2331,
20221028,252,753,대동,금정,1935,101,94,83,175,113,2501,1152,55,58,66,68,74,1473,
20221028,252,755,대동,광재,2431,101,89,117,307,139,3184,2232,100,90,115,469,132,3138,
20221028,252,756,대동,한림,842,39,35,32,55,45,1048,946,39,45,25,101,40,1196,
20221028,253,102,서서울,동수원,4631,56,62,16,22,286,5073,5716,68,76,12,15,362,6249,
20221028,253,103,서서울,수원신갈,1874,141,79,82,26,103,2305,2019,154,95,63,25,119,2475,
20221028,253,172,서서울,용인,1008,54,20,32,11,60,1185,1091,62,28,37,16,76,1310,
20221028,253,173,서서울,양지,938,126,63,83,34,41,1285,1366,144,75,110,46,65,1806,
20221028,253,213,서서울,부곡,807,51,21,38,111,63,1091,1567,76,42,28,148,109,1970,
20221028,253,215,서서울,군포,3564,166,141,138,63,231,4303,3792,96,71,32,56,257,4304,
20221028,253,255,서서울,서안산,15127,517,656,597,352,875,18124,15250,501,606,558,347,897,18159,
20221028,253,256,서서울,안산,9058,171,91,47,26,617,10010,6239,126,69,40,57,464,6995,
20221028,253,281,서서울,매송,3735,68,37,21,22,233,4116,4787,68,41,34,73,291,5294,
20221028,253,282,서서울,비봉,5807,247,234,155,484,320,7247,5868,298,267,169,536,362,7500,
20221028,253,283,서서울,발안,3094,148,165,157,116,168,3848,4279,229,203,205,118,248,5282,
20221028,253,285,서서울,서평택,1421,68,103,269,402,92,2355,1711,94,131,349,543,100,2928,
20221028,253,287,서서울,송악,2140,44,68,54,191,74,2571,2518,52,52,86,370,80,3158,
20221028,253,288,서서울,당진,1565,29,46,28,37,67,1772,1520,35,43,36,56,95,1785,
20221028,253,298,서서울,서산,3458,30,71,50,28,111,3748,2397,26,61,67,47,87,2685,
20221028,253,520,서서울,평택,2330,94,105,170,118,105,2922,2677,116,112,218,132,131,3386,
20221028,253,540,서서울,청북,718,38,61,113,55,34,1019,1007,60,57,101,66,44,1335,
20221028,253,741,서서울,평택고덕,880,27,18,23,13,59,1020,1330,36,25,30,9,99,1529,
20221028,254,102,군자,동수원,4155,66,86,31,28,257,4623,3856,52,66,19,27,198,4218,
20221028,254,103,군자,수원신갈,1852,119,88,128,100,105,2392,1565,108,57,72,73,80,1955,
20221028,254,173,군자,양지,757,108,86,164,196,28,1339,886,110,79,176,213,42,1506,
20221028,254,212,군자,북수원,1008,34,27,17,16,62,1164,1824,30,36,16,22,104,2032,
20221028,254,213,군자,부곡,782,33,23,34,313,40,1225,961,25,25,32,379,49,1471,
20221028,254,215,군자,군포,2924,125,116,126,159,188,3638,2279,71,65,37,75,143,2670,
20221028,254,255,군자,서안산,9863,406,228,231,298,685,11711,9712,386,214,213,278,673,11476,
20221028,254,256,군자,안산,4649,143,126,46,73,358,5395,4890,117,131,51,70,398,5657,
20221028,254,281,군자,매송,1050,35,31,31,64,68,1279,978,33,21,26,60,53,1171,
20221028,254,282,군자,비봉,1407,141,77,85,214,90,2014,1039,107,68,74,160,69,1517,
20221028,254,283,군자,발안,1027,86,77,56,125,50,1421,1163,82,57,58,110,64,1534,
20221028,255,102,서안산,동수원,1850,40,21,21,4,100,2036,1755,41,25,15,5,85,1926,
20221028,255,215,서안산,군포,1510,74,59,77,64,117,1901,1344,38,30,18,18,90,1538,
20221028,255,253,서안산,서서울,15250,501,606,558,347,897,18159,15127,517,656,597,352,875,18124,
20221028,255,254,서안산,군자,9712,386,214,213,278,673,11476,9863,406,228,231,298,685,11711,
20221028,256,253,안산,서서울,6239,126,69,40,57,464,6995,9058,171,91,47,26,617,10010,
20221028,256,254,안산,군자,4890,117,131,51,70,398,5657,4649,143,126,46,73,358,5395,
20221028,261,249,동광주,담양,2086,39,139,18,69,83,2434,2351,28,129,10,99,89,2706,
20221028,261,263,동광주,옥과,2729,24,114,16,55,134,3072,2455,16,106,12,66,92,2747,
20221028,261,265,동광주,곡성,1873,26,44,21,43,77,2084,1598,12,32,12,16,47,1717,
20221028,261,271,동광주,순천,3158,70,121,40,90,110,3589,3136,86,80,18,88,71,3479,
20221028,263,261,옥과,동광주,2455,16,106,12,66,92,2747,2729,24,114,16,55,134,3072,
20221028,265,261,곡성,동광주,1598,12,32,12,16,47,1717,1873,26,44,21,43,77,2084,
20221028,267,271,주암송광사,순천,963,15,23,15,32,50,1098,922,17,21,9,17,39,1025,
20221028,271,261,순천,동광주,3136,86,80,18,88,71,3479,3158,70,121,40,90,110,3589,
20221028,271,267,순천,주암송광사,922,17,21,9,17,39,1025,963,15,23,15,32,50,1098,
20221028,271,569,순천,북광주,1045,80,57,32,137,31,1382,972,67,36,25,82,29,1211,
20221028,272,145,광양,산인,987,21,49,21,12,19,1109,897,13,50,17,35,25,1037,
20221028,280,519,거창,남대구,972,28,47,8,6,53,1114,988,33,62,5,6,39,1133,
20221028,281,253,매송,서서울,4787,68,41,34,73,291,5294,3735,68,37,21,22,233,4116,
20221028,281,254,매송,군자,978,33,21,26,60,53,1171,1050,35,31,31,64,68,1279,
20221028,282,253,비봉,서서울,5868,298,267,169,536,362,7500,5807,247,234,155,484,320,7247,
20221028,282,254,비봉,군자,1039,107,68,74,160,69,1517,1407,141,77,85,214,90,2014,
20221028,283,253,발안,서서울,4279,229,203,205,118,248,5282,3094,148,165,157,116,168,3848,
20221028,283,254,발안,군자,1163,82,57,58,110,64,1534,1027,86,77,56,125,50,1421,
20221028,285,253,서평택,서서울,1711,94,131,349,543,100,2928,1421,68,103,269,402,92,2355,
20221028,285,287,서평택,송악,700,40,88,72,577,45,1522,881,57,90,90,443,56,1617,
20221028,287,253,송악,서서울,2518,52,52,86,370,80,3158,2140,44,68,54,191,74,2571,
20221028,287,285,송악,서평택,881,57,90,90,443,56,1617,700,40,88,72,577,45,1522,
20221028,288,253,당진,서서울,1520,35,43,36,56,95,1785,1565,29,46,28,37,67,1772,
20221028,289,140,마산,부산,1114,13,13,11,8,40,1199,1075,15,17,18,7,48,1180,
20221028,289,146,마산,동창원,2713,101,70,63,62,204,3213,2919,85,65,57,91,241,3458,
20221028,289,147,마산,진례,1357,102,93,55,75,99,1781,1379,89,86,55,93,93,1795,
20221028,289,148,마산,서김해,1650,27,66,15,14,114,1886,1708,29,63,9,8,122,1939,
20221028,289,149,마산,동김해,1063,35,40,24,10,79,1251,974,38,40,25,11,68,1156,
20221028,289,150,마산,북부산,3574,35,106,12,29,160,3916,3256,39,97,14,26,140,3572,
20221028,289,244,마산,서부산,3852,73,256,53,63,179,4476,3808,72,286,44,78,184,4472,
20221028,289,245,마산,장유,1761,33,41,20,14,118,1987,1710,37,45,14,18,132,1956,
20221028,289,757,마산,진영,766,53,50,33,89,48,1039,896,53,60,46,85,52,1192,
20221028,291,145,사천,산인,1747,52,47,22,25,81,1974,1660,44,56,15,24,69,1868,
20221028,291,225,사천,서진주,1131,25,37,27,30,87,1337,1083,18,24,27,36,86,1274,
20221028,291,292,사천,진주,2783,67,80,41,54,247,3272,3540,90,107,57,56,289,4139,
20221028,292,145,진주,산인,1948,39,153,21,18,107,2286,1817,28,152,11,19,105,2132,
20221028,292,291,진주,사천,3540,90,107,57,56,289,4139,2783,67,80,41,54,247,3272,
20221028,293,145,문산,산인,1512,26,24,8,6,87,1663,1419,24,23,12,9,76,1563,
20221028,298,253,서산,서서울,2397,26,61,67,47,87,2685,3458,30,71,50,28,111,3748,
20221028,508,509,무안,목포,1528,49,51,33,68,65,1794,1857,48,46,33,73,84,2141,
20221028,508,553,무안,동광산,1496,34,53,20,27,54,1684,1539,40,43,25,25,62,1734,
20221028,509,508,목포,무안,1857,48,46,33,73,84,2141,1528,49,51,33,68,65,1794,
20221028,509,553,목포,동광산,8184,186,214,164,390,273,9411,8004,175,236,179,423,274,9291,
20221028,513,515,고성,북통영,1665,43,94,13,33,95,1943,2018,45,85,12,24,148,2332,
20221028,513,516,고성,통영,3779,84,159,92,183,268,4565,3762,85,169,96,167,241,4520,
20221028,514,516,동고성,통영,1274,21,57,38,110,158,1658,1267,23,63,47,112,159,1671,
20221028,515,513,북통영,고성,2018,45,85,12,24,148,2332,1665,43,94,13,33,95,1943,
20221028,516,513,통영,고성,3762,85,169,96,167,241,4520,3779,84,159,92,183,268,4565,
20221028,516,514,통영,동고성,1267,23,63,47,112,159,1671,1274,21,57,38,110,158,1658,
20221028,517,597,양평,서여주,882,36,78,49,42,51,1138,943,30,33,44,24,52,1126,
20221028,517,598,양평,북여주,1530,28,21,27,87,54,1747,1236,16,21,23,37,43,1376,
20221028,519,231,남대구,화원옥포,6201,146,106,138,171,489,7251,6569,182,101,147,206,474,7679,
20221028,519,232,남대구,달성,2960,129,141,45,26,194,3495,2864,123,169,42,32,198,3428,
20221028,519,233,남대구,현풍,4524,176,201,100,95,310,5406,5103,216,221,83,144,372,6139,
20221028,519,239,남대구,칠원,1564,53,80,52,77,56,1882,1498,55,91,39,116,71,1870,
20221028,519,241,남대구,동고령,3099,88,93,217,214,156,3867,3088,85,77,230,215,161,3856,
20221028,519,242,남대구,고령,1956,34,65,20,149,83,2307,1919,36,59,20,153,96,2283,
20221028,519,280,남대구,거창,988,33,62,5,6,39,1133,972,28,47,8,6,53,1114,
20221028,519,730,남대구,유천,2571,62,23,1,2,163,2822,2962,46,14,0,0,200,3222,
20221028,519,731,남대구,북현풍,2055,23,33,1,1,136,2249,1620,20,6,0,0,111,1757,
20221028,520,253,평택,서서울,2677,116,112,218,132,131,3386,2330,94,105,170,118,105,2922,
20221028,520,540,평택,청북,1471,91,140,122,96,60,1980,900,83,137,134,97,56,1407,
20221028,520,741,평택,평택고덕,1101,13,216,20,25,95,1470,866,12,166,15,18,74,1151,
20221028,524,129,청통와촌,북대구,1166,74,34,16,36,51,1377,962,45,22,13,18,38,1098,
20221028,524,230,청통와촌,팔공산,1050,43,31,10,28,62,1224,1152,48,36,8,13,65,1322,
20221028,526,527,서포항,포항,1027,5,20,7,37,61,1157,1289,12,15,5,20,92,1433,
20221028,527,127,포항,서대구,957,35,32,16,51,35,1126,1250,26,45,25,78,60,1484,
20221028,527,129,포항,북대구,2263,46,32,24,70,115,2550,1650,28,22,23,59,66,1848,
20221028,527,230,포항,팔공산,1555,27,14,10,30,59,1695,1558,26,16,12,24,69,1705,
20221028,527,526,포항,서포항,1289,12,15,5,20,92,1433,1027,5,20,7,37,61,1157,
20221028,528,101,기흥동탄,서울,7373,73,1389,131,11,347,9324,6612,79,1240,126,8,329,8394,
20221028,528,103,기흥동탄,수원신갈,2119,16,152,7,4,110,2408,1492,20,200,4,2,107,1825,
20221028,528,106,기흥동탄,오산,954,40,39,18,7,79,1137,881,33,44,17,16,70,1061,
20221028,528,107,기흥동탄,안성,1207,20,29,4,3,89,1352,1027,11,28,6,4,84,1160,
20221028,528,108,기흥동탄,천안,1166,20,122,3,13,76,1400,1141,13,114,5,12,71,1356,
20221028,540,253,청북,서서울,1007,60,57,101,66,44,1335,718,38,61,113,55,34,1019,
20221028,540,520,청북,평택,900,83,137,134,97,56,1407,1471,91,140,122,96,60,1980,
20221028,540,741,청북,평택고덕,963,22,45,60,112,85,1287,1072,28,48,66,128,105,1447,
20221028,542,101,서안성,서울,1826,44,68,149,55,94,2236,1146,36,95,102,27,56,1462,
20221028,542,543,서안성,남안성,1079,46,93,115,130,97,1560,1191,47,92,109,106,100,1645,
20221028,543,101,남안성,서울,1076,93,88,101,84,49,1491,1135,71,73,63,64,41,1447,
20221028,543,542,남안성,서안성,1191,47,92,109,106,100,1645,1079,46,93,115,130,97,1560,
20221028,543,555,남안성,북진천,881,107,154,190,158,51,1541,868,109,140,171,154,61,1503,
20221028,548,553,북무안,동광산,1532,31,39,27,73,52,1754,1799,33,38,31,110,57,2068,
20221028,549,553,동함평,동광산,3563,53,70,20,58,123,3887,3718,50,81,27,49,132,4057,
20221028,551,553,나주,동광산,1385,19,28,143,57,77,1709,1424,16,41,138,57,59,1735,
20221028,552,553,서광산,동광산,4818,176,192,231,244,176,5837,6296,213,248,218,219,243,7437,
20221028,553,508,동광산,무안,1539,40,43,25,25,62,1734,1496,34,53,20,27,54,1684,
20221028,553,509,동광산,목포,8004,175,236,179,423,274,9291,8184,186,214,164,390,273,9411,
20221028,553,548,동광산,북무안,1799,33,38,31,110,57,2068,1532,31,39,27,73,52,1754,
20221028,553,549,동광산,동함평,3718,50,81,27,49,132,4057,3563,53,70,20,58,123,3887,
20221028,553,551,동광산,나주,1424,16,41,138,57,59,1735,1385,19,28,143,57,77,1709,
20221028,553,552,동광산,서광산,6296,213,248,218,219,243,7437,4818,176,192,231,244,176,5837,
20221028,554,174,동홍천,춘천,1470,18,21,4,7,110,1630,1164,21,18,11,7,79,1300,
20221028,555,543,북진천,남안성,868,109,140,171,154,61,1503,881,107,154,190,158,51,1541,
20221028,556,557,동순천,황전,1161,18,22,11,71,38,1321,984,11,25,13,59,30,1122,
20221028,557,556,황전,동순천,984,11,25,13,59,30,1122,1161,18,22,11,71,38,1321,
20221028,560,190,감곡,동서울,910,36,26,30,77,29,1108,1068,15,30,36,62,28,1239,
20221028,567,167,남고창,광주,1383,27,43,17,38,44,1552,1445,34,44,17,28,51,1619,
20221028,569,271,북광주,순천,972,67,36,25,82,29,1211,1045,80,57,32,137,31,1382,
20221028,579,115,남세종,대전,999,17,19,4,27,60,1126,1094,14,18,3,18,81,1228,
20221028,579,153,남세종,서대전,1091,24,22,7,22,99,1265,1267,18,11,5,13,97,1411,
20221028,583,704,동해,근덕,848,7,35,10,54,63,1017,874,13,30,13,53,57,1040,
20221028,587,589,오수,상관,1220,17,60,41,47,41,1426,1398,17,50,32,114,53,1664,
20221028,589,587,상관,오수,1398,17,50,32,114,53,1664,1220,17,60,41,47,41,1426,
20221028,597,517,서여주,양평,943,30,33,44,24,52,1126,882,36,78,49,42,51,1138,
20221028,597,598,서여주,북여주,953,50,128,38,60,57,1286,1060,34,70,35,51,63,1313,
20221028,598,517,북여주,양평,1236,16,21,23,37,43,1376,1530,28,21,27,87,54,1747,
20221028,598,597,북여주,서여주,1060,34,70,35,51,63,1313,953,50,128,38,60,57,1286,
20221028,621,127,동대구,서대구,1244,35,34,29,46,105,1493,1821,51,74,36,54,137,2173,
20221028,621,131,동대구,경산,2450,79,49,157,58,114,2907,2180,74,34,150,67,116,2621,
20221028,621,132,동대구,영천,1210,16,26,0,39,72,1363,1187,16,24,4,39,63,1333,
20221028,625,626,밀양,남밀양,1394,69,51,53,67,72,1706,1690,62,55,46,80,74,2007,
20221028,626,625,남밀양,밀양,1690,62,55,46,80,74,2007,1394,69,51,53,67,72,1706,
20221028,626,627,남밀양,삼랑진,1049,23,36,18,43,98,1267,1028,29,19,18,50,87,1231,
20221028,627,626,삼랑진,남밀양,1028,29,19,18,50,87,1231,1049,23,36,18,43,98,1267,
20221028,641,139,울산,서울산,1305,23,65,20,30,93,1536,1427,46,80,38,32,104,1727,
20221028,641,252,울산,대동,1513,70,101,32,77,86,1879,1783,75,101,38,50,112,2159,
20221028,641,643,울산,청량,1209,14,26,14,53,110,1426,1367,5,14,9,21,127,1543,
20221028,641,648,울산,해운대,995,8,10,3,6,76,1098,1203,8,20,0,8,84,1323,
20221028,641,706,울산,남경주,1238,11,36,11,40,69,1405,1279,6,43,23,29,63,1443,
20221028,641,707,울산,남포항,1263,14,31,15,175,71,1569,1367,21,33,39,169,66,1695,
20221028,643,641,청량,울산,1367,5,14,9,21,127,1543,1209,14,26,14,53,110,1426,
20221028,643,648,청량,해운대,3242,18,34,25,79,213,3611,3273,45,70,36,542,221,4187,
20221028,645,648,장안,해운대,1652,14,19,7,13,102,1807,3107,32,39,164,108,194,3644,
20221028,646,648,기장일광,해운대,4688,19,31,26,88,304,5156,5509,38,43,22,268,344,6224,
20221028,648,641,해운대,울산,1203,8,20,0,8,84,1323,995,8,10,3,6,76,1098,
20221028,648,643,해운대,청량,3273,45,70,36,542,221,4187,3242,18,34,25,79,213,3611,
20221028,648,645,해운대,장안,3107,32,39,164,108,194,3644,1652,14,19,7,13,102,1807,
20221028,648,646,해운대,기장일광,5509,38,43,22,268,344,6224,4688,19,31,26,88,304,5156,
20221028,648,707,해운대,남포항,926,11,31,24,162,37,1191,1050,10,17,9,37,46,1169,
20221028,651,652,남양주,화도,14539,453,532,448,260,964,17196,16687,577,631,491,258,1209,19853,
20221028,651,653,남양주,서종,1972,12,12,8,9,91,2104,2066,20,16,8,8,97,2215,
20221028,651,654,남양주,설악,5204,45,87,17,15,194,5562,3576,25,82,18,15,139,3855,
20221028,651,655,남양주,강촌,3409,38,122,23,44,133,3769,2773,38,130,32,41,103,3117,
20221028,651,656,남양주,남춘천,3520,27,67,31,68,101,3814,2369,20,42,15,49,70,2565,
20221028,652,651,화도,남양주,16687,577,631,491,258,1209,19853,14539,453,532,448,260,964,17196,
20221028,652,653,화도,서종,1591,37,21,48,23,133,1853,1674,48,21,40,27,127,1937,
20221028,652,654,화도,설악,1811,31,23,10,14,99,1988,1203,25,19,12,16,76,1351,
20221028,653,651,서종,남양주,2066,20,16,8,8,97,2215,1972,12,12,8,9,91,2104,
20221028,653,652,서종,화도,1674,48,21,40,27,127,1937,1591,37,21,48,23,133,1853,
20221028,654,651,설악,남양주,3576,25,82,18,15,139,3855,5204,45,87,17,15,194,5562,
20221028,654,652,설악,화도,1203,25,19,12,16,76,1351,1811,31,23,10,14,99,1988,
20221028,655,651,강촌,남양주,2773,38,130,32,41,103,3117,3409,38,122,23,44,133,3769,
20221028,656,651,남춘천,남양주,2369,20,42,15,49,70,2565,3520,27,67,31,68,101,3814,
20221028,671,672,봉담,정남,3317,192,97,74,134,231,4045,4342,190,96,71,175,309,5183,
20221028,671,673,봉담,북오산,2185,70,59,18,19,199,2550,2255,59,46,25,23,165,2573,
20221028,671,675,봉담,서오산,906,24,27,3,14,54,1028,994,18,18,7,15,71,1123,
20221028,671,676,봉담,향남,1312,95,55,41,24,86,1613,1482,107,46,26,44,107,1812,
20221028,671,677,봉담,북평택,9622,183,256,147,300,509,11017,8964,175,232,154,276,487,10288,
20221028,672,671,정남,봉담,4342,190,96,71,175,309,5183,3317,192,97,74,134,231,4045,
20221028,673,101,북오산,서울,1388,28,117,27,12,108,1680,1485,37,112,24,12,91,1761,
20221028,673,671,북오산,봉담,2255,59,46,25,23,165,2573,2185,70,59,18,19,199,2550,
20221028,673,677,북오산,북평택,2294,31,92,36,37,165,2655,1907,39,54,30,33,117,2180,
20221028,675,671,서오산,봉담,994,18,18,7,15,71,1123,906,24,27,3,14,54,1028,
20221028,675,676,서오산,향남,3546,116,82,54,256,225,4279,3206,99,67,31,251,183,3837,
20221028,675,677,서오산,북평택,13482,237,442,172,213,812,15358,12068,209,398,188,178,745,13786,
20221028,675,876,서오산,양감,1756,67,43,50,90,110,2116,2227,60,38,46,83,168,2622,
20221028,676,671,향남,봉담,1482,107,46,26,44,107,1812,1312,95,55,41,24,86,1613,
20221028,676,675,향남,서오산,3206,99,67,31,251,183,3837,3546,116,82,54,256,225,4279,
20221028,676,677,향남,북평택,1934,172,185,239,162,118,2810,1466,133,158,205,118,101,2181,
20221028,677,101,북평택,서울,1233,60,200,86,145,63,1787,1597,56,284,77,108,72,2194,
20221028,677,671,북평택,봉담,8964,175,232,154,276,487,10288,9622,183,256,147,300,509,11017,
20221028,677,673,북평택,북오산,1907,39,54,30,33,117,2180,2294,31,92,36,37,165,2655,
20221028,677,675,북평택,서오산,12068,209,398,188,178,745,13786,13482,237,442,172,213,812,15358,
20221028,677,676,북평택,향남,1466,133,158,205,118,101,2181,1934,172,185,239,162,118,2810,
20221028,677,876,북평택,양감,2640,152,200,234,157,159,3542,2254,135,176,242,140,153,3100,
20221028,682,683,조암,송산마도,782,95,77,81,45,40,1120,904,112,99,81,71,51,1318,
20221028,682,684,조암,남안산,872,155,177,91,74,47,1416,1072,147,187,123,86,35,1650,
20221028,682,685,조암,서시흥,1671,168,159,144,249,87,2478,1871,149,170,136,296,94,2716,
20221028,683,682,송산마도,조암,904,112,99,81,71,51,1318,782,95,77,81,45,40,1120,
20221028,683,684,송산마도,남안산,2687,194,175,115,254,167,3592,2209,181,138,95,183,130,2936,
20221028,683,685,송산마도,서시흥,5429,296,232,224,830,319,7330,4659,278,242,203,789,256,6427,
20221028,684,682,남안산,조암,1072,147,187,123,86,35,1650,872,155,177,91,74,47,1416,
20221028,684,683,남안산,송산마도,2209,181,138,95,183,130,2936,2687,194,175,115,254,167,3592,
20221028,684,685,남안산,서시흥,5123,573,316,433,597,369,7411,4930,389,326,383,443,359,6830,
20221028,685,682,서시흥,조암,1871,149,170,136,296,94,2716,1671,168,159,144,249,87,2478,
20221028,685,683,서시흥,송산마도,4659,278,242,203,789,256,6427,5429,296,232,224,830,319,7330,
20221028,685,684,서시흥,남안산,4930,389,326,383,443,359,6830,5123,573,316,433,597,369,7411,
20221028,704,583,근덕,동해,874,13,30,13,53,57,1040,848,7,35,10,54,63,1017,
20221028,705,190,남이천,동서울,2158,115,55,104,81,72,2585,1633,98,59,103,88,44,2025,
20221028,706,641,남경주,울산,1279,6,43,23,29,63,1443,1238,11,36,11,40,69,1405,
20221028,706,707,남경주,남포항,1183,23,74,36,274,72,1662,1225,30,70,29,214,60,1628,
20221028,707,641,남포항,울산,1367,21,33,39,169,66,1695,1263,14,31,15,175,71,1569,
20221028,707,648,남포항,해운대,1050,10,17,9,37,46,1169,926,11,31,24,162,37,1191,
20221028,707,706,남포항,남경주,1225,30,70,29,214,60,1628,1183,23,74,36,274,72,1662,
20221028,707,708,남포항,동경주,1627,22,31,25,152,91,1948,1692,25,36,30,226,101,2110,
20221028,708,707,동경주,남포항,1692,25,36,30,226,101,2110,1627,22,31,25,152,91,1948,
20221028,715,716,동안동,청송,1267,28,22,24,41,67,1449,1288,25,23,25,39,62,1462,
20221028,716,715,청송,동안동,1288,25,23,25,39,62,1462,1267,28,22,24,41,67,1449,
20221028,730,201,유천,칠곡,937,4,4,0,0,67,1012,1057,11,4,0,3,65,1140,
20221028,730,519,유천,남대구,2962,46,14,0,0,200,3222,2571,62,23,1,2,163,2822,
20221028,731,519,북현풍,남대구,1620,20,6,0,0,111,1757,2055,23,33,1,1,136,2249,
20221028,741,253,평택고덕,서서울,1330,36,25,30,9,99,1529,880,27,18,23,13,59,1020,
20221028,741,520,평택고덕,평택,866,12,166,15,18,74,1151,1101,13,216,20,25,95,1470,
20221028,741,540,평택고덕,청북,1072,28,48,66,128,105,1447,963,22,45,60,112,85,1287,
20221028,742,107,남사진위,안성,1550,41,48,39,9,103,1790,1458,35,47,34,4,103,1681,
20221028,742,108,남사진위,천안,1180,34,36,28,13,70,1361,1539,26,27,21,9,98,1720,
20221028,752,252,기장철마,대동,1951,66,59,44,61,150,2331,1877,67,45,44,135,120,2288,
20221028,753,252,금정,대동,1152,55,58,66,68,74,1473,1935,101,94,83,175,113,2501,
20221028,755,140,광재,부산,957,10,22,8,12,67,1076,1128,12,26,6,10,75,1257,
20221028,755,252,광재,대동,2232,100,90,115,469,132,3138,2431,101,89,117,307,139,3184,
20221028,756,252,한림,대동,946,39,45,25,101,40,1196,842,39,35,32,55,45,1048,
20221028,757,289,진영,마산,896,53,60,46,85,52,1192,766,53,50,33,89,48,1039,
20221028,772,774,북달성,남칠곡,2685,55,50,42,32,142,3006,2745,59,66,44,27,150,3091,
20221028,773,774,북다사,남칠곡,1507,23,13,14,21,78,1656,1414,30,24,6,16,91,1581,
20221028,774,772,남칠곡,북달성,2745,59,66,44,27,150,3091,2685,55,50,42,32,142,3006,
20221028,774,773,남칠곡,북다사,1414,30,24,6,16,91,1581,1507,23,13,14,21,78,1656,
20221028,775,203,동명동호,가산,1786,62,42,52,269,83,2294,1762,66,51,51,326,80,2336,
20221028,776,777,연경,파군재,3890,47,46,17,30,279,4309,3021,45,49,10,36,209,3370,
20221028,776,779,연경,율암,6524,108,96,100,232,449,7509,6486,120,100,83,208,459,7456,
20221028,777,776,파군재,연경,3021,45,49,10,36,209,3370,3890,47,46,17,30,279,4309,
20221028,777,779,파군재,율암,2953,19,20,14,33,269,3308,2822,25,16,5,43,251,3162,
20221028,779,776,율암,연경,6486,120,100,83,208,459,7456,6524,108,96,100,232,449,7509,
20221028,779,777,율암,파군재,2822,25,16,5,43,251,3162,2953,19,20,14,33,269,3308,
20221028,876,675,양감,서오산,2227,60,38,46,83,168,2622,1756,67,43,50,90,110,2116,
20221028,876,677,양감,북평택,2254,135,176,242,140,153,3100,2640,152,200,234,157,159,3542,
20221028,981,982,서영암,강진무위사,2062,44,81,60,41,97,2385,2334,56,88,100,46,100,2724,
20221028,981,987,서영암,남순천,2155,21,105,65,333,67,2746,2111,41,134,107,417,74,2884,
20221028,982,981,강진무위사,서영암,2334,56,88,100,46,100,2724,2062,44,81,60,41,97,2385,
20221028,982,987,강진무위사,남순천,1195,18,56,40,94,41,1444,965,14,51,50,102,22,1204,
20221028,984,985,보성,벌교,1719,35,57,36,75,48,1970,1711,41,48,24,60,44,1928,
20221028,984,987,보성,남순천,2322,50,85,58,302,65,2882,2301,45,113,57,260,69,2845,
20221028,985,984,벌교,보성,1711,41,48,24,60,44,1928,1719,35,57,36,75,48,1970,
20221028,986,987,고흥,남순천,4133,62,118,122,252,146,4833,4461,57,122,153,246,134,5173,
20221028,987,981,남순천,서영암,2111,41,134,107,417,74,2884,2155,21,105,65,333,67,2746,
20221028,987,982,남순천,강진무위사,965,14,51,50,102,22,1204,1195,18,56,40,94,41,1444,
20221028,987,984,남순천,보성,2301,45,113,57,260,69,2845,2322,50,85,58,302,65,2882,
20221028,987,986,남순천,고흥,4461,57,122,153,246,134,5173,4133,62,118,122,252,146,4833,
20221029,101,102,서울,동수원,3738,33,219,4,5,189,4188,4817,34,328,20,13,240,5452,
20221029,101,103,서울,수원신갈,14656,421,1038,319,86,619,17139,13726,455,1037,279,79,632,16208,
20221029,101,105,서울,기흥,6190,39,155,43,12,249,6688,5228,48,181,83,15,221,5776,
20221029,101,106,서울,오산,4722,224,323,98,34,287,5688,5387,329,357,134,54,321,6582,
20221029,101,107,서울,안성,3929,43,283,21,10,208,4494,3536,41,250,23,16,177,4043,
20221029,101,108,서울,천안,6119,53,368,43,12,263,6858,5448,32,371,24,14,246,6135,
20221029,101,111,서울,청주,937,13,344,15,10,35,1354,969,7,343,14,11,45,1389,
20221029,101,171,서울,마성,4051,62,142,37,0,165,4457,3267,17,140,31,3,149,3607,
20221029,101,172,서울,용인,2662,65,66,22,10,148,2973,3614,82,84,36,22,214,4052,
20221029,101,173,서울,양지,2384,117,107,41,23,75,2747,4563,287,123,81,73,146,5273,
20221029,101,528,서울,기흥동탄,6561,37,522,94,7,300,7521,6652,39,530,90,7,272,7590,
20221029,101,542,서울,서안성,1179,22,73,77,13,44,1408,2196,29,67,157,33,130,2612,
20221029,101,543,서울,남안성,1050,39,31,41,25,38,1224,1269,67,51,68,41,48,1544,
20221029,101,673,서울,북오산,1632,23,96,20,5,85,1861,1722,29,96,16,8,104,1975,
20221029,101,677,서울,북평택,2996,34,201,43,64,121,3459,2411,29,171,51,93,125,2880,
20221029,102,101,동수원,서울,4817,34,328,20,13,240,5452,3738,33,219,4,5,189,4188,
20221029,102,212,동수원,북수원,3735,12,155,3,8,182,4095,4013,23,150,8,12,221,4427,
20221029,102,214,동수원,동군포,1839,24,9,5,2,88,1967,1601,17,12,3,2,85,1720,
20221029,102,215,동수원,군포,1407,12,13,1,2,60,1495,1909,15,17,2,1,100,2044,
20221029,102,253,동수원,서서울,6323,46,41,6,12,342,6770,6047,38,44,20,9,331,6489,
20221029,102,254,동수원,군자,4788,28,49,15,15,234,5129,5496,41,52,11,27,278,5905,
20221029,102,255,동수원,서안산,1225,25,12,7,4,55,1328,1537,28,12,13,7,80,1677,
20221029,103,101,수원신갈,서울,13726,455,1037,279,79,632,16208,14656,421,1038,319,86,619,17139,
20221029,103,105,수원신갈,기흥,1773,10,10,6,34,99,1932,2270,11,6,3,31,109,2430,
20221029,103,108,수원신갈,천안,1191,5,31,3,0,43,1273,1336,8,32,5,5,52,1438,
20221029,103,253,수원신갈,서서울,2273,99,67,58,21,115,2633,2769,76,67,41,27,124,3104,
20221029,103,254,수원신갈,군자,1908,82,40,43,45,87,2205,2592,81,47,71,54,119,2964,
20221029,103,528,수원신갈,기흥동탄,1181,5,16,0,1,59,1262,1604,16,8,0,4,90,1722,
20221029,105,101,기흥,서울,5228,48,181,83,15,221,5776,6190,39,155,43,12,249,6688,
20221029,105,103,기흥,수원신갈,2270,11,6,3,31,109,2430,1773,10,10,6,34,99,1932,
20221029,106,101,오산,서울,5387,329,357,134,54,321,6582,4722,224,323,98,34,287,5688,
20221029,106,107,오산,안성,1484,16,15,8,14,114,1651,1045,18,13,9,9,81,1175,
20221029,107,101,안성,서울,3536,41,250,23,16,177,4043,3929,43,283,21,10,208,4494,
20221029,107,106,안성,오산,1045,18,13,9,9,81,1175,1484,16,15,8,14,114,1651,
20221029,107,108,안성,천안,1717,16,28,5,8,117,1891,1815,30,27,6,2,115,1995,
20221029,107,742,안성,남사진위,1133,22,34,20,10,80,1299,1616,22,43,24,10,83,1798,
20221029,108,101,천안,서울,5448,32,371,24,14,246,6135,6119,53,368,43,12,263,6858,
20221029,108,103,천안,수원신갈,1336,8,32,5,5,52,1438,1191,5,31,3,0,43,1273,
20221029,108,107,천안,안성,1815,30,27,6,2,115,1995,1717,16,28,5,8,117,1891,
20221029,108,229,천안,북천안,2301,33,70,25,19,104,2552,2083,50,100,30,22,132,2417,
20221029,108,742,천안,남사진위,1035,12,23,21,5,55,1151,1588,31,23,20,10,74,1746,
20221029,111,101,청주,서울,969,7,343,14,11,45,1389,937,13,344,15,10,35,1354,
20221029,112,115,남청주,대전,1377,64,69,6,43,93,1652,1235,73,56,5,12,91,1472,
20221029,114,153,남대전,서대전,1666,34,43,26,53,96,1918,1456,28,48,29,54,91,1706,
20221029,115,112,대전,남청주,1235,73,56,5,12,91,1472,1377,64,69,6,43,93,1652,
20221029,115,116,대전,옥천,2207,62,25,17,9,170,2490,2081,45,30,16,17,149,2338,
20221029,116,115,옥천,대전,2081,45,30,16,17,149,2338,2207,62,25,17,9,170,2490,
20221029,119,153,판암,서대전,1848,14,13,4,74,124,2077,1855,16,15,10,67,131,2094,
20221029,123,127,구미,서대구,1997,34,27,13,4,110,2185,1964,29,27,11,4,96,2131,
20221029,123,129,구미,북대구,2207,11,61,5,2,83,2369,2236,8,54,2,5,90,2395,
20221029,123,130,구미,동김천,1051,12,14,19,13,56,1165,902,16,12,13,7,53,1003,
20221029,125,127,남구미,서대구,1864,23,45,24,12,126,2094,1909,31,53,23,10,116,2142,
20221029,125,129,남구미,북대구,1759,11,27,4,2,92,1895,1884,7,27,9,5,87,2019,
20221029,126,127,왜관,서대구,2348,83,46,23,55,119,2674,2729,90,43,14,53,136,3065,
20221029,126,129,왜관,북대구,2773,61,41,12,69,132,3088,3389,71,49,18,70,146,3743,
20221029,127,123,서대구,구미,1964,29,27,11,4,96,2131,1997,34,27,13,4,110,2185,
20221029,127,125,서대구,남구미,1909,31,53,23,10,116,2142,1864,23,45,24,12,126,2094,
20221029,127,126,서대구,왜관,2729,90,43,14,53,136,3065,2348,83,46,23,55,119,2674,
20221029,127,131,서대구,경산,2064,105,61,43,45,118,2436,1443,61,51,25,46,81,1707,
20221029,127,203,서대구,가산,2218,28,40,22,36,95,2439,2124,40,39,24,61,96,2384,
20221029,127,230,서대구,팔공산,1525,23,17,8,3,67,1643,949,20,12,2,5,35,1023,
20221029,127,527,서대구,포항,2139,26,33,16,32,85,2331,1314,24,22,5,35,56,1456,
20221029,127,621,서대구,동대구,1620,37,63,24,33,88,1865,993,25,16,22,29,55,1140,
20221029,129,123,북대구,구미,2236,8,54,2,5,90,2395,2207,11,61,5,2,83,2369,
20221029,129,125,북대구,남구미,1884,7,27,9,5,87,2019,1759,11,27,4,2,92,1895,
20221029,129,126,북대구,왜관,3389,71,49,18,70,146,3743,2773,61,41,12,69,132,3088,
20221029,129,131,북대구,경산,1685,53,44,32,16,83,1913,2296,103,62,31,47,145,2684,
20221029,129,524,북대구,청통와촌,934,32,17,5,7,31,1026,1114,42,22,9,30,49,1266,
20221029,129,527,북대구,포항,2308,18,20,16,30,114,2506,2972,33,32,16,60,127,3240,
20221029,130,123,동김천,구미,902,16,12,13,7,53,1003,1051,12,14,19,13,56,1165,
20221029,131,127,경산,서대구,1443,61,51,25,46,81,1707,2064,105,61,43,45,118,2436,
20221029,131,129,경산,북대구,2296,103,62,31,47,145,2684,1685,53,44,32,16,83,1913,
20221029,131,230,경산,팔공산,1068,37,23,10,11,60,1209,1097,44,31,7,10,67,1256,
20221029,131,621,경산,동대구,1694,46,28,11,34,101,1914,1702,45,34,15,47,92,1935,
20221029,132,621,영천,동대구,1095,8,25,2,58,35,1223,1200,8,21,3,64,55,1351,
20221029,135,140,경주,부산,2437,8,28,7,13,114,2607,2797,9,25,6,11,134,2982,
20221029,135,252,경주,대동,1881,12,61,21,59,113,2147,2402,19,54,11,40,129,2655,
20221029,135,621,경주,동대구,1238,3,44,0,3,54,1342,1316,1,42,0,1,50,1410,
20221029,137,140,통도사,부산,857,30,10,7,129,51,1084,1249,17,14,6,162,55,1503,
20221029,138,140,양산,부산,3923,166,90,36,60,190,4465,3953,193,99,39,54,169,4507,
20221029,138,252,양산,대동,1694,164,82,57,97,67,2161,1827,167,72,60,117,100,2343,
20221029,139,140,서울산,부산,2446,33,32,7,2,102,2622,2502,36,17,1,4,93,2653,
20221029,139,252,서울산,대동,1317,13,28,13,35,74,1480,1490,12,34,13,19,78,1646,
20221029,139,641,서울산,울산,1507,29,48,17,22,108,1731,1294,14,47,7,14,115,1491,
20221029,140,135,부산,경주,2797,9,25,6,11,134,2982,2437,8,28,7,13,114,2607,
20221029,140,137,부산,통도사,1249,17,14,6,162,55,1503,857,30,10,7,129,51,1084,
20221029,140,138,부산,양산,3953,193,99,39,54,169,4507,3923,166,90,36,60,190,4465,
20221029,140,139,부산,서울산,2502,36,17,1,4,93,2653,2446,33,32,7,2,102,2622,
20221029,140,250,부산,남양산,7798,106,178,12,18,506,8618,7496,98,160,10,22,511,8297,
20221029,140,251,부산,물금,870,120,16,12,15,42,1075,1020,107,16,13,16,44,1216,
20221029,140,252,부산,대동,1274,24,25,16,26,70,1435,1048,25,17,15,35,56,1196,
20221029,140,286,부산,통도사휴게소,1153,6,4,0,0,35,1198,1124,4,1,0,0,27,1156,
20221029,140,289,부산,마산,1750,7,17,2,2,53,1831,1109,6,9,2,0,33,1159,
20221029,140,755,부산,광재,1055,15,17,2,11,54,1154,926,11,7,6,7,52,1009,
20221029,142,145,군북,산인,4738,29,76,14,58,279,5194,6084,38,90,19,61,317,6609,
20221029,144,145,함안,산인,1990,26,26,16,93,143,2294,2123,30,16,14,89,134,2406,
20221029,145,142,산인,군북,6084,38,90,19,61,317,6609,4738,29,76,14,58,279,5194,
20221029,145,144,산인,함안,2123,30,16,14,89,134,2406,1990,26,26,16,93,143,2294,
20221029,145,272,산인,광양,1614,12,61,12,10,43,1752,992,5,37,9,6,28,1077,
20221029,145,291,산인,사천,2722,27,52,8,9,119,2937,2139,42,47,6,4,99,2337,
20221029,145,292,산인,진주,2889,17,153,4,14,162,3239,2502,17,149,9,11,147,2835,
20221029,145,293,산인,문산,2231,15,13,7,7,120,2393,1863,17,19,5,4,92,2000,
20221029,145,295,산인,진성,1448,11,8,8,8,51,1534,1183,6,12,6,7,41,1255,
20221029,146,150,동창원,북부산,1195,13,8,0,7,58,1281,1420,7,7,5,5,78,1522,
20221029,146,244,동창원,서부산,1358,11,26,11,43,79,1528,1832,20,42,12,77,80,2063,
20221029,146,289,동창원,마산,2687,45,42,19,44,211,3048,2456,49,34,20,28,189,2776,
20221029,147,244,진례,서부산,1179,33,25,35,32,82,1386,1228,45,29,26,27,69,1424,
20221029,148,150,서김해,북부산,6063,77,76,35,31,434,6716,5900,54,61,29,20,408,6472,
20221029,148,251,서김해,물금,947,31,11,20,14,80,1103,923,35,18,19,14,79,1088,
20221029,148,289,서김해,마산,2056,20,73,5,3,120,2277,1697,16,61,9,3,109,1895,
20221029,149,150,동김해,북부산,10293,134,136,25,50,749,11387,8659,108,122,17,48,604,9558,
20221029,149,250,동김해,남양산,1064,15,47,5,8,75,1214,896,17,42,4,3,64,1026,
20221029,149,251,동김해,물금,1142,42,11,4,2,80,1281,1023,39,6,8,4,74,1154,
20221029,149,289,동김해,마산,1133,17,43,15,8,68,1284,1061,21,28,9,4,68,1191,
20221029,150,146,북부산,동창원,1420,7,7,5,5,78,1522,1195,13,8,0,7,58,1281,
20221029,150,148,북부산,서김해,5900,54,61,29,20,408,6472,6063,77,76,35,31,434,6716,
20221029,150,149,북부산,동김해,8659,108,122,17,48,604,9558,10293,134,136,25,50,749,11387,
20221029,150,245,북부산,장유,4194,25,81,9,28,248,4585,3449,29,82,4,21,224,3809,
20221029,150,289,북부산,마산,5431,26,139,4,13,216,5829,4231,27,117,4,6,182,4567,
20221029,152,154,유성,안영,1099,18,26,11,25,49,1228,1122,16,16,18,34,59,1265,
20221029,153,114,서대전,남대전,1456,28,48,29,54,91,1706,1666,34,43,26,53,96,1918,
20221029,153,119,서대전,판암,1855,16,15,10,67,131,2094,1848,14,13,4,74,124,2077,
20221029,153,154,서대전,안영,1133,15,29,23,98,47,1345,1021,17,21,21,77,42,1199,
20221029,153,579,서대전,남세종,1099,13,10,6,15,71,1214,968,11,9,8,21,52,1069,
20221029,154,152,안영,유성,1122,16,16,18,34,59,1265,1099,18,26,11,25,49,1228,
20221029,154,153,안영,서대전,1021,17,21,21,77,42,1199,1133,15,29,23,98,47,1345,
20221029,158,167,전주,광주,1019,23,54,21,16,20,1153,1177,26,72,18,12,28,1333,
20221029,159,167,서전주,광주,2070,47,43,26,22,53,2261,2093,52,43,21,15,68,2292,
20221029,163,167,정읍,광주,1019,11,42,22,10,26,1130,968,14,39,19,9,23,1072,
20221029,166,167,장성,광주,2325,58,58,15,27,89,2572,3064,79,69,7,31,120,3370,
20221029,167,158,광주,전주,1177,26,72,18,12,28,1333,1019,23,54,21,16,20,1153,
20221029,167,159,광주,서전주,2093,52,43,21,15,68,2292,2070,47,43,26,22,53,2261,
20221029,167,163,광주,정읍,968,14,39,19,9,23,1072,1019,11,42,22,10,26,1130,
20221029,167,166,광주,장성,3064,79,69,7,31,120,3370,2325,58,58,15,27,89,2572,
20221029,167,530,광주,내장산,1255,19,20,8,7,34,1343,1108,16,17,9,10,27,1187,
20221029,167,567,광주,남고창,1760,20,39,6,17,44,1886,1766,19,42,9,18,64,1918,
20221029,169,545,장수,소양,1367,6,8,1,1,57,1440,1421,4,7,1,2,51,1486,
20221029,171,101,마성,서울,3267,17,140,31,3,149,3607,4051,62,142,37,0,165,4457,
20221029,171,253,마성,서서울,1147,8,4,1,2,67,1229,1518,9,8,4,6,99,1644,
20221029,172,101,용인,서울,3614,82,84,36,22,214,4052,2662,65,66,22,10,148,2973,
20221029,172,173,용인,양지,1603,85,58,44,38,82,1910,1309,76,74,48,25,98,1630,
20221029,172,253,용인,서서울,1042,29,11,25,5,64,1176,994,22,16,23,12,36,1103,
20221029,173,101,양지,서울,4563,287,123,81,73,146,5273,2384,117,107,41,23,75,2747,
20221029,173,172,양지,용인,1309,76,74,48,25,98,1630,1603,85,58,44,38,82,1910,
20221029,174,179,춘천,홍천,3575,43,69,9,36,280,4012,3297,60,74,11,26,267,3735,
20221029,174,216,춘천,횡성,1489,43,20,13,19,81,1665,1362,30,19,8,19,76,1514,
20221029,174,218,춘천,남원주,1531,18,62,8,10,84,1713,1564,16,64,11,9,89,1753,
20221029,174,554,춘천,동홍천,1313,13,17,4,7,62,1416,1186,10,7,1,3,73,1280,
20221029,176,190,이천,동서울,1610,29,71,116,46,61,1933,1003,21,59,24,23,47,1177,
20221029,177,190,여주,동서울,1212,11,27,28,12,35,1325,1161,7,34,24,16,40,1282,
20221029,179,174,홍천,춘천,3297,60,74,11,26,267,3735,3575,43,69,9,36,280,4012,
20221029,184,189,대관령,강릉,1689,31,55,4,10,72,1861,1766,30,49,6,5,85,1941,
20221029,189,184,강릉,대관령,1766,30,49,6,5,85,1941,1689,31,55,4,10,72,1861,
20221029,190,176,동서울,이천,1003,21,59,24,23,47,1177,1610,29,71,116,46,61,1933,
20221029,190,177,동서울,여주,1161,7,34,24,16,40,1282,1212,11,27,28,12,35,1325,
20221029,190,191,동서울,경기광주,9219,255,279,109,116,505,10483,8975,265,285,191,197,530,10443,
20221029,190,192,동서울,곤지암,4142,189,106,80,49,204,4770,4210,202,74,96,35,206,4823,
20221029,190,193,동서울,일죽,2939,55,87,76,59,97,3313,2716,62,84,96,55,110,3123,
20221029,190,194,동서울,서이천,4095,328,199,133,62,196,5013,3490,271,174,93,60,195,4283,
20221029,190,198,동서울,서청주,1318,11,20,14,10,50,1423,1399,6,18,13,9,47,1492,
20221029,190,199,동서울,오창,1050,8,11,5,16,42,1132,1271,2,12,6,15,51,1357,
20221029,190,560,동서울,감곡,1099,3,7,14,27,36,1186,1322,6,16,11,32,38,1425,
20221029,190,705,동서울,남이천,1456,33,32,35,44,49,1649,1838,38,19,30,27,62,2014,
20221029,191,190,경기광주,동서울,8975,265,285,191,197,530,10443,9219,255,279,109,116,505,10483,
20221029,192,190,곤지암,동서울,4210,202,74,96,35,206,4823,4142,189,106,80,49,204,4770,
20221029,192,194,곤지암,서이천,1721,151,76,67,59,74,2148,1306,93,55,48,47,72,1621,
20221029,193,190,일죽,동서울,2716,62,84,96,55,110,3123,2939,55,87,76,59,97,3313,
20221029,194,190,서이천,동서울,3490,271,174,93,60,195,4283,4095,328,199,133,62,196,5013,
20221029,194,192,서이천,곤지암,1306,93,55,48,47,72,1621,1721,151,76,67,59,74,2148,
20221029,198,190,서청주,동서울,1399,6,18,13,9,47,1492,1318,11,20,14,10,50,1423,
20221029,199,190,오창,동서울,1271,2,12,6,15,51,1357,1050,8,11,5,16,42,1132,
20221029,203,127,가산,서대구,2124,40,39,24,61,96,2384,2218,28,40,22,36,95,2439,
20221029,203,775,가산,동명동호,1829,39,31,25,243,71,2238,1572,28,20,11,74,59,1764,
20221029,207,775,남안동,동명동호,1039,11,11,3,9,42,1115,1044,8,9,4,7,45,1117,
20221029,212,102,북수원,동수원,4013,23,150,8,12,221,4427,3735,12,155,3,8,182,4095,
20221029,212,254,북수원,군자,2048,19,30,10,13,95,2215,1397,18,23,12,5,72,1527,
20221029,213,253,부곡,서서울,1346,69,27,27,37,99,1605,996,55,20,23,30,55,1179,
20221029,213,254,부곡,군자,1052,23,12,16,91,55,1249,1114,18,23,13,77,63,1308,
20221029,214,102,동군포,동수원,1601,17,12,3,2,85,1720,1839,24,9,5,2,88,1967,
20221029,215,102,군포,동수원,1909,15,17,2,1,100,2044,1407,12,13,1,2,60,1495,
20221029,215,253,군포,서서울,3470,32,48,17,33,215,3815,3821,63,83,55,65,236,4323,
20221029,215,254,군포,군자,2685,35,39,28,44,147,2978,3429,81,52,49,77,215,3903,
20221029,216,174,횡성,춘천,1362,30,19,8,19,76,1514,1489,43,20,13,19,81,1665,
20221029,218,174,남원주,춘천,1564,16,64,11,9,89,1753,1531,18,62,8,10,84,1713,
20221029,218,240,남원주,제천,2288,33,51,10,45,106,2533,2339,44,38,9,32,124,2586,
20221029,225,291,서진주,사천,1001,23,25,7,23,68,1147,915,16,24,6,18,57,1036,
20221029,229,108,북천안,천안,2083,50,100,30,22,132,2417,2301,33,70,25,19,104,2552,
20221029,230,127,팔공산,서대구,949,20,12,2,5,35,1023,1525,23,17,8,3,67,1643,
20221029,230,131,팔공산,경산,1097,44,31,7,10,67,1256,1068,37,23,10,11,60,1209,
20221029,230,524,팔공산,청통와촌,1136,23,20,7,21,50,1257,933,26,22,4,23,41,1049,
20221029,230,527,팔공산,포항,2499,28,16,2,9,85,2639,2081,18,14,4,20,73,2210,
20221029,231,519,화원옥포,남대구,5512,109,73,31,203,417,6345,5337,94,69,23,151,429,6103,
20221029,232,519,달성,남대구,1982,61,58,24,37,146,2308,1808,57,51,24,7,130,2077,
20221029,233,519,현풍,남대구,3995,99,125,32,81,247,4579,3510,78,108,48,55,213,4012,
20221029,237,239,남지,칠원,862,18,42,6,21,57,1006,1027,15,46,8,26,59,1181,
20221029,238,239,칠서,칠원,1034,37,25,65,253,75,1489,1116,41,48,49,311,70,1635,
20221029,239,237,칠원,남지,1027,15,46,8,26,59,1181,862,18,42,6,21,57,1006,
20221029,239,238,칠원,칠서,1116,41,48,49,311,70,1635,1034,37,25,65,253,75,1489,
20221029,239,519,칠원,남대구,2308,24,83,25,42,116,2598,2516,24,74,25,47,103,2789,
20221029,240,218,제천,남원주,2339,44,38,9,32,124,2586,2288,33,51,10,45,106,2533,
20221029,241,519,동고령,남대구,3085,50,68,54,145,149,3551,3213,60,66,34,144,165,3682,
20221029,242,519,고령,남대구,2830,18,63,12,88,119,3130,3545,19,57,13,91,136,3861,
20221029,243,519,해인사,남대구,1009,8,1,0,1,36,1055,1337,9,5,1,1,40,1393,
20221029,244,146,서부산,동창원,1832,20,42,12,77,80,2063,1358,11,26,11,43,79,1528,
20221029,244,147,서부산,진례,1228,45,29,26,27,69,1424,1179,33,25,35,32,82,1386,
20221029,244,245,서부산,장유,14830,114,315,55,105,985,16404,14000,101,290,54,113,924,15482,
20221029,244,289,서부산,마산,6166,40,317,26,34,271,6854,4456,36,288,17,21,213,5031,
20221029,245,150,장유,북부산,3449,29,82,4,21,224,3809,4194,25,81,9,28,248,4585,
20221029,245,244,장유,서부산,14000,101,290,54,113,924,15482,14830,114,315,55,105,985,16404,
20221029,245,289,장유,마산,1970,21,39,14,8,106,2158,1740,14,40,16,5,117,1932,
20221029,248,261,순창,동광주,1773,17,20,1,40,43,1894,2112,22,23,2,23,77,2259,
20221029,249,261,담양,동광주,2923,16,113,6,68,88,3214,2660,29,106,12,66,94,2967,
20221029,250,140,남양산,부산,7496,98,160,10,22,511,8297,7798,106,178,12,18,506,8618,
20221029,250,149,남양산,동김해,896,17,42,4,3,64,1026,1064,15,47,5,8,75,1214,
20221029,250,252,남양산,대동,2812,87,68,32,51,207,3257,3592,85,72,44,61,260,4114,
20221029,251,140,물금,부산,1020,107,16,13,16,44,1216,870,120,16,12,15,42,1075,
20221029,251,148,물금,서김해,923,35,18,19,14,79,1088,947,31,11,20,14,80,1103,
20221029,251,149,물금,동김해,1023,39,6,8,4,74,1154,1142,42,11,4,2,80,1281,
20221029,251,252,물금,대동,2768,138,36,66,209,188,3405,3512,151,40,49,249,252,4253,
20221029,252,135,대동,경주,2402,19,54,11,40,129,2655,1881,12,61,21,59,113,2147,
20221029,252,138,대동,양산,1827,167,72,60,117,100,2343,1694,164,82,57,97,67,2161,
20221029,252,139,대동,서울산,1490,12,34,13,19,78,1646,1317,13,28,13,35,74,1480,
20221029,252,140,대동,부산,1048,25,17,15,35,56,1196,1274,24,25,16,26,70,1435,
20221029,252,250,대동,남양산,3592,85,72,44,61,260,4114,2812,87,68,32,51,207,3257,
20221029,252,251,대동,물금,3512,151,40,49,249,252,4253,2768,138,36,66,209,188,3405,
20221029,252,641,대동,울산,2004,22,58,11,32,116,2243,1862,28,53,25,50,94,2112,
20221029,252,752,대동,기장철마,1669,28,23,15,61,123,1919,1781,25,25,8,23,140,2002,
20221029,252,753,대동,금정,1528,36,32,24,117,112,1849,908,29,20,18,66,59,1100,
20221029,252,755,대동,광재,1756,33,42,28,186,108,2153,1686,31,38,26,288,91,2160,
20221029,253,102,서서울,동수원,6047,38,44,20,9,331,6489,6323,46,41,6,12,342,6770,
20221029,253,103,서서울,수원신갈,2769,76,67,41,27,124,3104,2273,99,67,58,21,115,2633,
20221029,253,171,서서울,마성,1518,9,8,4,6,99,1644,1147,8,4,1,2,67,1229,
20221029,253,172,서서울,용인,994,22,16,23,12,36,1103,1042,29,11,25,5,64,1176,
20221029,253,213,서서울,부곡,996,55,20,23,30,55,1179,1346,69,27,27,37,99,1605,
20221029,253,215,서서울,군포,3821,63,83,55,65,236,4323,3470,32,48,17,33,215,3815,
20221029,253,255,서서울,서안산,10592,209,151,146,368,591,12057,12111,184,112,107,288,711,13513,
20221029,253,256,서서울,안산,8860,94,68,27,32,587,9668,5932,64,49,19,46,348,6458,
20221029,253,257,서서울,홍성,1633,4,14,2,0,59,1712,1004,9,12,10,6,53,1094,
20221029,253,281,서서울,매송,3317,33,15,14,30,175,3584,4147,33,30,11,76,222,4519,
20221029,253,282,서서울,비봉,5246,106,121,61,343,235,6112,5268,122,108,64,369,283,6214,
20221029,253,283,서서울,발안,2911,49,39,43,57,192,3291,3710,78,60,57,68,196,4169,
20221029,253,285,서서울,서평택,1521,18,37,57,108,90,1831,1696,31,49,93,197,101,2167,
20221029,253,287,서서울,송악,2381,11,19,27,93,99,2630,2989,10,30,26,189,118,3362,
20221029,253,288,서서울,당진,1806,15,33,13,16,73,1956,2060,12,33,21,26,78,2230,
20221029,253,298,서서울,서산,4220,25,29,21,16,145,4456,3548,14,28,17,22,127,3756,
20221029,253,520,서서울,평택,3476,38,63,53,72,145,3847,3499,37,63,57,74,146,3876,
20221029,253,540,서서울,청북,1022,12,19,26,34,56,1169,912,27,19,44,57,44,1103,
20221029,253,741,서서울,평택고덕,1283,10,11,4,12,86,1406,1608,18,12,15,6,120,1779,
20221029,254,102,군자,동수원,5496,41,52,11,27,278,5905,4788,28,49,15,15,234,5129,
20221029,254,103,군자,수원신갈,2592,81,47,71,54,119,2964,1908,82,40,43,45,87,2205,
20221029,254,212,군자,북수원,1397,18,23,12,5,72,1527,2048,19,30,10,13,95,2215,
20221029,254,213,군자,부곡,1114,18,23,13,77,63,1308,1052,23,12,16,91,55,1249,
20221029,254,215,군자,군포,3429,81,52,49,77,215,3903,2685,35,39,28,44,147,2978,
20221029,254,255,군자,서안산,8701,172,107,87,173,494,9734,9904,196,126,88,211,556,11081,
20221029,254,256,군자,안산,4871,71,116,27,43,349,5477,5528,77,110,27,44,403,6189,
20221029,254,281,군자,매송,887,12,7,9,43,64,1022,1125,11,12,9,34,63,1254,
20221029,254,282,군자,비봉,1286,51,40,33,109,67,1586,1083,40,27,19,85,56,1310,
20221029,254,283,군자,발안,897,25,21,21,42,47,1053,1035,13,29,24,28,64,1193,
20221029,255,102,서안산,동수원,1537,28,12,13,7,80,1677,1225,25,12,7,4,55,1328,
20221029,255,253,서안산,서서울,12111,184,112,107,288,711,13513,10592,209,151,146,368,591,12057,
20221029,255,254,서안산,군자,9904,196,126,88,211,556,11081,8701,172,107,87,173,494,9734,
20221029,256,253,안산,서서울,5932,64,49,19,46,348,6458,8860,94,68,27,32,587,9668,
20221029,256,254,안산,군자,5528,77,110,27,44,403,6189,4871,71,116,27,43,349,5477,
20221029,257,253,홍성,서서울,1004,9,12,10,6,53,1094,1633,4,14,2,0,59,1712,
20221029,261,248,동광주,순창,2112,22,23,2,23,77,2259,1773,17,20,1,40,43,1894,
20221029,261,249,동광주,담양,2660,29,106,12,66,94,2967,2923,16,113,6,68,88,3214,
20221029,261,262,동광주,창평,1756,57,27,12,20,58,1930,1621,46,19,12,31,42,1771,
20221029,261,271,동광주,순천,4611,59,86,15,34,120,4925,3827,60,72,10,40,68,4077,
20221029,262,261,창평,동광주,1621,46,19,12,31,42,1771,1756,57,27,12,20,58,1930,
20221029,265,569,곡성,북광주,1064,2,10,5,11,39,1131,1199,4,6,5,9,36,1259,
20221029,267,271,주암송광사,순천,1035,5,13,4,21,41,1119,1091,7,11,2,16,36,1163,
20221029,271,261,순천,동광주,3827,60,72,10,40,68,4077,4611,59,86,15,34,120,4925,
20221029,271,267,순천,주암송광사,1091,7,11,2,16,36,1163,1035,5,13,4,21,41,1119,
20221029,271,569,순천,북광주,1136,42,17,13,48,24,1280,1384,39,16,17,48,28,1532,
20221029,272,145,광양,산인,992,5,37,9,6,28,1077,1614,12,61,12,10,43,1752,
20221029,280,519,거창,남대구,1369,13,38,4,4,70,1498,1713,17,40,4,4,81,1859,
20221029,281,253,매송,서서울,4147,33,30,11,76,222,4519,3317,33,15,14,30,175,3584,
20221029,281,254,매송,군자,1125,11,12,9,34,63,1254,887,12,7,9,43,64,1022,
20221029,282,253,비봉,서서울,5268,122,108,64,369,283,6214,5246,106,121,61,343,235,6112,
20221029,282,254,비봉,군자,1083,40,27,19,85,56,1310,1286,51,40,33,109,67,1586,
20221029,283,253,발안,서서울,3710,78,60,57,68,196,4169,2911,49,39,43,57,192,3291,
20221029,283,254,발안,군자,1035,13,29,24,28,64,1193,897,25,21,21,42,47,1053,
20221029,285,253,서평택,서서울,1696,31,49,93,197,101,2167,1521,18,37,57,108,90,1831,
20221029,286,140,통도사휴게소,부산,1124,4,1,0,0,27,1156,1153,6,4,0,0,35,1198,
20221029,287,253,송악,서서울,2989,10,30,26,189,118,3362,2381,11,19,27,93,99,2630,
20221029,288,253,당진,서서울,2060,12,33,21,26,78,2230,1806,15,33,13,16,73,1956,
20221029,289,140,마산,부산,1109,6,9,2,0,33,1159,1750,7,17,2,2,53,1831,
20221029,289,146,마산,동창원,2456,49,34,20,28,189,2776,2687,45,42,19,44,211,3048,
20221029,289,148,마산,서김해,1697,16,61,9,3,109,1895,2056,20,73,5,3,120,2277,
20221029,289,149,마산,동김해,1061,21,28,9,4,68,1191,1133,17,43,15,8,68,1284,
20221029,289,150,마산,북부산,4231,27,117,4,6,182,4567,5431,26,139,4,13,216,5829,
20221029,289,244,마산,서부산,4456,36,288,17,21,213,5031,6166,40,317,26,34,271,6854,
20221029,289,245,마산,장유,1740,14,40,16,5,117,1932,1970,21,39,14,8,106,2158,
20221029,291,145,사천,산인,2139,42,47,6,4,99,2337,2722,27,52,8,9,119,2937,
20221029,291,225,사천,서진주,915,16,24,6,18,57,1036,1001,23,25,7,23,68,1147,
20221029,291,292,사천,진주,2166,35,57,24,27,165,2474,2720,61,53,32,47,214,3127,
20221029,292,145,진주,산인,2502,17,149,9,11,147,2835,2889,17,153,4,14,162,3239,
20221029,292,291,진주,사천,2720,61,53,32,47,214,3127,2166,35,57,24,27,165,2474,
20221029,292,516,진주,통영,1118,7,23,2,7,67,1224,1147,19,17,3,6,75,1267,
20221029,293,145,문산,산인,1863,17,19,5,4,92,2000,2231,15,13,7,7,120,2393,
20221029,295,145,진성,산인,1183,6,12,6,7,41,1255,1448,11,8,8,8,51,1534,
20221029,298,253,서산,서서울,3548,14,28,17,22,127,3756,4220,25,29,21,16,145,4456,
20221029,508,509,무안,목포,1449,19,41,18,23,57,1607,1759,28,51,19,32,70,1959,
20221029,508,553,무안,동광산,1644,19,24,8,25,51,1771,2003,23,19,12,23,70,2150,
20221029,509,508,목포,무안,1759,28,51,19,32,70,1959,1449,19,41,18,23,57,1607,
20221029,509,553,목포,동광산,10302,130,189,84,278,338,11321,9885,124,203,127,267,289,10895,
20221029,513,515,고성,북통영,2517,18,68,8,21,156,2788,2568,21,67,10,14,150,2830,
20221029,513,516,고성,통영,5841,61,112,42,119,328,6503,4903,53,97,45,100,323,5521,
20221029,514,516,동고성,통영,1199,12,34,14,40,130,1429,1229,11,35,12,51,105,1443,
20221029,515,513,북통영,고성,2568,21,67,10,14,150,2830,2517,18,68,8,21,156,2788,
20221029,516,292,통영,진주,1147,19,17,3,6,75,1267,1118,7,23,2,7,67,1224,
20221029,516,513,통영,고성,4903,53,97,45,100,323,5521,5841,61,112,42,119,328,6503,
20221029,516,514,통영,동고성,1229,11,35,12,51,105,1443,1199,12,34,14,40,130,1429,
20221029,517,597,양평,서여주,944,20,53,30,14,44,1105,853,21,36,28,16,52,1006,
20221029,517,598,양평,북여주,2170,13,11,19,45,77,2335,1441,11,8,9,36,51,1556,
20221029,519,231,남대구,화원옥포,5337,94,69,23,151,429,6103,5512,109,73,31,203,417,6345,
20221029,519,232,남대구,달성,1808,57,51,24,7,130,2077,1982,61,58,24,37,146,2308,
20221029,519,233,남대구,현풍,3510,78,108,48,55,213,4012,3995,99,125,32,81,247,4579,
20221029,519,239,남대구,칠원,2516,24,74,25,47,103,2789,2308,24,83,25,42,116,2598,
20221029,519,241,남대구,동고령,3213,60,66,34,144,165,3682,3085,50,68,54,145,149,3551,
20221029,519,242,남대구,고령,3545,19,57,13,91,136,3861,2830,18,63,12,88,119,3130,
20221029,519,243,남대구,해인사,1337,9,5,1,1,40,1393,1009,8,1,0,1,36,1055,
20221029,519,280,남대구,거창,1713,17,40,4,4,81,1859,1369,13,38,4,4,70,1498,
20221029,519,730,남대구,유천,2075,30,10,0,5,115,2235,2442,30,8,0,0,143,2623,
20221029,519,731,남대구,북현풍,1870,14,18,0,12,102,2016,1544,12,3,0,0,73,1632,
20221029,520,253,평택,서서울,3499,37,63,57,74,146,3876,3476,38,63,53,72,145,3847,
20221029,520,540,평택,청북,1296,32,59,31,31,50,1499,1115,19,57,55,37,45,1328,
20221029,524,129,청통와촌,북대구,1114,42,22,9,30,49,1266,934,32,17,5,7,31,1026,
20221029,524,230,청통와촌,팔공산,933,26,22,4,23,41,1049,1136,23,20,7,21,50,1257,
20221029,524,527,청통와촌,포항,1090,32,14,3,21,38,1198,1111,32,17,3,23,47,1233,
20221029,526,527,서포항,포항,1259,6,16,4,23,82,1390,1820,9,24,2,16,89,1960,
20221029,527,127,포항,서대구,1314,24,22,5,35,56,1456,2139,26,33,16,32,85,2331,
20221029,527,129,포항,북대구,2972,33,32,16,60,127,3240,2308,18,20,16,30,114,2506,
20221029,527,230,포항,팔공산,2081,18,14,4,20,73,2210,2499,28,16,2,9,85,2639,
20221029,527,524,포항,청통와촌,1111,32,17,3,23,47,1233,1090,32,14,3,21,38,1198,
20221029,527,526,포항,서포항,1820,9,24,2,16,89,1960,1259,6,16,4,23,82,1390,
20221029,528,101,기흥동탄,서울,6652,39,530,90,7,272,7590,6561,37,522,94,7,300,7521,
20221029,528,103,기흥동탄,수원신갈,1604,16,8,0,4,90,1722,1181,5,16,0,1,59,1262,
20221029,530,167,내장산,광주,1108,16,17,9,10,27,1187,1255,19,20,8,7,34,1343,
20221029,540,253,청북,서서울,912,27,19,44,57,44,1103,1022,12,19,26,34,56,1169,
20221029,540,520,청북,평택,1115,19,57,55,37,45,1328,1296,32,59,31,31,50,1499,
20221029,542,101,서안성,서울,2196,29,67,157,33,130,2612,1179,22,73,77,13,44,1408,
20221029,543,101,남안성,서울,1269,67,51,68,41,48,1544,1050,39,31,41,25,38,1224,
20221029,543,555,남안성,북진천,847,39,43,59,69,33,1090,783,33,51,62,86,37,1052,
20221029,545,169,소양,장수,1421,4,7,1,2,51,1486,1367,6,8,1,1,57,1440,
20221029,548,553,북무안,동광산,1849,29,30,17,107,63,2095,2703,18,32,19,136,78,2986,
20221029,549,553,동함평,동광산,4524,28,49,18,36,154,4809,5036,26,67,17,38,154,5338,
20221029,551,553,나주,동광산,1160,12,11,9,45,70,1307,1250,8,12,7,47,60,1384,
20221029,552,553,서광산,동광산,3859,131,122,112,116,101,4441,5558,151,132,119,106,145,6211,
20221029,553,508,동광산,무안,2003,23,19,12,23,70,2150,1644,19,24,8,25,51,1771,
20221029,553,509,동광산,목포,9885,124,203,127,267,289,10895,10302,130,189,84,278,338,11321,
20221029,553,548,동광산,북무안,2703,18,32,19,136,78,2986,1849,29,30,17,107,63,2095,
20221029,553,549,동광산,동함평,5036,26,67,17,38,154,5338,4524,28,49,18,36,154,4809,
20221029,553,551,동광산,나주,1250,8,12,7,47,60,1384,1160,12,11,9,45,70,1307,
20221029,553,552,동광산,서광산,5558,151,132,119,106,145,6211,3859,131,122,112,116,101,4441,
20221029,554,174,동홍천,춘천,1186,10,7,1,3,73,1280,1313,13,17,4,7,62,1416,
20221029,555,543,북진천,남안성,783,33,51,62,86,37,1052,847,39,43,59,69,33,1090,
20221029,556,557,동순천,황전,1820,16,24,9,81,45,1995,1443,15,17,6,64,43,1588,
20221029,556,589,동순천,상관,902,5,19,6,99,20,1051,1066,10,28,10,49,26,1189,
20221029,557,556,황전,동순천,1443,15,17,6,64,43,1588,1820,16,24,9,81,45,1995,
20221029,560,190,감곡,동서울,1322,6,16,11,32,38,1425,1099,3,7,14,27,36,1186,
20221029,567,167,남고창,광주,1766,19,42,9,18,64,1918,1760,20,39,6,17,44,1886,
20221029,569,265,북광주,곡성,1199,4,6,5,9,36,1259,1064,2,10,5,11,39,1131,
20221029,569,271,북광주,순천,1384,39,16,17,48,28,1532,1136,42,17,13,48,24,1280,
20221029,579,153,남세종,서대전,968,11,9,8,21,52,1069,1099,13,10,6,15,71,1214,
20221029,583,584,동해,남강릉,929,24,14,2,44,72,1085,907,22,17,5,26,66,1043,
20221029,583,704,동해,근덕,922,4,33,3,51,46,1059,972,10,33,4,29,46,1094,
20221029,584,583,남강릉,동해,907,22,17,5,26,66,1043,929,24,14,2,44,72,1085,
20221029,587,589,오수,상관,1339,16,44,25,43,36,1503,1630,10,31,22,121,37,1851,
20221029,589,556,상관,동순천,1066,10,28,10,49,26,1189,902,5,19,6,99,20,1051,
20221029,589,587,상관,오수,1630,10,31,22,121,37,1851,1339,16,44,25,43,36,1503,
20221029,597,517,서여주,양평,853,21,36,28,16,52,1006,944,20,53,30,14,44,1105,
20221029,597,598,서여주,북여주,856,30,104,12,34,50,1086,928,21,47,13,25,51,1085,
20221029,598,517,북여주,양평,1441,11,8,9,36,51,1556,2170,13,11,19,45,77,2335,
20221029,598,597,북여주,서여주,928,21,47,13,25,51,1085,856,30,104,12,34,50,1086,
20221029,621,127,동대구,서대구,993,25,16,22,29,55,1140,1620,37,63,24,33,88,1865,
20221029,621,131,동대구,경산,1702,45,34,15,47,92,1935,1694,46,28,11,34,101,1914,
20221029,621,132,동대구,영천,1200,8,21,3,64,55,1351,1095,8,25,2,58,35,1223,
20221029,621,135,동대구,경주,1316,1,42,0,1,50,1410,1238,3,44,0,3,54,1342,
20221029,624,626,청도,남밀양,1069,16,38,16,36,50,1225,1098,14,20,40,17,57,1246,
20221029,625,626,밀양,남밀양,2072,30,41,22,71,89,2325,2600,26,39,25,100,115,2905,
20221029,626,624,남밀양,청도,1098,14,20,40,17,57,1246,1069,16,38,16,36,50,1225,
20221029,626,625,남밀양,밀양,2600,26,39,25,100,115,2905,2072,30,41,22,71,89,2325,
20221029,626,627,남밀양,삼랑진,966,19,23,3,32,84,1127,1010,25,16,6,11,77,1145,
20221029,627,626,삼랑진,남밀양,1010,25,16,6,11,77,1145,966,19,23,3,32,84,1127,
20221029,641,139,울산,서울산,1294,14,47,7,14,115,1491,1507,29,48,17,22,108,1731,
20221029,641,252,울산,대동,1862,28,53,25,50,94,2112,2004,22,58,11,32,116,2243,
20221029,641,648,울산,해운대,1232,3,4,1,5,74,1319,1405,5,6,2,2,87,1507,
20221029,641,706,울산,남경주,1752,10,11,2,25,88,1888,1651,4,11,12,21,77,1776,
20221029,641,707,울산,남포항,1972,9,40,7,134,90,2252,1739,7,37,19,105,89,1996,
20221029,643,645,청량,장안,896,5,11,13,157,56,1138,771,8,12,17,164,52,1024,
20221029,643,648,청량,해운대,3866,14,17,12,59,230,4198,4016,20,60,19,207,214,4536,
20221029,645,643,장안,청량,771,8,12,17,164,52,1024,896,5,11,13,157,56,1138,
20221029,645,648,장안,해운대,1445,7,7,0,9,83,1551,3023,16,19,7,24,161,3250,
20221029,646,648,기장일광,해운대,4752,11,25,6,40,252,5086,5729,26,36,9,62,300,6162,
20221029,648,641,해운대,울산,1405,5,6,2,2,87,1507,1232,3,4,1,5,74,1319,
20221029,648,643,해운대,청량,4016,20,60,19,207,214,4536,3866,14,17,12,59,230,4198,
20221029,648,645,해운대,장안,3023,16,19,7,24,161,3250,1445,7,7,0,9,83,1551,
20221029,648,646,해운대,기장일광,5729,26,36,9,62,300,6162,4752,11,25,6,40,252,5086,
20221029,648,707,해운대,남포항,1580,10,29,3,33,56,1711,1349,1,12,2,16,49,1429,
20221029,651,652,남양주,화도,9017,171,276,225,81,581,10351,10754,189,354,238,64,579,12178,
20221029,651,653,남양주,서종,1849,6,11,3,3,70,1942,3117,14,11,1,4,124,3271,
20221029,651,654,남양주,설악,4925,24,76,12,10,179,5226,4241,26,74,14,11,159,4525,
20221029,651,655,남양주,강촌,3047,23,105,22,19,74,3290,3101,23,103,10,14,99,3350,
20221029,651,656,남양주,남춘천,3541,19,50,13,18,123,3764,2542,14,33,8,11,62,2670,
20221029,652,651,화도,남양주,10754,189,354,238,64,579,12178,9017,171,276,225,81,581,10351,
20221029,652,653,화도,서종,1303,15,5,14,3,86,1426,1798,32,13,11,7,104,1965,
20221029,652,654,화도,설악,2253,12,11,3,2,105,2386,1141,14,14,7,3,77,1256,
20221029,653,651,서종,남양주,3117,14,11,1,4,124,3271,1849,6,11,3,3,70,1942,
20221029,653,652,서종,화도,1798,32,13,11,7,104,1965,1303,15,5,14,3,86,1426,
20221029,654,651,설악,남양주,4241,26,74,14,11,159,4525,4925,24,76,12,10,179,5226,
20221029,654,652,설악,화도,1141,14,14,7,3,77,1256,2253,12,11,3,2,105,2386,
20221029,655,651,강촌,남양주,3101,23,103,10,14,99,3350,3047,23,105,22,19,74,3290,
20221029,656,651,남춘천,남양주,2542,14,33,8,11,62,2670,3541,19,50,13,18,123,3764,
20221029,671,672,봉담,정남,1994,61,39,41,117,104,2356,2393,64,30,32,228,126,2873,
20221029,671,673,봉담,북오산,1716,34,35,14,13,104,1916,2147,37,39,17,24,133,2397,
20221029,671,677,봉담,북평택,10474,65,89,58,110,505,11301,10223,86,100,41,84,518,11052,
20221029,672,671,정남,봉담,2393,64,30,32,228,126,2873,1994,61,39,41,117,104,2356,
20221029,673,101,북오산,서울,1722,29,96,16,8,104,1975,1632,23,96,20,5,85,1861,
20221029,673,671,북오산,봉담,2147,37,39,17,24,133,2397,1716,34,35,14,13,104,1916,
20221029,673,677,북오산,북평택,2423,22,22,12,22,112,2613,1833,26,26,11,19,103,2018,
20221029,675,676,서오산,향남,2152,49,32,18,324,129,2704,1803,38,36,18,236,102,2233,
20221029,675,677,서오산,북평택,15404,109,209,82,133,714,16651,13769,112,208,94,113,664,14960,
20221029,676,675,향남,서오산,1803,38,36,18,236,102,2233,2152,49,32,18,324,129,2704,
20221029,676,677,향남,북평택,1673,68,46,51,121,95,2054,1571,60,60,49,108,90,1938,
20221029,677,101,북평택,서울,2411,29,171,51,93,125,2880,2996,34,201,43,64,121,3459,
20221029,677,671,북평택,봉담,10223,86,100,41,84,518,11052,10474,65,89,58,110,505,11301,
20221029,677,673,북평택,북오산,1833,26,26,11,19,103,2018,2423,22,22,12,22,112,2613,
20221029,677,675,북평택,서오산,13769,112,208,94,113,664,14960,15404,109,209,82,133,714,16651,
20221029,677,676,북평택,향남,1571,60,60,49,108,90,1938,1673,68,46,51,121,95,2054,
20221029,677,876,북평택,양감,3615,52,67,54,86,198,4072,1881,40,55,42,77,100,2195,
20221029,682,685,조암,서시흥,1460,54,56,70,142,54,1836,1529,49,68,38,160,87,1931,
20221029,683,684,송산마도,남안산,2280,83,48,39,241,127,2818,1991,60,35,42,121,117,2366,
20221029,683,685,송산마도,서시흥,4327,80,86,74,749,222,5538,4322,86,86,82,861,251,5688,
20221029,684,683,남안산,송산마도,1991,60,35,42,121,117,2366,2280,83,48,39,241,127,2818,
20221029,684,685,남안산,서시흥,2787,163,120,203,255,199,3727,3581,135,127,179,174,231,4427,
20221029,685,682,서시흥,조암,1529,49,68,38,160,87,1931,1460,54,56,70,142,54,1836,
20221029,685,683,서시흥,송산마도,4322,86,86,82,861,251,5688,4327,80,86,74,749,222,5538,
20221029,685,684,서시흥,남안산,3581,135,127,179,174,231,4427,2787,163,120,203,255,199,3727,
20221029,704,583,근덕,동해,972,10,33,4,29,46,1094,922,4,33,3,51,46,1059,
20221029,705,190,남이천,동서울,1838,38,19,30,27,62,2014,1456,33,32,35,44,49,1649,
20221029,706,641,남경주,울산,1651,4,11,12,21,77,1776,1752,10,11,2,25,88,1888,
20221029,706,707,남경주,남포항,1775,17,47,22,166,88,2115,1699,26,51,18,130,93,2017,
20221029,707,641,남포항,울산,1739,7,37,19,105,89,1996,1972,9,40,7,134,90,2252,
20221029,707,648,남포항,해운대,1349,1,12,2,16,49,1429,1580,10,29,3,33,56,1711,
20221029,707,706,남포항,남경주,1699,26,51,18,130,93,2017,1775,17,47,22,166,88,2115,
20221029,707,708,남포항,동경주,2019,19,22,14,106,94,2274,1940,16,25,16,114,103,2214,
20221029,708,707,동경주,남포항,1940,16,25,16,114,103,2214,2019,19,22,14,106,94,2274,
20221029,715,716,동안동,청송,1316,20,20,14,29,58,1457,1270,26,20,18,33,46,1413,
20221029,715,749,동안동,영덕,1185,4,28,1,29,45,1292,974,6,26,2,30,38,1076,
20221029,716,715,청송,동안동,1270,26,20,18,33,46,1413,1316,20,20,14,29,58,1457,
20221029,730,519,유천,남대구,2442,30,8,0,0,143,2623,2075,30,10,0,5,115,2235,
20221029,731,519,북현풍,남대구,1544,12,3,0,0,73,1632,1870,14,18,0,12,102,2016,
20221029,741,253,평택고덕,서서울,1608,18,12,15,6,120,1779,1283,10,11,4,12,86,1406,
20221029,742,107,남사진위,안성,1616,22,43,24,10,83,1798,1133,22,34,20,10,80,1299,
20221029,742,108,남사진위,천안,1588,31,23,20,10,74,1746,1035,12,23,21,5,55,1151,
20221029,749,715,영덕,동안동,974,6,26,2,30,38,1076,1185,4,28,1,29,45,1292,
20221029,752,252,기장철마,대동,1781,25,25,8,23,140,2002,1669,28,23,15,61,123,1919,
20221029,753,252,금정,대동,908,29,20,18,66,59,1100,1528,36,32,24,117,112,1849,
20221029,755,140,광재,부산,926,11,7,6,7,52,1009,1055,15,17,2,11,54,1154,
20221029,755,252,광재,대동,1686,31,38,26,288,91,2160,1756,33,42,28,186,108,2153,
20221029,772,774,북달성,남칠곡,2391,33,42,27,15,106,2614,2460,41,34,29,22,115,2701,
20221029,773,774,북다사,남칠곡,1367,11,15,1,14,47,1455,1094,8,17,3,15,47,1184,
20221029,774,772,남칠곡,북달성,2460,41,34,29,22,115,2701,2391,33,42,27,15,106,2614,
20221029,774,773,남칠곡,북다사,1094,8,17,3,15,47,1184,1367,11,15,1,14,47,1455,
20221029,775,203,동명동호,가산,1572,28,20,11,74,59,1764,1829,39,31,25,243,71,2238,
20221029,775,207,동명동호,남안동,1044,8,9,4,7,45,1117,1039,11,11,3,9,42,1115,
20221029,776,777,연경,파군재,4706,34,20,10,24,245,5039,3809,25,17,5,19,189,4064,
20221029,776,779,연경,율암,5475,74,52,56,178,304,6139,6070,69,59,33,165,338,6734,
20221029,777,776,파군재,연경,3809,25,17,5,19,189,4064,4706,34,20,10,24,245,5039,
20221029,777,779,파군재,율암,3180,12,12,1,4,203,3412,3454,11,17,3,6,205,3696,
20221029,779,776,율암,연경,6070,69,59,33,165,338,6734,5475,74,52,56,178,304,6139,
20221029,779,777,율암,파군재,3454,11,17,3,6,205,3696,3180,12,12,1,4,203,3412,
20221029,876,677,양감,북평택,1881,40,55,42,77,100,2195,3615,52,67,54,86,198,4072,
20221029,981,982,서영암,강진무위사,2153,14,72,32,13,67,2351,2588,26,77,47,27,86,2851,
20221029,981,987,서영암,남순천,1854,10,65,39,145,65,2178,2406,26,87,53,200,73,2845,
20221029,982,981,강진무위사,서영암,2588,26,77,47,27,86,2851,2153,14,72,32,13,67,2351,
20221029,982,987,강진무위사,남순천,1365,8,59,17,43,43,1535,1504,9,51,26,51,35,1676,
20221029,984,985,보성,벌교,2574,23,44,30,48,51,2770,2043,29,32,11,44,51,2210,
20221029,984,987,보성,남순천,2399,27,67,38,134,61,2726,2633,22,76,30,162,58,2981,
20221029,985,984,벌교,보성,2043,29,32,11,44,51,2210,2574,23,44,30,48,51,2770,
20221029,986,987,고흥,남순천,4260,26,103,64,143,155,4751,5500,33,104,93,179,186,6095,
20221029,987,981,남순천,서영암,2406,26,87,53,200,73,2845,1854,10,65,39,145,65,2178,
20221029,987,982,남순천,강진무위사,1504,9,51,26,51,35,1676,1365,8,59,17,43,43,1535,
20221029,987,984,남순천,보성,2633,22,76,30,162,58,2981,2399,27,67,38,134,61,2726,
20221029,987,986,남순천,고흥,5500,33,104,93,179,186,6095,4260,26,103,64,143,155,4751,
20221030,101,102,서울,동수원,2992,21,161,5,3,128,3310,3600,32,262,23,5,173,4095,
20221030,101,103,서울,수원신갈,12821,234,898,261,22,508,14744,11556,250,856,242,23,494,13421,
20221030,101,105,서울,기흥,5814,23,148,31,7,216,6239,5330,31,152,69,4,209,5795,
20221030,101,106,서울,오산,5254,146,258,68,17,327,6070,4538,123,265,69,6,274,5275,
20221030,101,107,서울,안성,4511,37,260,12,0,252,5072,3085,25,261,14,7,148,3540,
20221030,101,108,서울,천안,5936,21,299,13,3,265,6537,5265,18,330,14,2,214,5843,
20221030,101,111,서울,청주,1154,5,253,3,1,45,1461,760,9,318,2,1,32,1122,
20221030,101,171,서울,마성,2452,8,114,28,0,90,2692,2133,8,121,29,0,105,2396,
20221030,101,172,서울,용인,3071,36,59,19,0,165,3350,3689,30,63,24,6,202,4014,
20221030,101,173,서울,양지,3263,70,69,26,24,92,3544,4614,131,80,39,24,126,5014,
20221030,101,528,서울,기흥동탄,6173,16,410,88,2,276,6965,5573,17,421,91,6,234,6342,
20221030,101,542,서울,서안성,1452,11,56,54,7,75,1655,1719,20,52,88,9,83,1971,
20221030,101,543,서울,남안성,1399,23,25,32,10,56,1545,1248,31,24,44,11,51,1409,
20221030,101,673,서울,북오산,1694,16,81,5,5,123,1924,1501,11,79,5,1,86,1683,
20221030,101,677,서울,북평택,2031,11,255,23,24,108,2452,2635,17,157,20,24,104,2957,
20221030,102,101,동수원,서울,3600,32,262,23,5,173,4095,2992,21,161,5,3,128,3310,
20221030,102,173,동수원,양지,1003,12,17,2,6,55,1095,1352,12,14,2,1,65,1446,
20221030,102,212,동수원,북수원,2327,10,133,1,1,128,2600,2334,6,134,4,3,131,2612,
20221030,102,215,동수원,군포,1004,11,3,0,0,62,1080,1494,8,7,0,1,85,1595,
20221030,102,253,동수원,서서울,5154,19,24,5,1,252,5455,5417,23,33,7,7,289,5776,
20221030,102,254,동수원,군자,4142,15,35,3,4,208,4407,5067,14,38,5,6,249,5379,
20221030,103,101,수원신갈,서울,11556,250,856,242,23,494,13421,12821,234,898,261,22,508,14744,
20221030,103,105,수원신갈,기흥,1494,6,6,3,8,85,1602,2270,6,5,1,13,105,2400,
20221030,103,108,수원신갈,천안,1019,5,29,12,0,39,1104,1122,6,26,14,0,51,1219,
20221030,103,253,수원신갈,서서울,1816,56,27,41,3,94,2037,2516,59,38,26,6,137,2782,
20221030,103,254,수원신갈,군자,1613,37,17,17,29,88,1801,2388,47,21,45,31,121,2653,
20221030,105,101,기흥,서울,5330,31,152,69,4,209,5795,5814,23,148,31,7,216,6239,
20221030,105,103,기흥,수원신갈,2270,6,5,1,13,105,2400,1494,6,6,3,8,85,1602,
20221030,106,101,오산,서울,4538,123,265,69,6,274,5275,5254,146,258,68,17,327,6070,
20221030,107,101,안성,서울,3085,25,261,14,7,148,3540,4511,37,260,12,0,252,5072,
20221030,107,108,안성,천안,1491,3,28,2,1,99,1624,1515,7,24,1,0,82,1629,
20221030,108,101,천안,서울,5265,18,330,14,2,214,5843,5936,21,299,13,3,265,6537,
20221030,108,103,천안,수원신갈,1122,6,26,14,0,51,1219,1019,5,29,12,0,39,1104,
20221030,108,107,천안,안성,1515,7,24,1,0,82,1629,1491,3,28,2,1,99,1624,
20221030,108,229,천안,북천안,1265,19,47,8,1,60,1400,1474,25,46,9,8,66,1628,
20221030,111,101,청주,서울,760,9,318,2,1,32,1122,1154,5,253,3,1,45,1461,
20221030,112,115,남청주,대전,966,23,43,5,0,70,1107,969,27,48,2,0,60,1106,
20221030,114,153,남대전,서대전,1484,5,9,4,4,92,1598,1057,6,12,12,2,76,1165,
20221030,115,112,대전,남청주,969,27,48,2,0,60,1106,966,23,43,5,0,70,1107,
20221030,115,116,대전,옥천,1994,12,12,6,4,129,2157,2183,7,16,3,1,144,2354,
20221030,116,115,옥천,대전,2183,7,16,3,1,144,2354,1994,12,12,6,4,129,2157,
20221030,119,153,판암,서대전,1644,4,5,0,0,99,1752,1581,2,10,3,0,109,1705,
20221030,123,127,구미,서대구,1642,10,23,1,1,70,1747,1667,10,29,1,2,86,1795,
20221030,123,129,구미,북대구,1628,3,54,0,1,81,1767,1879,7,48,3,0,85,2022,
20221030,125,127,남구미,서대구,1290,8,34,3,2,90,1427,1593,10,32,5,5,87,1732,
20221030,125,129,남구미,북대구,1238,3,13,0,1,67,1322,1584,6,12,2,1,93,1698,
20221030,126,127,왜관,서대구,2012,22,26,7,3,105,2175,2149,33,22,5,6,122,2337,
20221030,126,129,왜관,북대구,2506,21,12,5,9,116,2669,2679,17,17,1,11,132,2857,
20221030,127,123,서대구,구미,1667,10,29,1,2,86,1795,1642,10,23,1,1,70,1747,
20221030,127,125,서대구,남구미,1593,10,32,5,5,87,1732,1290,8,34,3,2,90,1427,
20221030,127,126,서대구,왜관,2149,33,22,5,6,122,2337,2012,22,26,7,3,105,2175,
20221030,127,131,서대구,경산,1614,35,18,6,15,86,1774,1109,23,5,2,8,61,1208,
20221030,127,203,서대구,가산,2233,16,28,9,8,90,2384,1855,11,13,4,3,82,1968,
20221030,127,527,서대구,포항,1727,9,46,2,15,69,1868,1475,11,41,3,2,56,1588,
20221030,129,123,북대구,구미,1879,7,48,3,0,85,2022,1628,3,54,0,1,81,1767,
20221030,129,125,북대구,남구미,1584,6,12,2,1,93,1698,1238,3,13,0,1,67,1322,
20221030,129,126,북대구,왜관,2679,17,17,1,11,132,2857,2506,21,12,5,9,116,2669,
20221030,129,131,북대구,경산,1210,29,14,7,9,73,1342,1741,36,17,10,11,94,1909,
20221030,129,527,북대구,포항,2189,18,26,2,8,102,2345,3239,29,30,8,13,119,3438,
20221030,131,127,경산,서대구,1109,23,5,2,8,61,1208,1614,35,18,6,15,86,1774,
20221030,131,129,경산,북대구,1741,36,17,10,11,94,1909,1210,29,14,7,9,73,1342,
20221030,131,621,경산,동대구,1356,21,12,4,11,81,1485,1324,19,14,6,6,67,1436,
20221030,135,140,경주,부산,2687,5,23,6,5,115,2841,2646,10,21,2,5,125,2809,
20221030,135,252,경주,대동,2106,9,49,15,5,112,2296,2220,12,51,6,10,116,2415,
20221030,135,621,경주,동대구,1301,2,43,0,1,35,1382,1196,4,42,0,1,43,1286,
20221030,138,140,양산,부산,3503,38,48,5,17,141,3752,3018,51,50,10,10,108,3247,
20221030,138,252,양산,대동,1352,22,12,9,16,56,1467,1378,47,25,5,20,62,1537,
20221030,139,140,서울산,부산,3176,6,30,0,3,103,3318,2229,9,20,0,0,81,2339,
20221030,139,252,서울산,대동,1683,13,25,2,4,75,1802,1421,9,10,1,1,83,1525,
20221030,139,641,서울산,울산,1460,18,45,2,2,86,1613,956,7,54,0,4,46,1067,
20221030,140,135,부산,경주,2646,10,21,2,5,125,2809,2687,5,23,6,5,115,2841,
20221030,140,138,부산,양산,3018,51,50,10,10,108,3247,3503,38,48,5,17,141,3752,
20221030,140,139,부산,서울산,2229,9,20,0,0,81,2339,3176,6,30,0,3,103,3318,
20221030,140,250,부산,남양산,6502,32,126,1,10,441,7112,6293,33,121,6,12,406,6871,
20221030,140,286,부산,통도사휴게소,1236,5,2,0,0,28,1271,1192,2,3,0,0,30,1227,
20221030,140,289,부산,마산,996,4,3,0,1,41,1045,1534,5,9,3,0,60,1611,
20221030,142,145,군북,산인,5244,21,70,9,6,235,5585,4180,10,40,4,9,216,4459,
20221030,144,145,함안,산인,1926,9,10,3,1,98,2047,1824,10,18,1,5,104,1962,
20221030,145,142,산인,군북,4180,10,40,4,9,216,4459,5244,21,70,9,6,235,5585,
20221030,145,144,산인,함안,1824,10,18,1,5,104,1962,1926,9,10,3,1,98,2047,
20221030,145,272,산인,광양,936,5,38,2,2,26,1009,1288,8,71,15,8,40,1430,
20221030,145,291,산인,사천,1721,13,38,3,2,83,1860,2479,18,43,4,1,120,2665,
20221030,145,292,산인,진주,1655,11,139,3,2,97,1907,2428,11,142,0,2,140,2723,
20221030,145,293,산인,문산,1471,9,14,3,4,65,1566,1616,6,13,4,6,84,1729,
20221030,146,150,동창원,북부산,1097,5,3,0,1,66,1172,1057,3,7,2,1,60,1130,
20221030,146,244,동창원,서부산,1310,13,12,4,3,61,1403,1419,9,16,6,6,73,1529,
20221030,146,289,동창원,마산,1916,19,9,7,5,138,2094,2010,23,11,6,5,131,2186,
20221030,148,150,서김해,북부산,5277,41,42,11,18,364,5753,4813,37,41,16,11,332,5250,
20221030,148,289,서김해,마산,1366,9,45,0,0,89,1509,1859,9,48,1,0,89,2006,
20221030,149,150,동김해,북부산,8174,82,93,5,14,557,8925,7065,68,83,3,10,473,7702,
20221030,150,146,북부산,동창원,1057,3,7,2,1,60,1130,1097,5,3,0,1,66,1172,
20221030,150,148,북부산,서김해,4813,37,41,16,11,332,5250,5277,41,42,11,18,364,5753,
20221030,150,149,북부산,동김해,7065,68,83,3,10,473,7702,8174,82,93,5,14,557,8925,
20221030,150,245,북부산,장유,3667,15,75,6,15,229,4007,2933,7,78,0,9,152,3179,
20221030,150,289,북부산,마산,3532,15,124,3,4,137,3815,6174,17,159,4,7,202,6563,
20221030,153,114,서대전,남대전,1057,6,12,12,2,76,1165,1484,5,9,4,4,92,1598,
20221030,153,119,서대전,판암,1581,2,10,3,0,109,1705,1644,4,5,0,0,99,1752,
20221030,153,154,서대전,안영,986,10,12,3,4,42,1057,1038,12,16,6,3,58,1133,
20221030,154,153,안영,서대전,1038,12,16,6,3,58,1133,986,10,12,3,4,42,1057,
20221030,159,167,서전주,광주,1733,9,45,13,5,59,1864,2217,13,24,10,3,67,2334,
20221030,166,167,장성,광주,2382,15,54,8,4,85,2548,2974,32,44,3,0,77,3130,
20221030,167,159,광주,서전주,2217,13,24,10,3,67,2334,1733,9,45,13,5,59,1864,
20221030,167,166,광주,장성,2974,32,44,3,0,77,3130,2382,15,54,8,4,85,2548,
20221030,167,530,광주,내장산,1377,16,11,9,1,57,1471,1115,6,8,3,2,50,1184,
20221030,167,567,광주,남고창,1507,9,43,16,4,64,1643,1716,2,31,7,0,60,1816,
20221030,169,545,장수,소양,1265,3,4,0,1,32,1305,1094,2,5,1,1,24,1127,
20221030,171,101,마성,서울,2133,8,121,29,0,105,2396,2452,8,114,28,0,90,2692,
20221030,172,101,용인,서울,3689,30,63,24,6,202,4014,3071,36,59,19,0,165,3350,
20221030,172,173,용인,양지,1086,70,27,14,7,69,1273,992,41,18,9,2,74,1136,
20221030,172,253,용인,서서울,1138,11,8,8,3,50,1218,1195,18,8,14,2,72,1309,
20221030,173,101,양지,서울,4614,131,80,39,24,126,5014,3263,70,69,26,24,92,3544,
20221030,173,102,양지,동수원,1352,12,14,2,1,65,1446,1003,12,17,2,6,55,1095,
20221030,173,172,양지,용인,992,41,18,9,2,74,1136,1086,70,27,14,7,69,1273,
20221030,173,212,양지,북수원,1287,14,8,5,4,41,1359,990,31,10,7,2,43,1083,
20221030,173,253,양지,서서울,1534,29,10,30,11,63,1677,1076,41,11,12,7,58,1205,
20221030,174,179,춘천,홍천,3293,25,50,7,3,220,3598,2719,19,40,3,4,207,2992,
20221030,174,216,춘천,횡성,1064,13,15,2,2,58,1154,1303,12,10,3,0,57,1385,
20221030,174,218,춘천,남원주,1489,10,43,2,1,88,1633,1321,3,50,2,1,80,1457,
20221030,174,554,춘천,동홍천,969,4,10,5,5,65,1058,1203,2,8,1,1,72,1287,
20221030,176,190,이천,동서울,1402,22,48,15,5,63,1555,1640,13,69,37,13,76,1848,
20221030,177,190,여주,동서울,1037,7,29,16,0,31,1120,1096,6,33,16,0,30,1181,
20221030,179,174,홍천,춘천,2719,19,40,3,4,207,2992,3293,25,50,7,3,220,3598,
20221030,184,189,대관령,강릉,1395,17,59,5,4,69,1549,1369,18,56,3,3,70,1519,
20221030,189,184,강릉,대관령,1369,18,56,3,3,70,1519,1395,17,59,5,4,69,1549,
20221030,190,176,동서울,이천,1640,13,69,37,13,76,1848,1402,22,48,15,5,63,1555,
20221030,190,177,동서울,여주,1096,6,33,16,0,30,1181,1037,7,29,16,0,31,1120,
20221030,190,191,동서울,경기광주,9112,179,246,54,16,539,10146,7526,125,232,40,16,421,8360,
20221030,190,192,동서울,곤지암,4396,122,74,63,18,225,4898,3637,76,53,47,20,172,4005,
20221030,190,193,동서울,일죽,2931,37,68,36,22,121,3215,3149,30,58,62,21,100,3420,
20221030,190,194,동서울,서이천,3633,143,114,74,15,176,4155,2673,44,84,58,18,130,3007,
20221030,190,198,동서울,서청주,1445,9,29,3,3,52,1541,1182,6,9,8,1,45,1251,
20221030,190,199,동서울,오창,1104,4,2,2,11,64,1187,1245,4,5,3,10,51,1318,
20221030,190,560,동서울,감곡,1153,8,8,7,9,30,1215,1276,9,11,7,17,32,1352,
20221030,190,705,동서울,남이천,1326,22,26,20,6,32,1432,2000,25,19,21,10,51,2126,
20221030,191,190,경기광주,동서울,7526,125,232,40,16,421,8360,9112,179,246,54,16,539,10146,
20221030,192,190,곤지암,동서울,3637,76,53,47,20,172,4005,4396,122,74,63,18,225,4898,
20221030,192,194,곤지암,서이천,1094,75,41,32,8,62,1312,1171,38,28,25,6,69,1337,
20221030,193,190,일죽,동서울,3149,30,58,62,21,100,3420,2931,37,68,36,22,121,3215,
20221030,194,190,서이천,동서울,2673,44,84,58,18,130,3007,3633,143,114,74,15,176,4155,
20221030,194,192,서이천,곤지암,1171,38,28,25,6,69,1337,1094,75,41,32,8,62,1312,
20221030,198,190,서청주,동서울,1182,6,9,8,1,45,1251,1445,9,29,3,3,52,1541,
20221030,199,190,오창,동서울,1245,4,5,3,10,51,1318,1104,4,2,2,11,64,1187,
20221030,203,127,가산,서대구,1855,11,13,4,3,82,1968,2233,16,28,9,8,90,2384,
20221030,203,775,가산,동명동호,1597,9,8,7,116,58,1795,1701,13,13,2,40,69,1838,
20221030,212,102,북수원,동수원,2334,6,134,4,3,131,2612,2327,10,133,1,1,128,2600,
20221030,212,173,북수원,양지,990,31,10,7,2,43,1083,1287,14,8,5,4,41,1359,
20221030,212,254,북수원,군자,1611,10,19,8,9,86,1743,1179,10,14,10,5,69,1287,
20221030,213,253,부곡,서서울,955,44,13,12,5,63,1092,900,45,17,18,8,52,1040,
20221030,215,102,군포,동수원,1494,8,7,0,1,85,1595,1004,11,3,0,0,62,1080,
20221030,215,253,군포,서서울,2791,19,36,10,7,152,3015,2774,30,58,30,17,176,3085,
20221030,215,254,군포,군자,2207,9,22,4,15,120,2377,2752,25,20,20,21,158,2996,
20221030,216,174,횡성,춘천,1303,12,10,3,0,57,1385,1064,13,15,2,2,58,1154,
20221030,218,174,남원주,춘천,1321,3,50,2,1,80,1457,1489,10,43,2,1,88,1633,
20221030,218,240,남원주,제천,1856,19,28,4,15,102,2024,2065,13,31,9,8,106,2232,
20221030,229,108,북천안,천안,1474,25,46,9,8,66,1628,1265,19,47,8,1,60,1400,
20221030,230,527,팔공산,포항,2206,14,13,0,1,80,2314,2190,12,18,0,2,75,2297,
20221030,231,519,화원옥포,남대구,4538,33,44,7,2,306,4930,4142,31,31,7,7,332,4550,
20221030,232,519,달성,남대구,1481,24,27,2,2,111,1647,1444,25,14,3,0,108,1594,
20221030,233,519,현풍,남대구,3469,43,41,10,12,218,3793,3018,24,39,20,10,168,3279,
20221030,239,519,칠원,남대구,2143,19,64,15,1,92,2334,2346,23,71,5,4,109,2558,
20221030,240,218,제천,남원주,2065,13,31,9,8,106,2232,1856,19,28,4,15,102,2024,
20221030,241,519,동고령,남대구,3841,20,59,13,2,163,4098,2477,12,42,5,2,121,2659,
20221030,242,519,고령,남대구,3001,19,30,5,10,108,3173,3080,14,34,5,12,111,3256,
20221030,243,519,해인사,남대구,1426,3,3,0,0,52,1484,1328,2,5,0,0,48,1383,
20221030,244,146,서부산,동창원,1419,9,16,6,6,73,1529,1310,13,12,4,3,61,1403,
20221030,244,245,서부산,장유,13432,57,267,14,36,871,14677,12931,63,230,24,42,783,14073,
20221030,244,289,서부산,마산,4020,26,278,5,5,162,4496,5743,36,331,9,8,239,6366,
20221030,245,150,장유,북부산,2933,7,78,0,9,152,3179,3667,15,75,6,15,229,4007,
20221030,245,244,장유,서부산,12931,63,230,24,42,783,14073,13432,57,267,14,36,871,14677,
20221030,245,289,장유,마산,1220,6,20,5,1,62,1314,1802,10,35,12,5,83,1947,
20221030,248,261,순창,동광주,1861,12,22,3,1,42,1941,2187,13,30,3,2,67,2302,
20221030,249,261,담양,동광주,3059,15,95,2,2,65,3238,2916,13,95,2,4,87,3117,
20221030,250,140,남양산,부산,6293,33,121,6,12,406,6871,6502,32,126,1,10,441,7112,
20221030,250,252,남양산,대동,2118,14,19,8,17,138,2314,2926,24,17,8,14,197,3186,
20221030,251,252,물금,대동,2086,79,17,23,93,148,2446,3169,90,15,19,61,207,3561,
20221030,252,135,대동,경주,2220,12,51,6,10,116,2415,2106,9,49,15,5,112,2296,
20221030,252,138,대동,양산,1378,47,25,5,20,62,1537,1352,22,12,9,16,56,1467,
20221030,252,139,대동,서울산,1421,9,10,1,1,83,1525,1683,13,25,2,4,75,1802,
20221030,252,250,대동,남양산,2926,24,17,8,14,197,3186,2118,14,19,8,17,138,2314,
20221030,252,251,대동,물금,3169,90,15,19,61,207,3561,2086,79,17,23,93,148,2446,
20221030,252,641,대동,울산,2151,10,42,5,2,112,2322,1635,10,35,3,9,81,1773,
20221030,252,752,대동,기장철마,1584,4,14,1,12,99,1714,1519,11,15,4,20,94,1663,
20221030,252,755,대동,광재,1338,8,8,4,7,59,1424,1315,8,18,2,7,67,1417,
20221030,253,102,서서울,동수원,5417,23,33,7,7,289,5776,5154,19,24,5,1,252,5455,
20221030,253,103,서서울,수원신갈,2516,59,38,26,6,137,2782,1816,56,27,41,3,94,2037,
20221030,253,172,서서울,용인,1195,18,8,14,2,72,1309,1138,11,8,8,3,50,1218,
20221030,253,173,서서울,양지,1076,41,11,12,7,58,1205,1534,29,10,30,11,63,1677,
20221030,253,213,서서울,부곡,900,45,17,18,8,52,1040,955,44,13,12,5,63,1092,
20221030,253,215,서서울,군포,2774,30,58,30,17,176,3085,2791,19,36,10,7,152,3015,
20221030,253,255,서서울,서안산,8445,92,67,69,86,465,9224,8487,96,59,59,78,461,9240,
20221030,253,256,서서울,안산,7113,71,42,11,10,431,7678,4472,36,25,12,9,300,4854,
20221030,253,257,서서울,홍성,1144,4,11,0,1,36,1196,1921,3,12,5,0,63,2004,
20221030,253,259,서서울,대천,991,3,18,2,0,45,1059,1541,5,10,4,0,61,1621,
20221030,253,281,서서울,매송,3012,7,11,6,0,163,3199,2289,12,11,2,5,143,2462,
20221030,253,282,서서울,비봉,4185,48,37,22,27,216,4535,4479,45,31,18,23,203,4799,
20221030,253,283,서서울,발안,3779,30,24,22,195,210,4260,2458,26,16,23,165,124,2812,
20221030,253,285,서서울,서평택,2339,14,33,48,87,141,2662,1885,11,24,52,84,92,2148,
20221030,253,287,서서울,송악,3161,7,24,17,67,142,3418,4438,16,16,30,63,145,4708,
20221030,253,288,서서울,당진,2432,10,30,8,5,114,2599,2231,5,23,14,10,87,2370,
20221030,253,298,서서울,서산,3763,12,40,21,5,135,3976,4374,13,19,58,7,157,4628,
20221030,253,520,서서울,평택,3852,18,37,25,18,188,4138,3550,14,25,34,20,128,3771,
20221030,253,741,서서울,평택고덕,1953,14,10,8,9,140,2134,1008,8,6,9,2,63,1096,
20221030,254,102,군자,동수원,5067,14,38,5,6,249,5379,4142,15,35,3,4,208,4407,
20221030,254,103,군자,수원신갈,2388,47,21,45,31,121,2653,1613,37,17,17,29,88,1801,
20221030,254,212,군자,북수원,1179,10,14,10,5,69,1287,1611,10,19,8,9,86,1743,
20221030,254,215,군자,군포,2752,25,20,20,21,158,2996,2207,9,22,4,15,120,2377,
20221030,254,255,군자,서안산,6366,65,45,15,33,432,6956,7428,69,43,13,39,465,8057,
20221030,254,256,군자,안산,4160,33,84,18,12,307,4614,4388,35,90,16,14,309,4852,
20221030,255,253,서안산,서서울,8487,96,59,59,78,461,9240,8445,92,67,69,86,465,9224,
20221030,255,254,서안산,군자,7428,69,43,13,39,465,8057,6366,65,45,15,33,432,6956,
20221030,256,253,안산,서서울,4472,36,25,12,9,300,4854,7113,71,42,11,10,431,7678,
20221030,256,254,안산,군자,4388,35,90,16,14,309,4852,4160,33,84,18,12,307,4614,
20221030,257,253,홍성,서서울,1921,3,12,5,0,63,2004,1144,4,11,0,1,36,1196,
20221030,259,253,대천,서서울,1541,5,10,4,0,61,1621,991,3,18,2,0,45,1059,
20221030,261,248,동광주,순창,2187,13,30,3,2,67,2302,1861,12,22,3,1,42,1941,
20221030,261,249,동광주,담양,2916,13,95,2,4,87,3117,3059,15,95,2,2,65,3238,
20221030,261,262,동광주,창평,1628,20,12,5,4,71,1740,1750,9,10,4,2,49,1824,
20221030,262,261,창평,동광주,1750,9,10,4,2,49,1824,1628,20,12,5,4,71,1740,
20221030,267,271,주암송광사,순천,1152,1,7,2,4,20,1186,1116,3,4,1,2,29,1155,
20221030,271,267,순천,주암송광사,1116,3,4,1,2,29,1155,1152,1,7,2,4,20,1186,
20221030,271,569,순천,북광주,1121,9,8,1,12,29,1180,939,15,8,2,20,19,1003,
20221030,272,145,광양,산인,1288,8,71,15,8,40,1430,936,5,38,2,2,26,1009,
20221030,280,519,거창,남대구,1529,7,35,2,1,63,1637,1321,10,42,3,0,58,1434,
20221030,281,253,매송,서서울,2289,12,11,2,5,143,2462,3012,7,11,6,0,163,3199,
20221030,282,253,비봉,서서울,4479,45,31,18,23,203,4799,4185,48,37,22,27,216,4535,
20221030,283,253,발안,서서울,2458,26,16,23,165,124,2812,3779,30,24,22,195,210,4260,
20221030,285,253,서평택,서서울,1885,11,24,52,84,92,2148,2339,14,33,48,87,141,2662,
20221030,286,140,통도사휴게소,부산,1192,2,3,0,0,30,1227,1236,5,2,0,0,28,1271,
20221030,287,253,송악,서서울,4438,16,16,30,63,145,4708,3161,7,24,17,67,142,3418,
20221030,287,520,송악,평택,951,4,16,5,38,44,1058,924,3,19,8,29,40,1023,
20221030,288,253,당진,서서울,2231,5,23,14,10,87,2370,2432,10,30,8,5,114,2599,
20221030,289,140,마산,부산,1534,5,9,3,0,60,1611,996,4,3,0,1,41,1045,
20221030,289,146,마산,동창원,2010,23,11,6,5,131,2186,1916,19,9,7,5,138,2094,
20221030,289,148,마산,서김해,1859,9,48,1,0,89,2006,1366,9,45,0,0,89,1509,
20221030,289,150,마산,북부산,6174,17,159,4,7,202,6563,3532,15,124,3,4,137,3815,
20221030,289,244,마산,서부산,5743,36,331,9,8,239,6366,4020,26,278,5,5,162,4496,
20221030,289,245,마산,장유,1802,10,35,12,5,83,1947,1220,6,20,5,1,62,1314,
20221030,291,145,사천,산인,2479,18,43,4,1,120,2665,1721,13,38,3,2,83,1860,
20221030,291,292,사천,진주,1481,7,26,5,4,113,1636,1824,18,16,6,2,140,2006,
20221030,292,145,진주,산인,2428,11,142,0,2,140,2723,1655,11,139,3,2,97,1907,
20221030,292,291,진주,사천,1824,18,16,6,2,140,2006,1481,7,26,5,4,113,1636,
20221030,292,516,진주,통영,962,5,14,0,1,96,1078,936,13,14,1,4,69,1037,
20221030,293,145,문산,산인,1616,6,13,4,6,84,1729,1471,9,14,3,4,65,1566,
20221030,298,253,서산,서서울,4374,13,19,58,7,157,4628,3763,12,40,21,5,135,3976,
20221030,298,520,서산,평택,914,5,44,10,1,27,1001,903,5,101,3,1,32,1045,
20221030,508,509,무안,목포,1259,9,17,12,6,41,1344,1500,13,13,10,16,58,1610,
20221030,508,553,무안,동광산,1395,8,24,4,3,39,1473,1487,7,31,6,0,45,1576,
20221030,509,508,목포,무안,1500,13,13,10,16,58,1610,1259,9,17,12,6,41,1344,
20221030,509,553,목포,동광산,9072,47,142,71,53,255,9640,8444,40,132,67,40,270,8993,
20221030,513,515,고성,북통영,1864,7,49,3,1,110,2034,2562,15,53,5,4,146,2785,
20221030,513,516,고성,통영,4480,29,47,13,14,295,4878,4936,31,33,14,9,274,5297,
20221030,514,516,동고성,통영,1074,5,8,6,4,98,1195,925,0,13,2,0,96,1036,
20221030,515,513,북통영,고성,2562,15,53,5,4,146,2785,1864,7,49,3,1,110,2034,
20221030,516,292,통영,진주,936,13,14,1,4,69,1037,962,5,14,0,1,96,1078,
20221030,516,513,통영,고성,4936,31,33,14,9,274,5297,4480,29,47,13,14,295,4878,
20221030,516,514,통영,동고성,925,0,13,2,0,96,1036,1074,5,8,6,4,98,1195,
20221030,517,598,양평,북여주,1398,4,4,1,12,47,1466,1034,5,3,4,18,37,1101,
20221030,519,231,남대구,화원옥포,4142,31,31,7,7,332,4550,4538,33,44,7,2,306,4930,
20221030,519,232,남대구,달성,1444,25,14,3,0,108,1594,1481,24,27,2,2,111,1647,
20221030,519,233,남대구,현풍,3018,24,39,20,10,168,3279,3469,43,41,10,12,218,3793,
20221030,519,239,남대구,칠원,2346,23,71,5,4,109,2558,2143,19,64,15,1,92,2334,
20221030,519,241,남대구,동고령,2477,12,42,5,2,121,2659,3841,20,59,13,2,163,4098,
20221030,519,242,남대구,고령,3080,14,34,5,12,111,3256,3001,19,30,5,10,108,3173,
20221030,519,243,남대구,해인사,1328,2,5,0,0,48,1383,1426,3,3,0,0,52,1484,
20221030,519,280,남대구,거창,1321,10,42,3,0,58,1434,1529,7,35,2,1,63,1637,
20221030,519,730,남대구,유천,1687,12,9,0,1,73,1782,1816,11,7,0,0,103,1937,
20221030,519,731,남대구,북현풍,1683,4,13,0,0,79,1779,1375,3,4,0,0,79,1461,
20221030,520,253,평택,서서울,3550,14,25,34,20,128,3771,3852,18,37,25,18,188,4138,
20221030,520,287,평택,송악,924,3,19,8,29,40,1023,951,4,16,5,38,44,1058,
20221030,520,298,평택,서산,903,5,101,3,1,32,1045,914,5,44,10,1,27,1001,
20221030,524,527,청통와촌,포항,1038,22,11,1,3,33,1108,1372,19,10,2,0,54,1457,
20221030,526,527,서포항,포항,1659,6,16,1,3,75,1760,1433,8,10,1,1,75,1528,
20221030,527,127,포항,서대구,1475,11,41,3,2,56,1588,1727,9,46,2,15,69,1868,
20221030,527,129,포항,북대구,3239,29,30,8,13,119,3438,2189,18,26,2,8,102,2345,
20221030,527,230,포항,팔공산,2190,12,18,0,2,75,2297,2206,14,13,0,1,80,2314,
20221030,527,524,포항,청통와촌,1372,19,10,2,0,54,1457,1038,22,11,1,3,33,1108,
20221030,527,526,포항,서포항,1433,8,10,1,1,75,1528,1659,6,16,1,3,75,1760,
20221030,528,101,기흥동탄,서울,5573,17,421,91,6,234,6342,6173,16,410,88,2,276,6965,
20221030,530,167,내장산,광주,1115,6,8,3,2,50,1184,1377,16,11,9,1,57,1471,
20221030,542,101,서안성,서울,1719,20,52,88,9,83,1971,1452,11,56,54,7,75,1655,
20221030,543,101,남안성,서울,1248,31,24,44,11,51,1409,1399,23,25,32,10,56,1545,
20221030,545,169,소양,장수,1094,2,5,1,1,24,1127,1265,3,4,0,1,32,1305,
20221030,548,553,북무안,동광산,2426,25,28,20,5,66,2570,1955,18,24,22,4,45,2068,
20221030,549,553,동함평,동광산,5174,22,43,13,9,174,5435,4987,24,56,7,14,167,5255,
20221030,551,553,나주,동광산,1072,4,4,12,3,33,1128,982,4,5,6,2,34,1033,
20221030,552,553,서광산,동광산,3259,41,88,55,34,71,3548,3866,46,116,65,25,113,4231,
20221030,553,508,동광산,무안,1487,7,31,6,0,45,1576,1395,8,24,4,3,39,1473,
20221030,553,509,동광산,목포,8444,40,132,67,40,270,8993,9072,47,142,71,53,255,9640,
20221030,553,548,동광산,북무안,1955,18,24,22,4,45,2068,2426,25,28,20,5,66,2570,
20221030,553,549,동광산,동함평,4987,24,56,7,14,167,5255,5174,22,43,13,9,174,5435,
20221030,553,551,동광산,나주,982,4,5,6,2,34,1033,1072,4,4,12,3,33,1128,
20221030,553,552,동광산,서광산,3866,46,116,65,25,113,4231,3259,41,88,55,34,71,3548,
20221030,554,174,동홍천,춘천,1203,2,8,1,1,72,1287,969,4,10,5,5,65,1058,
20221030,556,557,동순천,황전,1792,8,11,4,4,38,1857,1606,7,8,2,3,46,1672,
20221030,557,556,황전,동순천,1606,7,8,2,3,46,1672,1792,8,11,4,4,38,1857,
20221030,560,190,감곡,동서울,1276,9,11,7,17,32,1352,1153,8,8,7,9,30,1215,
20221030,567,167,남고창,광주,1716,2,31,7,0,60,1816,1507,9,43,16,4,64,1643,
20221030,569,271,북광주,순천,939,15,8,2,20,19,1003,1121,9,8,1,12,29,1180,
20221030,583,704,동해,근덕,903,6,35,4,20,56,1024,919,6,29,5,14,58,1031,
20221030,587,589,오수,상관,1216,3,17,10,6,23,1275,1267,6,15,5,3,27,1323,
20221030,589,587,상관,오수,1267,6,15,5,3,27,1323,1216,3,17,10,6,23,1275,
20221030,597,598,서여주,북여주,933,18,88,9,1,34,1083,1152,15,76,13,1,47,1304,
20221030,598,517,북여주,양평,1034,5,3,4,18,37,1101,1398,4,4,1,12,47,1466,
20221030,598,597,북여주,서여주,1152,15,76,13,1,47,1304,933,18,88,9,1,34,1083,
20221030,621,131,동대구,경산,1324,19,14,6,6,67,1436,1356,21,12,4,11,81,1485,
20221030,621,135,동대구,경주,1196,4,42,0,1,43,1286,1301,2,43,0,1,35,1382,
20221030,624,626,청도,남밀양,1074,7,11,10,8,54,1164,1014,6,12,18,9,35,1094,
20221030,625,626,밀양,남밀양,2818,13,15,12,18,107,2983,2177,7,12,15,12,86,2309,
20221030,626,624,남밀양,청도,1014,6,12,18,9,35,1094,1074,7,11,10,8,54,1164,
20221030,626,625,남밀양,밀양,2177,7,12,15,12,86,2309,2818,13,15,12,18,107,2983,
20221030,641,139,울산,서울산,956,7,54,0,4,46,1067,1460,18,45,2,2,86,1613,
20221030,641,252,울산,대동,1635,10,35,3,9,81,1773,2151,10,42,5,2,112,2322,
20221030,641,648,울산,해운대,1119,2,1,0,0,51,1173,1353,1,3,0,2,71,1430,
20221030,641,706,울산,남경주,1311,4,4,0,3,62,1384,1713,3,6,1,3,79,1805,
20221030,641,707,울산,남포항,1687,9,13,5,31,65,1810,2033,8,10,10,28,87,2176,
20221030,643,648,청량,해운대,3283,4,13,1,2,203,3506,4258,8,47,4,33,224,4574,
20221030,645,648,장안,해운대,1389,1,5,0,0,72,1467,2882,4,13,4,4,141,3048,
20221030,646,648,기장일광,해운대,4500,7,8,3,4,246,4768,5098,11,15,6,33,241,5404,
20221030,648,641,해운대,울산,1353,1,3,0,2,71,1430,1119,2,1,0,0,51,1173,
20221030,648,643,해운대,청량,4258,8,47,4,33,224,4574,3283,4,13,1,2,203,3506,
20221030,648,645,해운대,장안,2882,4,13,4,4,141,3048,1389,1,5,0,0,72,1467,
20221030,648,646,해운대,기장일광,5098,11,15,6,33,241,5404,4500,7,8,3,4,246,4768,
20221030,648,707,해운대,남포항,1531,2,27,6,16,53,1635,1294,1,15,3,2,43,1358,
20221030,651,652,남양주,화도,12661,110,273,166,32,735,13977,14521,112,291,194,25,790,15933,
20221030,651,653,남양주,서종,1942,5,8,0,0,82,2037,4968,5,9,0,0,133,5115,
20221030,651,654,남양주,설악,4466,19,78,4,7,160,4734,4198,14,54,4,6,133,4409,
20221030,651,655,남양주,강촌,2969,7,93,8,16,86,3179,2900,4,89,18,11,77,3099,
20221030,651,656,남양주,남춘천,3229,7,36,5,7,103,3387,2016,3,22,3,2,44,2090,
20221030,652,651,화도,남양주,14521,112,291,194,25,790,15933,12661,110,273,166,32,735,13977,
20221030,652,653,화도,서종,1149,7,1,3,0,56,1216,2628,9,2,4,1,126,2770,
20221030,652,654,화도,설악,1089,9,8,0,2,57,1165,1218,5,9,2,0,47,1281,
20221030,653,651,서종,남양주,4968,5,9,0,0,133,5115,1942,5,8,0,0,82,2037,
20221030,653,652,서종,화도,2628,9,2,4,1,126,2770,1149,7,1,3,0,56,1216,
20221030,654,651,설악,남양주,4198,14,54,4,6,133,4409,4466,19,78,4,7,160,4734,
20221030,654,652,설악,화도,1218,5,9,2,0,47,1281,1089,9,8,0,2,57,1165,
20221030,655,651,강촌,남양주,2900,4,89,18,11,77,3099,2969,7,93,8,16,86,3179,
20221030,656,651,남춘천,남양주,2016,3,22,3,2,44,2090,3229,7,36,5,7,103,3387,
20221030,671,672,봉담,정남,1453,23,11,5,9,84,1585,1557,23,13,11,13,83,1700,
20221030,671,673,봉담,북오산,1561,9,13,7,4,86,1680,1729,15,25,8,7,104,1888,
20221030,671,677,봉담,북평택,8591,33,54,22,13,452,9165,10783,34,48,29,10,436,11340,
20221030,672,671,정남,봉담,1557,23,13,11,13,83,1700,1453,23,11,5,9,84,1585,
20221030,673,101,북오산,서울,1501,11,79,5,1,86,1683,1694,16,81,5,5,123,1924,
20221030,673,671,북오산,봉담,1729,15,25,8,7,104,1888,1561,9,13,7,4,86,1680,
20221030,673,677,북오산,북평택,1907,9,14,6,5,96,2037,1904,11,10,6,3,78,2012,
20221030,675,676,서오산,향남,1290,18,12,4,21,78,1423,1044,20,12,4,37,63,1180,
20221030,675,677,서오산,북평택,9653,58,116,29,47,479,10382,13815,63,103,53,34,587,14655,
20221030,676,675,향남,서오산,1044,20,12,4,37,63,1180,1290,18,12,4,21,78,1423,
20221030,676,677,향남,북평택,1168,19,12,37,40,69,1345,1682,25,23,37,38,83,1888,
20221030,677,101,북평택,서울,2635,17,157,20,24,104,2957,2031,11,255,23,24,108,2452,
20221030,677,671,북평택,봉담,10783,34,48,29,10,436,11340,8591,33,54,22,13,452,9165,
20221030,677,673,북평택,북오산,1904,11,10,6,3,78,2012,1907,9,14,6,5,96,2037,
20221030,677,675,북평택,서오산,13815,63,103,53,34,587,14655,9653,58,116,29,47,479,10382,
20221030,677,676,북평택,향남,1682,25,23,37,38,83,1888,1168,19,12,37,40,69,1345,
20221030,677,876,북평택,양감,3338,23,20,12,13,144,3550,1041,10,13,8,12,70,1154,
20221030,682,685,조암,서시흥,1155,21,15,27,42,59,1319,1546,16,16,20,45,75,1718,
20221030,683,684,송산마도,남안산,1430,21,19,7,51,81,1609,1421,26,13,5,14,65,1544,
20221030,683,685,송산마도,서시흥,4411,25,38,14,217,217,4922,4284,25,40,33,228,231,4841,
20221030,684,683,남안산,송산마도,1421,26,13,5,14,65,1544,1430,21,19,7,51,81,1609,
20221030,684,685,남안산,서시흥,2077,87,69,119,149,131,2632,3520,92,72,99,140,257,4180,
20221030,685,682,서시흥,조암,1546,16,16,20,45,75,1718,1155,21,15,27,42,59,1319,
20221030,685,683,서시흥,송산마도,4284,25,40,33,228,231,4841,4411,25,38,14,217,217,4922,
20221030,685,684,서시흥,남안산,3520,92,72,99,140,257,4180,2077,87,69,119,149,131,2632,
20221030,704,583,근덕,동해,919,6,29,5,14,58,1031,903,6,35,4,20,56,1024,
20221030,705,190,남이천,동서울,2000,25,19,21,10,51,2126,1326,22,26,20,6,32,1432,
20221030,706,641,남경주,울산,1713,3,6,1,3,79,1805,1311,4,4,0,3,62,1384,
20221030,706,707,남경주,남포항,1597,9,29,1,20,96,1752,1916,14,33,2,18,107,2090,
20221030,707,641,남포항,울산,2033,8,10,10,28,87,2176,1687,9,13,5,31,65,1810,
20221030,707,648,남포항,해운대,1294,1,15,3,2,43,1358,1531,2,27,6,16,53,1635,
20221030,707,706,남포항,남경주,1916,14,33,2,18,107,2090,1597,9,29,1,20,96,1752,
20221030,707,708,남포항,동경주,1942,6,13,1,4,77,2043,2007,8,15,2,0,90,2122,
20221030,708,707,동경주,남포항,2007,8,15,2,0,90,2122,1942,6,13,1,4,77,2043,
20221030,715,716,동안동,청송,1147,9,16,12,1,50,1235,1208,13,10,15,3,45,1294,
20221030,715,749,동안동,영덕,1124,7,23,2,2,44,1202,1239,8,22,7,0,60,1336,
20221030,716,715,청송,동안동,1208,13,10,15,3,45,1294,1147,9,16,12,1,50,1235,
20221030,730,519,유천,남대구,1816,11,7,0,0,103,1937,1687,12,9,0,1,73,1782,
20221030,731,519,북현풍,남대구,1375,3,4,0,0,79,1461,1683,4,13,0,0,79,1779,
20221030,741,253,평택고덕,서서울,1008,8,6,9,2,63,1096,1953,14,10,8,9,140,2134,
20221030,749,715,영덕,동안동,1239,8,22,7,0,60,1336,1124,7,23,2,2,44,1202,
20221030,752,252,기장철마,대동,1519,11,15,4,20,94,1663,1584,4,14,1,12,99,1714,
20221030,755,252,광재,대동,1315,8,18,2,7,67,1417,1338,8,8,4,7,59,1424,
20221030,772,774,북달성,남칠곡,2032,7,12,6,5,91,2153,2590,14,16,5,7,94,2726,
20221030,773,774,북다사,남칠곡,1098,2,3,1,2,51,1157,1243,2,6,0,1,47,1299,
20221030,774,772,남칠곡,북달성,2590,14,16,5,7,94,2726,2032,7,12,6,5,91,2153,
20221030,774,773,남칠곡,북다사,1243,2,6,0,1,47,1299,1098,2,3,1,2,51,1157,
20221030,775,203,동명동호,가산,1701,13,13,2,40,69,1838,1597,9,8,7,116,58,1795,
20221030,776,777,연경,파군재,4166,10,10,2,8,195,4391,3917,13,12,2,7,207,4158,
20221030,776,779,연경,율암,4507,18,29,22,146,241,4963,4702,19,47,25,122,249,5164,
20221030,777,776,파군재,연경,3917,13,12,2,7,207,4158,4166,10,10,2,8,195,4391,
20221030,777,779,파군재,율암,3096,5,7,7,2,186,3303,3095,4,5,2,4,173,3283,
20221030,779,776,율암,연경,4702,19,47,25,122,249,5164,4507,18,29,22,146,241,4963,
20221030,779,777,율암,파군재,3095,4,5,2,4,173,3283,3096,5,7,7,2,186,3303,
20221030,876,677,양감,북평택,1041,10,13,8,12,70,1154,3338,23,20,12,13,144,3550,
20221030,981,982,서영암,강진무위사,1661,12,56,14,14,50,1807,2808,17,83,24,17,66,3015,
20221030,981,987,서영암,남순천,1637,11,69,29,64,54,1864,2527,14,66,24,41,99,2771,
20221030,982,981,강진무위사,서영암,2808,17,83,24,17,66,3015,1661,12,56,14,14,50,1807,
20221030,982,987,강진무위사,남순천,1464,11,38,18,20,46,1597,1202,7,30,12,9,48,1308,
20221030,983,987,장흥,남순천,994,1,41,3,5,28,1072,981,5,26,1,9,35,1057,
20221030,984,985,보성,벌교,1948,11,27,11,12,49,2058,2615,17,25,14,18,67,2756,
20221030,984,987,보성,남순천,2614,26,65,31,51,66,2853,2533,26,58,15,46,69,2747,
20221030,985,984,벌교,보성,2615,17,25,14,18,67,2756,1948,11,27,11,12,49,2058,
20221030,986,987,고흥,남순천,5289,30,67,69,50,151,5656,4075,29,53,21,36,141,4355,
20221030,987,981,남순천,서영암,2527,14,66,24,41,99,2771,1637,11,69,29,64,54,1864,
20221030,987,982,남순천,강진무위사,1202,7,30,12,9,48,1308,1464,11,38,18,20,46,1597,
20221030,987,983,남순천,장흥,981,5,26,1,9,35,1057,994,1,41,3,5,28,1072,
20221030,987,984,남순천,보성,2533,26,58,15,46,69,2747,2614,26,65,31,51,66,2853,
20221030,987,986,남순천,고흥,4075,29,53,21,36,141,4355,5289,30,67,69,50,151,5656,
20221031,101,102,서울,동수원,3581,43,248,9,5,228,4114,4817,52,371,25,11,278,5554,
20221031,101,103,서울,수원신갈,14647,594,1545,406,138,740,18070,14322,674,1604,375,99,668,17742,
20221031,101,105,서울,기흥,6834,75,417,68,13,359,7766,5980,83,347,85,23,306,6824,
20221031,101,106,서울,오산,4839,369,410,157,103,304,6182,4321,441,439,162,96,260,5719,
20221031,101,107,서울,안성,3617,66,294,39,17,206,4239,2982,71,295,37,18,167,3570,
20221031,101,108,서울,천안,4397,57,347,30,11,203,5045,3833,51,326,33,13,174,4430,
20221031,101,111,서울,청주,1004,15,184,15,20,39,1277,856,14,206,18,17,33,1144,
20221031,101,171,서울,마성,2038,22,217,55,4,90,2426,2375,23,228,51,4,110,2791,
20221031,101,172,서울,용인,3400,131,97,28,27,231,3914,3890,155,103,51,30,249,4478,
20221031,101,173,서울,양지,3521,210,137,108,46,139,4161,4171,344,125,97,113,159,5009,
20221031,101,229,서울,북천안,979,31,38,34,22,43,1147,795,60,52,43,28,48,1026,
20221031,101,528,서울,기흥동탄,6973,77,1138,128,14,347,8677,7275,79,1273,129,21,351,9128,
20221031,101,542,서울,서안성,1360,29,87,78,25,72,1651,1785,63,80,121,46,95,2190,
20221031,101,543,서울,남안성,1172,54,57,54,64,38,1439,1228,72,82,99,90,49,1620,
20221031,101,673,서울,북오산,1601,36,120,21,32,118,1928,1570,46,114,22,21,92,1865,
20221031,101,677,서울,북평택,1645,43,214,66,86,92,2146,1592,62,260,80,124,84,2202,
20221031,102,101,동수원,서울,4817,52,371,25,11,278,5554,3581,43,248,9,5,228,4114,
20221031,102,172,동수원,용인,933,32,14,15,4,86,1084,984,30,21,6,3,81,1125,
20221031,102,173,동수원,양지,1217,33,26,5,23,64,1368,1301,32,27,5,7,86,1458,
20221031,102,212,동수원,북수원,4342,31,227,22,20,257,4899,4820,45,227,25,15,264,5396,
20221031,102,213,동수원,부곡,1106,18,8,5,23,87,1247,1035,15,18,7,25,87,1187,
20221031,102,214,동수원,동군포,1658,22,20,18,4,109,1831,1588,22,16,9,5,99,1739,
20221031,102,215,동수원,군포,1651,24,22,7,9,102,1815,2316,26,52,7,8,165,2574,
20221031,102,253,동수원,서서울,5353,59,57,17,6,341,5833,5092,45,67,17,18,377,5616,
20221031,102,254,동수원,군자,3866,52,69,17,25,224,4253,4351,84,84,27,40,283,4869,
20221031,102,255,동수원,서안산,1773,37,18,6,6,85,1925,1951,43,21,14,2,113,2144,
20221031,103,101,수원신갈,서울,14322,674,1604,375,99,668,17742,14647,594,1545,406,138,740,18070,
20221031,103,105,수원신갈,기흥,1541,33,49,72,21,110,1826,2069,31,30,67,21,134,2352,
20221031,103,106,수원신갈,오산,1087,68,54,66,13,83,1371,1285,74,62,85,9,80,1595,
20221031,103,107,수원신갈,안성,922,21,37,2,7,65,1054,999,14,37,1,9,67,1127,
20221031,103,108,수원신갈,천안,998,7,55,14,1,44,1119,1165,10,47,15,1,57,1295,
20221031,103,253,수원신갈,서서울,1814,152,64,65,24,105,2224,1928,139,69,65,30,120,2351,
20221031,103,254,수원신갈,군자,1515,96,51,77,84,90,1913,1689,126,66,121,98,98,2198,
20221031,103,528,수원신갈,기흥동탄,1450,12,191,9,2,104,1768,2062,19,148,17,2,135,2383,
20221031,105,101,기흥,서울,5980,83,347,85,23,306,6824,6834,75,417,68,13,359,7766,
20221031,105,103,기흥,수원신갈,2069,31,30,67,21,134,2352,1541,33,49,72,21,110,1826,
20221031,106,101,오산,서울,4321,441,439,162,96,260,5719,4839,369,410,157,103,304,6182,
20221031,106,103,오산,수원신갈,1285,74,62,85,9,80,1595,1087,68,54,66,13,83,1371,
20221031,106,107,오산,안성,1602,43,32,21,20,126,1844,1390,44,14,18,19,113,1598,
20221031,106,108,오산,천안,998,22,22,16,13,59,1130,1020,27,19,14,4,65,1149,
20221031,107,101,안성,서울,2982,71,295,37,18,167,3570,3617,66,294,39,17,206,4239,
20221031,107,103,안성,수원신갈,999,14,37,1,9,67,1127,922,21,37,2,7,65,1054,
20221031,107,106,안성,오산,1390,44,14,18,19,113,1598,1602,43,32,21,20,126,1844,
20221031,107,108,안성,천안,1527,21,36,6,8,130,1728,1492,26,39,12,4,136,1709,
20221031,107,528,안성,기흥동탄,965,17,18,4,2,93,1099,1146,23,28,7,1,104,1309,
20221031,107,742,안성,남사진위,1223,36,41,18,6,105,1429,1385,38,53,30,7,112,1625,
20221031,108,101,천안,서울,3833,51,326,33,13,174,4430,4397,57,347,30,11,203,5045,
20221031,108,103,천안,수원신갈,1165,10,47,15,1,57,1295,998,7,55,14,1,44,1119,
20221031,108,106,천안,오산,1020,27,19,14,4,65,1149,998,22,22,16,13,59,1130,
20221031,108,107,천안,안성,1492,26,39,12,4,136,1709,1527,21,36,6,8,130,1728,
20221031,108,111,천안,청주,1153,38,65,25,36,65,1382,1087,29,57,29,25,76,1303,
20221031,108,229,천안,북천안,3299,82,110,30,31,193,3745,3660,79,124,44,71,221,4199,
20221031,108,528,천안,기흥동탄,1054,6,95,5,12,68,1240,1090,23,112,3,11,63,1302,
20221031,108,742,천안,남사진위,1083,20,41,16,15,71,1246,1044,27,36,24,8,72,1211,
20221031,111,101,청주,서울,856,14,206,18,17,33,1144,1004,15,184,15,20,39,1277,
20221031,111,108,청주,천안,1087,29,57,29,25,76,1303,1153,38,65,25,36,65,1382,
20221031,112,115,남청주,대전,1539,69,56,10,25,116,1815,1667,94,56,11,2,126,1956,
20221031,113,115,신탄진,대전,930,19,6,4,4,111,1074,1114,23,15,4,4,135,1295,
20221031,114,153,남대전,서대전,1880,42,66,54,74,121,2237,1730,34,67,73,71,114,2089,
20221031,115,112,대전,남청주,1667,94,56,11,2,126,1956,1539,69,56,10,25,116,1815,
20221031,115,113,대전,신탄진,1114,23,15,4,4,135,1295,930,19,6,4,4,111,1074,
20221031,115,116,대전,옥천,2256,90,41,19,21,145,2572,1970,53,33,24,16,149,2245,
20221031,115,151,대전,북대전,1091,12,11,9,9,106,1238,883,18,10,1,9,115,1036,
20221031,115,153,대전,서대전,946,13,6,1,1,68,1035,915,19,8,1,1,58,1002,
20221031,115,579,대전,남세종,1027,12,12,4,8,83,1146,1121,15,15,5,8,90,1254,
20221031,116,115,옥천,대전,1970,53,33,24,16,149,2245,2256,90,41,19,21,145,2572,
20221031,119,153,판암,서대전,1691,24,19,6,35,163,1938,1764,26,20,10,40,161,2021,
20221031,123,127,구미,서대구,1568,25,18,16,6,105,1738,1671,31,21,16,9,97,1845,
20221031,123,129,구미,북대구,1772,14,57,11,4,86,1944,1842,15,60,5,1,100,2023,
20221031,123,130,구미,동김천,1101,19,42,41,27,66,1296,1121,20,30,25,20,69,1285,
20221031,125,127,남구미,서대구,1862,52,91,33,13,130,2181,2141,68,109,36,20,117,2491,
20221031,125,129,남구미,북대구,1766,20,68,3,5,105,1967,2194,29,68,10,6,115,2422,
20221031,126,127,왜관,서대구,2504,100,69,43,128,153,2997,2774,123,59,49,70,132,3207,
20221031,126,129,왜관,북대구,2995,90,49,18,69,125,3346,3411,96,63,25,80,161,3836,
20221031,127,123,서대구,구미,1671,31,21,16,9,97,1845,1568,25,18,16,6,105,1738,
20221031,127,125,서대구,남구미,2141,68,109,36,20,117,2491,1862,52,91,33,13,130,2181,
20221031,127,126,서대구,왜관,2774,123,59,49,70,132,3207,2504,100,69,43,128,153,2997,
20221031,127,131,서대구,경산,2538,201,140,100,82,155,3216,1821,156,76,79,52,120,2304,
20221031,127,203,서대구,가산,2119,65,71,32,122,103,2512,1925,57,70,27,141,97,2317,
20221031,127,230,서대구,팔공산,1493,46,41,16,5,85,1686,1115,39,29,14,7,72,1276,
20221031,127,621,서대구,동대구,1761,64,76,36,53,135,2125,1330,40,33,21,35,96,1555,
20221031,129,123,북대구,구미,1842,15,60,5,1,100,2023,1772,14,57,11,4,86,1944,
20221031,129,125,북대구,남구미,2194,29,68,10,6,115,2422,1766,20,68,3,5,105,1967,
20221031,129,126,북대구,왜관,3411,96,63,25,80,161,3836,2995,90,49,18,69,125,3346,
20221031,129,131,북대구,경산,2311,147,81,48,36,117,2740,2896,195,124,71,44,163,3493,
20221031,129,524,북대구,청통와촌,884,49,19,7,11,47,1017,1058,70,31,16,23,59,1257,
20221031,129,527,북대구,포항,1603,19,23,19,66,73,1803,1944,45,26,25,73,105,2218,
20221031,130,123,동김천,구미,1121,20,30,25,20,69,1285,1101,19,42,41,27,66,1296,
20221031,131,127,경산,서대구,1821,156,76,79,52,120,2304,2538,201,140,100,82,155,3216,
20221031,131,129,경산,북대구,2896,195,124,71,44,163,3493,2311,147,81,48,36,117,2740,
20221031,131,132,경산,영천,912,38,44,40,71,46,1151,812,33,45,37,44,55,1026,
20221031,131,230,경산,팔공산,1264,91,42,23,15,80,1515,1496,82,79,32,16,87,1792,
20221031,131,621,경산,동대구,2222,70,34,117,90,140,2673,2433,59,38,116,59,140,2845,
20221031,132,131,영천,경산,812,33,45,37,44,55,1026,912,38,44,40,71,46,1151,
20221031,132,621,영천,동대구,1048,9,23,4,25,43,1152,1161,9,26,1,29,39,1265,
20221031,135,140,경주,부산,1335,13,28,9,53,51,1489,1353,15,30,11,55,71,1535,
20221031,135,252,경주,대동,1052,34,68,49,166,53,1422,1268,44,68,54,102,63,1599,
20221031,138,140,양산,부산,4676,261,180,252,237,270,5876,5052,302,196,279,261,291,6381,
20221031,138,252,양산,대동,2526,310,202,180,326,126,3670,2849,327,195,180,331,130,4012,
20221031,139,140,서울산,부산,1406,43,27,5,24,65,1570,1324,46,33,10,24,81,1518,
20221031,139,252,서울산,대동,858,39,51,39,50,49,1086,847,32,30,40,44,63,1056,
20221031,139,641,서울산,울산,1167,27,53,30,39,99,1415,1054,14,39,14,22,83,1226,
20221031,140,135,부산,경주,1353,15,30,11,55,71,1535,1335,13,28,9,53,51,1489,
20221031,140,138,부산,양산,5052,302,196,279,261,291,6381,4676,261,180,252,237,270,5876,
20221031,140,139,부산,서울산,1324,46,33,10,24,81,1518,1406,43,27,5,24,65,1570,
20221031,140,250,부산,남양산,7659,137,223,30,39,666,8754,7647,120,205,35,38,642,8687,
20221031,140,251,부산,물금,978,116,28,14,39,58,1233,942,102,26,16,59,57,1202,
20221031,140,252,부산,대동,1812,54,54,47,77,109,2153,1565,44,29,32,117,102,1889,
20221031,140,755,부산,광재,1119,24,22,9,20,72,1266,1035,16,12,10,21,64,1158,
20221031,142,145,군북,산인,3913,78,112,44,66,279,4492,4207,83,134,53,102,303,4882,
20221031,143,145,장지,산인,1179,28,27,26,92,90,1442,1293,30,33,24,111,88,1579,
20221031,144,145,함안,산인,1910,41,35,23,103,123,2235,2030,54,38,28,108,134,2392,
20221031,145,142,산인,군북,4207,83,134,53,102,303,4882,3913,78,112,44,66,279,4492,
20221031,145,143,산인,장지,1293,30,33,24,111,88,1579,1179,28,27,26,92,90,1442,
20221031,145,144,산인,함안,2030,54,38,28,108,134,2392,1910,41,35,23,103,123,2235,
20221031,145,291,산인,사천,1333,41,59,27,26,76,1562,1343,59,51,20,31,62,1566,
20221031,145,292,산인,진주,1395,28,144,19,28,79,1693,1506,32,139,15,22,99,1813,
20221031,145,293,산인,문산,1377,31,22,15,15,79,1539,1158,23,26,15,7,71,1300,
20221031,146,150,동창원,북부산,996,18,14,4,38,66,1136,971,13,18,3,21,66,1092,
20221031,146,244,동창원,서부산,1172,26,32,21,46,84,1381,1223,33,35,20,74,83,1468,
20221031,146,245,동창원,장유,960,18,17,4,17,91,1107,1004,17,19,6,30,93,1169,
20221031,146,289,동창원,마산,2676,92,78,53,90,226,3215,2468,90,71,33,54,211,2927,
20221031,147,150,진례,북부산,1371,39,28,26,27,91,1582,1671,43,24,19,17,108,1882,
20221031,147,244,진례,서부산,1709,87,78,48,62,117,2101,1880,106,81,51,92,120,2330,
20221031,147,245,진례,장유,1110,61,72,57,18,103,1421,1430,52,71,52,24,148,1777,
20221031,147,289,진례,마산,1313,105,98,56,102,92,1766,1278,90,77,46,64,93,1648,
20221031,148,150,서김해,북부산,6339,138,85,132,126,490,7310,6329,118,59,116,77,527,7226,
20221031,148,251,서김해,물금,885,27,20,30,11,73,1046,892,35,27,19,22,75,1070,
20221031,148,289,서김해,마산,1547,34,66,15,9,118,1789,1352,20,52,17,8,103,1552,
20221031,149,150,동김해,북부산,10395,179,166,32,96,832,11700,8996,168,132,26,44,725,10091,
20221031,149,250,동김해,남양산,1067,22,55,10,5,79,1238,930,20,55,7,9,66,1087,
20221031,149,251,동김해,물금,1094,40,11,9,5,102,1261,1062,28,10,4,5,99,1208,
20221031,150,146,북부산,동창원,971,13,18,3,21,66,1092,996,18,14,4,38,66,1136,
20221031,150,147,북부산,진례,1671,43,24,19,17,108,1882,1371,39,28,26,27,91,1582,
20221031,150,148,북부산,서김해,6329,118,59,116,77,527,7226,6339,138,85,132,126,490,7310,
20221031,150,149,북부산,동김해,8996,168,132,26,44,725,10091,10395,179,166,32,96,832,11700,
20221031,150,245,북부산,장유,3871,26,88,10,35,255,4285,3003,42,80,9,34,214,3382,
20221031,150,289,북부산,마산,2985,34,90,11,26,144,3290,2641,24,62,9,18,116,2870,
20221031,151,115,북대전,대전,883,18,10,1,9,115,1036,1091,12,11,9,9,106,1238,
20221031,151,153,북대전,서대전,1117,11,14,16,29,82,1269,1226,19,25,22,30,81,1403,
20221031,152,154,유성,안영,911,16,34,13,30,66,1070,1050,21,26,8,31,69,1205,
20221031,153,114,서대전,남대전,1730,34,67,73,71,114,2089,1880,42,66,54,74,121,2237,
20221031,153,115,서대전,대전,915,19,8,1,1,58,1002,946,13,6,1,1,68,1035,
20221031,153,119,서대전,판암,1764,26,20,10,40,161,2021,1691,24,19,6,35,163,1938,
20221031,153,151,서대전,북대전,1226,19,25,22,30,81,1403,1117,11,14,16,29,82,1269,
20221031,153,154,서대전,안영,1055,31,25,28,70,70,1279,1066,34,31,37,66,60,1294,
20221031,153,579,서대전,남세종,1112,21,15,5,8,73,1234,1006,26,14,8,18,74,1146,
20221031,154,152,안영,유성,1050,21,26,8,31,69,1205,911,16,34,13,30,66,1070,
20221031,154,153,안영,서대전,1066,34,31,37,66,60,1294,1055,31,25,28,70,70,1279,
20221031,159,167,서전주,광주,1426,61,74,49,41,44,1695,1351,61,53,42,35,38,1580,
20221031,166,167,장성,광주,2271,72,59,30,59,110,2601,2635,110,70,45,41,112,3013,
20221031,167,159,광주,서전주,1351,61,53,42,35,38,1580,1426,61,74,49,41,44,1695,
20221031,167,166,광주,장성,2635,110,70,45,41,112,3013,2271,72,59,30,59,110,2601,
20221031,167,567,광주,남고창,1237,24,57,20,26,42,1406,1298,29,47,11,34,49,1468,
20221031,171,101,마성,서울,2375,23,228,51,4,110,2791,2038,22,217,55,4,90,2426,
20221031,172,101,용인,서울,3890,155,103,51,30,249,4478,3400,131,97,28,27,231,3914,
20221031,172,102,용인,동수원,984,30,21,6,3,81,1125,933,32,14,15,4,86,1084,
20221031,172,173,용인,양지,1898,226,116,117,42,149,2548,1741,200,121,111,57,144,2374,
20221031,172,212,용인,북수원,906,39,17,16,12,54,1044,1111,56,19,10,9,66,1271,
20221031,172,253,용인,서서울,1012,48,21,27,21,45,1174,987,42,18,30,15,55,1147,
20221031,173,101,양지,서울,4171,344,125,97,113,159,5009,3521,210,137,108,46,139,4161,
20221031,173,102,양지,동수원,1301,32,27,5,7,86,1458,1217,33,26,5,23,64,1368,
20221031,173,172,양지,용인,1741,200,121,111,57,144,2374,1898,226,116,117,42,149,2548,
20221031,173,212,양지,북수원,1144,75,34,44,30,72,1399,1269,94,33,40,66,64,1566,
20221031,173,253,양지,서서울,1098,119,61,94,42,57,1471,957,113,53,87,37,51,1298,
20221031,173,254,양지,군자,761,95,73,174,158,42,1303,692,89,85,169,160,39,1234,
20221031,174,179,춘천,홍천,3337,63,89,50,34,315,3888,3068,56,89,47,30,319,3609,
20221031,174,216,춘천,횡성,1003,36,33,20,32,71,1195,1058,38,28,12,17,80,1233,
20221031,174,218,춘천,남원주,1088,36,68,18,18,65,1293,1011,29,58,14,6,58,1176,
20221031,174,554,춘천,동홍천,1122,18,14,7,21,90,1272,1119,12,17,6,9,85,1248,
20221031,176,190,이천,동서울,1393,57,164,99,107,66,1886,1686,55,172,147,60,75,2195,
20221031,179,174,홍천,춘천,3068,56,89,47,30,319,3609,3337,63,89,50,34,315,3888,
20221031,184,189,대관령,강릉,1158,38,52,3,11,73,1335,1244,43,52,4,8,79,1430,
20221031,189,184,강릉,대관령,1244,43,52,4,8,79,1430,1158,38,52,3,11,73,1335,
20221031,190,176,동서울,이천,1686,55,172,147,60,75,2195,1393,57,164,99,107,66,1886,
20221031,190,191,동서울,경기광주,10329,632,454,325,229,677,12646,10051,602,402,227,198,678,12158,
20221031,190,192,동서울,곤지암,6301,468,210,196,97,374,7646,5243,386,165,156,69,309,6328,
20221031,190,193,동서울,일죽,2581,151,153,166,115,108,3274,2169,166,149,219,104,93,2900,
20221031,190,194,동서울,서이천,4317,547,287,253,167,260,5831,2922,408,206,209,110,198,4053,
20221031,190,198,동서울,서청주,1173,37,43,34,32,34,1353,923,26,43,22,14,40,1068,
20221031,190,560,동서울,감곡,992,17,27,46,72,24,1178,1008,26,33,22,87,24,1200,
20221031,190,705,동서울,남이천,1463,101,43,129,93,61,1890,1272,101,57,72,57,50,1609,
20221031,191,190,경기광주,동서울,10051,602,402,227,198,678,12158,10329,632,454,325,229,677,12646,
20221031,192,190,곤지암,동서울,5243,386,165,156,69,309,6328,6301,468,210,196,97,374,7646,
20221031,192,194,곤지암,서이천,1262,220,107,194,131,96,2010,1017,140,87,179,147,75,1645,
20221031,193,190,일죽,동서울,2169,166,149,219,104,93,2900,2581,151,153,166,115,108,3274,
20221031,194,190,서이천,동서울,2922,408,206,209,110,198,4053,4317,547,287,253,167,260,5831,
20221031,194,192,서이천,곤지암,1017,140,87,179,147,75,1645,1262,220,107,194,131,96,2010,
20221031,196,198,진천,서청주,1240,37,87,36,31,62,1493,1189,34,79,31,23,68,1424,
20221031,198,190,서청주,동서울,923,26,43,22,14,40,1068,1173,37,43,34,32,34,1353,
20221031,198,196,서청주,진천,1189,34,79,31,23,68,1424,1240,37,87,36,31,62,1493,
20221031,201,203,칠곡,가산,792,37,31,44,126,53,1083,886,36,47,38,162,49,1218,
20221031,203,127,가산,서대구,1925,57,70,27,141,97,2317,2119,65,71,32,122,103,2512,
20221031,203,201,가산,칠곡,886,36,47,38,162,49,1218,792,37,31,44,126,53,1083,
20221031,203,775,가산,동명동호,1588,52,45,51,248,83,2067,1588,56,33,43,170,78,1968,
20221031,212,102,북수원,동수원,4820,45,227,25,15,264,5396,4342,31,227,22,20,257,4899,
20221031,212,172,북수원,용인,1111,56,19,10,9,66,1271,906,39,17,16,12,54,1044,
20221031,212,173,북수원,양지,1269,94,33,40,66,64,1566,1144,75,34,44,30,72,1399,
20221031,212,253,북수원,서서울,2191,41,20,12,18,156,2438,937,29,13,12,12,63,1066,
20221031,212,254,북수원,군자,1594,27,27,16,21,76,1761,1085,30,22,12,23,61,1233,
20221031,213,102,부곡,동수원,1035,15,18,7,25,87,1187,1106,18,8,5,23,87,1247,
20221031,213,253,부곡,서서울,1328,69,35,34,167,80,1713,1012,58,26,46,146,75,1363,
20221031,213,254,부곡,군자,962,33,29,29,446,64,1563,883,41,35,40,364,61,1424,
20221031,214,102,동군포,동수원,1588,22,16,9,5,99,1739,1658,22,20,18,4,109,1831,
20221031,215,102,군포,동수원,2316,26,52,7,8,165,2574,1651,24,22,7,9,102,1815,
20221031,215,253,군포,서서울,2796,77,59,31,41,175,3179,3674,150,136,174,95,242,4471,
20221031,215,254,군포,군자,1962,59,58,33,105,126,2343,2744,111,85,130,166,200,3436,
20221031,215,255,군포,서안산,1245,36,27,15,16,96,1435,1485,70,61,86,59,121,1882,
20221031,216,174,횡성,춘천,1058,38,28,12,17,80,1233,1003,36,33,20,32,71,1195,
20221031,218,174,남원주,춘천,1011,29,58,14,6,58,1176,1088,36,68,18,18,65,1293,
20221031,218,240,남원주,제천,2007,44,41,24,56,128,2300,1968,58,49,21,24,128,2248,
20221031,225,291,서진주,사천,979,23,21,5,77,61,1166,1011,22,28,12,81,64,1218,
20221031,229,101,북천안,서울,795,60,52,43,28,48,1026,979,31,38,34,22,43,1147,
20221031,229,108,북천안,천안,3660,79,124,44,71,221,4199,3299,82,110,30,31,193,3745,
20221031,230,127,팔공산,서대구,1115,39,29,14,7,72,1276,1493,46,41,16,5,85,1686,
20221031,230,131,팔공산,경산,1496,82,79,32,16,87,1792,1264,91,42,23,15,80,1515,
20221031,230,524,팔공산,청통와촌,1135,40,37,12,45,62,1331,971,43,29,13,37,46,1139,
20221031,230,527,팔공산,포항,1567,26,19,8,23,83,1726,1265,27,13,5,29,71,1410,
20221031,231,519,화원옥포,남대구,6415,161,112,159,269,479,7595,6206,146,116,143,152,444,7207,
20221031,232,519,달성,남대구,2658,132,129,41,38,179,3177,2916,137,139,45,30,185,3452,
20221031,233,519,현풍,남대구,4923,212,171,75,117,353,5851,4473,192,189,99,97,327,5377,
20221031,238,239,칠서,칠원,1526,92,93,188,384,108,2391,1744,117,120,208,436,137,2762,
20221031,239,238,칠원,칠서,1744,117,120,208,436,137,2762,1526,92,93,188,384,108,2391,
20221031,239,519,칠원,남대구,1174,55,81,49,88,45,1492,1223,58,74,38,71,49,1513,
20221031,240,218,제천,남원주,1968,58,49,21,24,128,2248,2007,44,41,24,56,128,2300,
20221031,241,519,동고령,남대구,2937,81,76,388,113,144,3739,2975,88,91,391,131,137,3813,
20221031,242,519,고령,남대구,1662,38,47,27,176,78,2028,1763,35,50,15,170,73,2106,
20221031,244,146,서부산,동창원,1223,33,35,20,74,83,1468,1172,26,32,21,46,84,1381,
20221031,244,147,서부산,진례,1880,106,81,51,92,120,2330,1709,87,78,48,62,117,2101,
20221031,244,245,서부산,장유,13117,239,362,122,276,959,15075,12354,222,364,123,339,933,14335,
20221031,244,289,서부산,마산,3458,67,252,67,102,155,4101,2816,64,232,42,68,129,3351,
20221031,245,146,장유,동창원,1004,17,19,6,30,93,1169,960,18,17,4,17,91,1107,
20221031,245,147,장유,진례,1430,52,71,52,24,148,1777,1110,61,72,57,18,103,1421,
20221031,245,150,장유,북부산,3003,42,80,9,34,214,3382,3871,26,88,10,35,255,4285,
20221031,245,244,장유,서부산,12354,222,364,123,339,933,14335,13117,239,362,122,276,959,15075,
20221031,245,289,장유,마산,1638,31,62,18,39,138,1926,1300,26,39,20,11,112,1508,
20221031,250,140,남양산,부산,7647,120,205,35,38,642,8687,7659,137,223,30,39,666,8754,
20221031,250,149,남양산,동김해,930,20,55,7,9,66,1087,1067,22,55,10,5,79,1238,
20221031,250,252,남양산,대동,3378,152,92,113,111,257,4103,3920,157,116,78,122,281,4674,
20221031,251,140,물금,부산,942,102,26,16,59,57,1202,978,116,28,14,39,58,1233,
20221031,251,148,물금,서김해,892,35,27,19,22,75,1070,885,27,20,30,11,73,1046,
20221031,251,149,물금,동김해,1062,28,10,4,5,99,1208,1094,40,11,9,5,102,1261,
20221031,251,252,물금,대동,3090,188,99,172,432,248,4229,3870,176,98,190,544,281,5159,
20221031,252,135,대동,경주,1268,44,68,54,102,63,1599,1052,34,68,49,166,53,1422,
20221031,252,138,대동,양산,2849,327,195,180,331,130,4012,2526,310,202,180,326,126,3670,
20221031,252,139,대동,서울산,847,32,30,40,44,63,1056,858,39,51,39,50,49,1086,
20221031,252,140,대동,부산,1565,44,29,32,117,102,1889,1812,54,54,47,77,109,2153,
20221031,252,250,대동,남양산,3920,157,116,78,122,281,4674,3378,152,92,113,111,257,4103,
20221031,252,251,대동,물금,3870,176,98,190,544,281,5159,3090,188,99,172,432,248,4229,
20221031,252,641,대동,울산,1632,70,100,32,56,115,2005,1338,69,87,33,61,77,1665,
20221031,252,752,대동,기장철마,1824,67,43,37,156,127,2254,1877,63,64,37,83,154,2278,
20221031,252,753,대동,금정,1760,89,105,83,187,126,2350,1096,63,77,65,79,63,1443,
20221031,252,755,대동,광재,2460,89,86,88,314,147,3184,2277,106,96,78,489,122,3168,
20221031,252,756,대동,한림,908,37,38,28,78,46,1135,960,47,40,27,88,42,1204,
20221031,253,102,서서울,동수원,5092,45,67,17,18,377,5616,5353,59,57,17,6,341,5833,
20221031,253,103,서서울,수원신갈,1928,139,69,65,30,120,2351,1814,152,64,65,24,105,2224,
20221031,253,172,서서울,용인,987,42,18,30,15,55,1147,1012,48,21,27,21,45,1174,
20221031,253,173,서서울,양지,957,113,53,87,37,51,1298,1098,119,61,94,42,57,1471,
20221031,253,212,서서울,북수원,937,29,13,12,12,63,1066,2191,41,20,12,18,156,2438,
20221031,253,213,서서울,부곡,1012,58,26,46,146,75,1363,1328,69,35,34,167,80,1713,
20221031,253,215,서서울,군포,3674,150,136,174,95,242,4471,2796,77,59,31,41,175,3179,
20221031,253,255,서서울,서안산,15164,449,634,612,321,861,18041,14349,449,606,550,314,881,17149,
20221031,253,256,서서울,안산,8841,142,84,49,35,668,9819,5701,121,77,36,56,401,6392,
20221031,253,281,서서울,매송,3962,64,35,14,54,252,4381,3312,56,31,12,99,221,3731,
20221031,253,282,서서울,비봉,5644,238,242,144,383,314,6965,5406,283,270,173,442,343,6917,
20221031,253,283,서서울,발안,3471,146,168,157,122,225,4289,3254,204,170,162,106,189,4085,
20221031,253,285,서서울,서평택,1725,58,103,228,393,108,2615,1433,84,120,353,484,95,2569,
20221031,253,287,서서울,송악,2188,39,67,69,205,78,2646,1828,33,56,78,370,81,2446,
20221031,253,288,서서울,당진,1509,25,34,31,29,74,1702,1375,35,51,40,44,57,1602,
20221031,253,298,서서울,서산,2336,22,75,55,22,95,2605,2421,26,60,94,32,82,2715,
20221031,253,520,서서울,평택,2371,102,106,160,132,96,2967,2123,96,103,229,140,97,2788,
20221031,253,540,서서울,청북,881,39,71,95,68,46,1200,880,61,46,76,81,41,1185,
20221031,254,102,군자,동수원,4351,84,84,27,40,283,4869,3866,52,69,17,25,224,4253,
20221031,254,103,군자,수원신갈,1689,126,66,121,98,98,2198,1515,96,51,77,84,90,1913,
20221031,254,173,군자,양지,692,89,85,169,160,39,1234,761,95,73,174,158,42,1303,
20221031,254,212,군자,북수원,1085,30,22,12,23,61,1233,1594,27,27,16,21,76,1761,
20221031,254,213,군자,부곡,883,41,35,40,364,61,1424,962,33,29,29,446,64,1563,
20221031,254,215,군자,군포,2744,111,85,130,166,200,3436,1962,59,58,33,105,126,2343,
20221031,254,255,군자,서안산,10292,451,203,216,307,713,12182,9358,386,155,211,307,634,11051,
20221031,254,256,군자,안산,4546,121,119,35,61,349,5231,4921,110,106,43,62,383,5625,
20221031,254,281,군자,매송,1225,41,22,22,68,79,1457,834,24,19,17,51,63,1008,
20221031,254,282,군자,비봉,1381,112,92,82,178,93,1938,1104,100,75,58,131,79,1547,
20221031,254,283,군자,발안,1192,82,55,67,140,72,1608,936,83,46,54,93,64,1276,
20221031,255,102,서안산,동수원,1951,43,21,14,2,113,2144,1773,37,18,6,6,85,1925,
20221031,255,215,서안산,군포,1485,70,61,86,59,121,1882,1245,36,27,15,16,96,1435,
20221031,255,253,서안산,서서울,14349,449,606,550,314,881,17149,15164,449,634,612,321,861,18041,
20221031,255,254,서안산,군자,9358,386,155,211,307,634,11051,10292,451,203,216,307,713,12182,
20221031,256,253,안산,서서울,5701,121,77,36,56,401,6392,8841,142,84,49,35,668,9819,
20221031,256,254,안산,군자,4921,110,106,43,62,383,5625,4546,121,119,35,61,349,5231,
20221031,261,262,동광주,창평,1572,78,30,39,64,51,1834,1597,53,18,30,57,49,1804,
20221031,262,261,창평,동광주,1597,53,18,30,57,49,1804,1572,78,30,39,64,51,1834,
20221031,271,569,순천,북광주,806,71,41,19,101,23,1061,848,61,31,30,93,30,1093,
20221031,280,519,거창,남대구,873,18,49,7,6,47,1000,891,29,64,8,6,46,1044,
20221031,281,253,매송,서서울,3312,56,31,12,99,221,3731,3962,64,35,14,54,252,4381,
20221031,281,254,매송,군자,834,24,19,17,51,63,1008,1225,41,22,22,68,79,1457,
20221031,282,253,비봉,서서울,5406,283,270,173,442,343,6917,5644,238,242,144,383,314,6965,
20221031,282,254,비봉,군자,1104,100,75,58,131,79,1547,1381,112,92,82,178,93,1938,
20221031,283,253,발안,서서울,3254,204,170,162,106,189,4085,3471,146,168,157,122,225,4289,
20221031,283,254,발안,군자,936,83,46,54,93,64,1276,1192,82,55,67,140,72,1608,
20221031,285,253,서평택,서서울,1433,84,120,353,484,95,2569,1725,58,103,228,393,108,2615,
20221031,285,287,서평택,송악,664,34,96,73,550,37,1454,658,36,87,67,383,42,1273,
20221031,287,253,송악,서서울,1828,33,56,78,370,81,2446,2188,39,67,69,205,78,2646,
20221031,287,285,송악,서평택,658,36,87,67,383,42,1273,664,34,96,73,550,37,1454,
20221031,288,253,당진,서서울,1375,35,51,40,44,57,1602,1509,25,34,31,29,74,1702,
20221031,289,146,마산,동창원,2468,90,71,33,54,211,2927,2676,92,78,53,90,226,3215,
20221031,289,147,마산,진례,1278,90,77,46,64,93,1648,1313,105,98,56,102,92,1766,
20221031,289,148,마산,서김해,1352,20,52,17,8,103,1552,1547,34,66,15,9,118,1789,
20221031,289,150,마산,북부산,2641,24,62,9,18,116,2870,2985,34,90,11,26,144,3290,
20221031,289,244,마산,서부산,2816,64,232,42,68,129,3351,3458,67,252,67,102,155,4101,
20221031,289,245,마산,장유,1300,26,39,20,11,112,1508,1638,31,62,18,39,138,1926,
20221031,289,757,마산,진영,742,41,57,42,91,42,1015,825,75,57,52,95,47,1151,
20221031,291,145,사천,산인,1343,59,51,20,31,62,1566,1333,41,59,27,26,76,1562,
20221031,291,225,사천,서진주,1011,22,28,12,81,64,1218,979,23,21,5,77,61,1166,
20221031,291,292,사천,진주,2695,70,74,40,58,239,3176,3388,88,95,49,75,281,3976,
20221031,292,145,진주,산인,1506,32,139,15,22,99,1813,1395,28,144,19,28,79,1693,
20221031,292,291,진주,사천,3388,88,95,49,75,281,3976,2695,70,74,40,58,239,3176,
20221031,293,145,문산,산인,1158,23,26,15,7,71,1300,1377,31,22,15,15,79,1539,
20221031,298,253,서산,서서울,2421,26,60,94,32,82,2715,2336,22,75,55,22,95,2605,
20221031,508,509,무안,목포,1361,37,39,39,80,68,1624,1612,39,41,36,72,96,1896,
20221031,508,553,무안,동광산,1432,22,30,24,27,51,1586,1552,34,48,30,25,58,1747,
20221031,509,508,목포,무안,1612,39,41,36,72,96,1896,1361,37,39,39,80,68,1624,
20221031,509,553,목포,동광산,6614,190,186,140,339,238,7707,7481,166,188,140,356,279,8610,
20221031,513,515,고성,북통영,1341,31,78,9,31,84,1574,1501,31,65,18,33,105,1753,
20221031,513,516,고성,통영,3007,102,100,80,187,228,3704,2859,86,115,86,150,251,3547,
20221031,514,516,동고성,통영,1234,24,49,47,121,155,1630,1208,18,62,47,131,161,1627,
20221031,515,513,북통영,고성,1501,31,65,18,33,105,1753,1341,31,78,9,31,84,1574,
20221031,516,513,통영,고성,2859,86,115,86,150,251,3547,3007,102,100,80,187,228,3704,
20221031,516,514,통영,동고성,1208,18,62,47,131,161,1627,1234,24,49,47,121,155,1630,
20221031,519,231,남대구,화원옥포,6206,146,116,143,152,444,7207,6415,161,112,159,269,479,7595,
20221031,519,232,남대구,달성,2916,137,139,45,30,185,3452,2658,132,129,41,38,179,3177,
20221031,519,233,남대구,현풍,4473,192,189,99,97,327,5377,4923,212,171,75,117,353,5851,
20221031,519,239,남대구,칠원,1223,58,74,38,71,49,1513,1174,55,81,49,88,45,1492,
20221031,519,241,남대구,동고령,2975,88,91,391,131,137,3813,2937,81,76,388,113,144,3739,
20221031,519,242,남대구,고령,1763,35,50,15,170,73,2106,1662,38,47,27,176,78,2028,
20221031,519,280,남대구,거창,891,29,64,8,6,46,1044,873,18,49,7,6,47,1000,
20221031,519,730,남대구,유천,2396,63,12,0,28,163,2662,2857,58,8,0,0,205,3128,
20221031,519,731,남대구,북현풍,1942,18,28,0,8,116,2112,1520,25,5,0,0,118,1668,
20221031,520,253,평택,서서울,2123,96,103,229,140,97,2788,2371,102,106,160,132,96,2967,
20221031,520,540,평택,청북,955,78,151,133,70,65,1452,777,85,145,113,75,47,1242,
20221031,520,741,평택,평택고덕,880,13,188,17,21,82,1201,778,15,162,15,19,67,1056,
20221031,524,129,청통와촌,북대구,1058,70,31,16,23,59,1257,884,49,19,7,11,47,1017,
20221031,524,230,청통와촌,팔공산,971,43,29,13,37,46,1139,1135,40,37,12,45,62,1331,
20221031,526,527,서포항,포항,942,15,13,12,23,75,1080,1024,15,15,7,23,75,1159,
20221031,527,129,포항,북대구,1944,45,26,25,73,105,2218,1603,19,23,19,66,73,1803,
20221031,527,230,포항,팔공산,1265,27,13,5,29,71,1410,1567,26,19,8,23,83,1726,
20221031,527,526,포항,서포항,1024,15,15,7,23,75,1159,942,15,13,12,23,75,1080,
20221031,528,101,기흥동탄,서울,7275,79,1273,129,21,351,9128,6973,77,1138,128,14,347,8677,
20221031,528,103,기흥동탄,수원신갈,2062,19,148,17,2,135,2383,1450,12,191,9,2,104,1768,
20221031,528,107,기흥동탄,안성,1146,23,28,7,1,104,1309,965,17,18,4,2,93,1099,
20221031,528,108,기흥동탄,천안,1090,23,112,3,11,63,1302,1054,6,95,5,12,68,1240,
20221031,540,253,청북,서서울,880,61,46,76,81,41,1185,881,39,71,95,68,46,1200,
20221031,540,520,청북,평택,777,85,145,113,75,47,1242,955,78,151,133,70,65,1452,
20221031,540,741,청북,평택고덕,857,32,35,49,139,88,1200,888,40,28,48,143,97,1244,
20221031,542,101,서안성,서울,1785,63,80,121,46,95,2190,1360,29,87,78,25,72,1651,
20221031,542,543,서안성,남안성,1046,49,76,109,93,87,1460,1148,42,88,116,95,87,1576,
20221031,543,101,남안성,서울,1228,72,82,99,90,49,1620,1172,54,57,54,64,38,1439,
20221031,543,542,남안성,서안성,1148,42,88,116,95,87,1576,1046,49,76,109,93,87,1460,
20221031,543,555,남안성,북진천,782,100,153,177,145,45,1402,789,109,156,154,148,53,1409,
20221031,548,553,북무안,동광산,1314,30,26,26,52,38,1486,1521,32,33,29,59,46,1720,
20221031,549,553,동함평,동광산,3440,34,67,45,54,126,3766,3526,43,80,42,69,128,3888,
20221031,551,553,나주,동광산,1316,19,32,75,41,67,1550,1274,22,41,73,46,63,1519,
20221031,552,553,서광산,동광산,4348,157,181,233,181,181,5281,6003,164,208,216,181,216,6988,
20221031,553,508,동광산,무안,1552,34,48,30,25,58,1747,1432,22,30,24,27,51,1586,
20221031,553,509,동광산,목포,7481,166,188,140,356,279,8610,6614,190,186,140,339,238,7707,
20221031,553,548,동광산,북무안,1521,32,33,29,59,46,1720,1314,30,26,26,52,38,1486,
20221031,553,549,동광산,동함평,3526,43,80,42,69,128,3888,3440,34,67,45,54,126,3766,
20221031,553,551,동광산,나주,1274,22,41,73,46,63,1519,1316,19,32,75,41,67,1550,
20221031,553,552,동광산,서광산,6003,164,208,216,181,216,6988,4348,157,181,233,181,181,5281,
20221031,554,174,동홍천,춘천,1119,12,17,6,9,85,1248,1122,18,14,7,21,90,1272,
20221031,555,543,북진천,남안성,789,109,156,154,148,53,1409,782,100,153,177,145,45,1402,
20221031,560,190,감곡,동서울,1008,26,33,22,87,24,1200,992,17,27,46,72,24,1178,
20221031,567,167,남고창,광주,1298,29,47,11,34,49,1468,1237,24,57,20,26,42,1406,
20221031,569,271,북광주,순천,848,61,31,30,93,30,1093,806,71,41,19,101,23,1061,
20221031,579,115,남세종,대전,1121,15,15,5,8,90,1254,1027,12,12,4,8,83,1146,
20221031,579,153,남세종,서대전,1006,26,14,8,18,74,1146,1112,21,15,5,8,73,1234,
20221031,587,589,오수,상관,1001,16,50,36,68,29,1200,1260,27,50,35,143,51,1566,
20221031,589,587,상관,오수,1260,27,50,35,143,51,1566,1001,16,50,36,68,29,1200,
20221031,597,598,서여주,북여주,931,41,83,28,39,52,1174,1071,48,71,31,33,53,1307,
20221031,598,597,북여주,서여주,1071,48,71,31,33,53,1307,931,41,83,28,39,52,1174,
20221031,621,127,동대구,서대구,1330,40,33,21,35,96,1555,1761,64,76,36,53,135,2125,
20221031,621,131,동대구,경산,2433,59,38,116,59,140,2845,2222,70,34,117,90,140,2673,
20221031,621,132,동대구,영천,1161,9,26,1,29,39,1265,1048,9,23,4,25,43,1152,
20221031,625,626,밀양,남밀양,1304,54,48,38,56,57,1557,1310,46,42,37,57,65,1557,
20221031,626,625,남밀양,밀양,1310,46,42,37,57,65,1557,1304,54,48,38,56,57,1557,
20221031,626,627,남밀양,삼랑진,904,27,34,9,43,106,1123,981,24,26,18,46,93,1188,
20221031,627,626,삼랑진,남밀양,981,24,26,18,46,93,1188,904,27,34,9,43,106,1123,
20221031,641,139,울산,서울산,1054,14,39,14,22,83,1226,1167,27,53,30,39,99,1415,
20221031,641,252,울산,대동,1338,69,87,33,61,77,1665,1632,70,100,32,56,115,2005,
20221031,641,643,울산,청량,1230,12,19,15,47,116,1439,1282,10,12,5,21,137,1467,
20221031,641,706,울산,남경주,1146,9,20,15,41,62,1293,1182,4,23,22,33,69,1333,
20221031,641,707,울산,남포항,1114,13,19,15,144,50,1355,1113,14,25,33,169,58,1412,
20221031,643,641,청량,울산,1282,10,12,5,21,137,1467,1230,12,19,15,47,116,1439,
20221031,643,648,청량,해운대,2746,28,38,16,48,173,3049,3475,31,80,40,447,220,4293,
20221031,645,648,장안,해운대,1659,11,12,9,9,104,1804,3001,25,23,45,86,188,3368,
20221031,646,648,기장일광,해운대,4478,22,20,12,42,259,4833,5365,40,23,27,190,311,5956,
20221031,648,643,해운대,청량,3475,31,80,40,447,220,4293,2746,28,38,16,48,173,3049,
20221031,648,645,해운대,장안,3001,25,23,45,86,188,3368,1659,11,12,9,9,104,1804,
20221031,648,646,해운대,기장일광,5365,40,23,27,190,311,5956,4478,22,20,12,42,259,4833,
20221031,651,652,남양주,화도,14519,488,478,420,220,1083,17208,16884,544,541,472,201,1250,19892,
20221031,651,653,남양주,서종,1888,20,7,6,19,84,2024,2000,23,10,4,10,79,2126,
20221031,651,654,남양주,설악,4056,42,68,18,11,172,4367,3926,30,52,19,13,145,4185,
20221031,651,655,남양주,강촌,2391,49,122,28,44,69,2703,2499,34,108,40,41,82,2804,
20221031,651,656,남양주,남춘천,2688,35,52,27,86,78,2966,2262,24,32,13,58,67,2456,
20221031,652,651,화도,남양주,16884,544,541,472,201,1250,19892,14519,488,478,420,220,1083,17208,
20221031,652,653,화도,서종,1429,29,17,30,12,104,1621,1521,23,23,21,14,112,1714,
20221031,652,654,화도,설악,1170,21,7,6,13,78,1295,1294,24,13,7,12,85,1435,
20221031,653,651,서종,남양주,2000,23,10,4,10,79,2126,1888,20,7,6,19,84,2024,
20221031,653,652,서종,화도,1521,23,23,21,14,112,1714,1429,29,17,30,12,104,1621,
20221031,654,651,설악,남양주,3926,30,52,19,13,145,4185,4056,42,68,18,11,172,4367,
20221031,654,652,설악,화도,1294,24,13,7,12,85,1435,1170,21,7,6,13,78,1295,
20221031,655,651,강촌,남양주,2499,34,108,40,41,82,2804,2391,49,122,28,44,69,2703,
20221031,656,651,남춘천,남양주,2262,24,32,13,58,67,2456,2688,35,52,27,86,78,2966,
20221031,671,672,봉담,정남,3189,172,88,154,100,230,3933,3606,156,92,145,122,265,4386,
20221031,671,673,봉담,북오산,1883,56,36,17,25,136,2153,1902,53,44,20,25,156,2200,
20221031,671,676,봉담,향남,1338,116,55,36,37,114,1696,1172,113,40,24,27,103,1479,
20221031,671,677,봉담,북평택,8018,179,204,139,271,474,9285,7068,161,181,116,187,407,8120,
20221031,672,671,정남,봉담,3606,156,92,145,122,265,4386,3189,172,88,154,100,230,3933,
20221031,673,101,북오산,서울,1570,46,114,22,21,92,1865,1601,36,120,21,32,118,1928,
20221031,673,671,북오산,봉담,1902,53,44,20,25,156,2200,1883,56,36,17,25,136,2153,
20221031,673,677,북오산,북평택,1848,32,77,31,49,126,2163,1932,35,52,27,38,137,2221,
20221031,675,676,서오산,향남,3354,106,87,75,204,218,4044,3079,94,67,52,174,205,3671,
20221031,675,677,서오산,북평택,11777,231,376,157,181,772,13494,10714,229,336,173,168,709,12329,
20221031,675,876,서오산,양감,1775,67,38,37,45,114,2076,1924,62,27,35,36,140,2224,
20221031,676,671,향남,봉담,1172,113,40,24,27,103,1479,1338,116,55,36,37,114,1696,
20221031,676,675,향남,서오산,3079,94,67,52,174,205,3671,3354,106,87,75,204,218,4044,
20221031,676,677,향남,북평택,1759,157,182,200,158,119,2575,1608,137,145,194,116,79,2279,
20221031,677,101,북평택,서울,1592,62,260,80,124,84,2202,1645,43,214,66,86,92,2146,
20221031,677,671,북평택,봉담,7068,161,181,116,187,407,8120,8018,179,204,139,271,474,9285,
20221031,677,673,북평택,북오산,1932,35,52,27,38,137,2221,1848,32,77,31,49,126,2163,
20221031,677,675,북평택,서오산,10714,229,336,173,168,709,12329,11777,231,376,157,181,772,13494,
20221031,677,676,북평택,향남,1608,137,145,194,116,79,2279,1759,157,182,200,158,119,2575,
20221031,677,876,북평택,양감,2222,139,165,202,175,155,3058,2012,142,165,222,179,150,2870,
20221031,682,683,조암,송산마도,827,83,89,44,46,45,1134,975,106,97,72,66,45,1361,
20221031,682,684,조암,남안산,1085,170,195,84,91,50,1675,1112,142,172,107,94,57,1684,
20221031,682,685,조암,서시흥,1775,179,172,160,249,92,2627,2165,165,181,149,277,101,3038,
20221031,683,682,송산마도,조암,975,106,97,72,66,45,1361,827,83,89,44,46,45,1134,
20221031,683,684,송산마도,남안산,2500,178,145,106,193,145,3267,2143,170,115,93,117,129,2767,
20221031,683,685,송산마도,서시흥,5023,293,216,212,799,273,6816,4636,255,233,204,747,257,6332,
20221031,684,682,남안산,조암,1112,142,172,107,94,57,1684,1085,170,195,84,91,50,1675,
20221031,684,683,남안산,송산마도,2143,170,115,93,117,129,2767,2500,178,145,106,193,145,3267,
20221031,684,685,남안산,서시흥,5313,491,266,382,515,356,7323,4084,352,284,339,375,291,5725,
20221031,685,682,서시흥,조암,2165,165,181,149,277,101,3038,1775,179,172,160,249,92,2627,
20221031,685,683,서시흥,송산마도,4636,255,233,204,747,257,6332,5023,293,216,212,799,273,6816,
20221031,685,684,서시흥,남안산,4084,352,284,339,375,291,5725,5313,491,266,382,515,356,7323,
20221031,705,190,남이천,동서울,1272,101,57,72,57,50,1609,1463,101,43,129,93,61,1890,
20221031,706,641,남경주,울산,1182,4,23,22,33,69,1333,1146,9,20,15,41,62,1293,
20221031,706,707,남경주,남포항,984,31,69,33,227,60,1404,993,31,76,35,190,63,1388,
20221031,707,641,남포항,울산,1113,14,25,33,169,58,1412,1114,13,19,15,144,50,1355,
20221031,707,706,남포항,남경주,993,31,76,35,190,63,1388,984,31,69,33,227,60,1404,
20221031,707,708,남포항,동경주,1408,27,27,20,209,89,1780,1351,30,25,21,258,87,1772,
20221031,708,707,동경주,남포항,1351,30,25,21,258,87,1772,1408,27,27,20,209,89,1780,
20221031,715,716,동안동,청송,1226,24,16,12,30,59,1367,1127,32,15,18,24,61,1277,
20221031,716,715,청송,동안동,1127,32,15,18,24,61,1277,1226,24,16,12,30,59,1367,
20221031,730,519,유천,남대구,2857,58,8,0,0,205,3128,2396,63,12,0,28,163,2662,
20221031,731,519,북현풍,남대구,1520,25,5,0,0,118,1668,1942,18,28,0,8,116,2112,
20221031,741,520,평택고덕,평택,778,15,162,15,19,67,1056,880,13,188,17,21,82,1201,
20221031,741,540,평택고덕,청북,888,40,28,48,143,97,1244,857,32,35,49,139,88,1200,
20221031,742,107,남사진위,안성,1385,38,53,30,7,112,1625,1223,36,41,18,6,105,1429,
20221031,742,108,남사진위,천안,1044,27,36,24,8,72,1211,1083,20,41,16,15,71,1246,
20221031,752,252,기장철마,대동,1877,63,64,37,83,154,2278,1824,67,43,37,156,127,2254,
20221031,753,252,금정,대동,1096,63,77,65,79,63,1443,1760,89,105,83,187,126,2350,
20221031,755,140,광재,부산,1035,16,12,10,21,64,1158,1119,24,22,9,20,72,1266,
20221031,755,252,광재,대동,2277,106,96,78,489,122,3168,2460,89,86,88,314,147,3184,
20221031,756,252,한림,대동,960,47,40,27,88,42,1204,908,37,38,28,78,46,1135,
20221031,757,289,진영,마산,825,75,57,52,95,47,1151,742,41,57,42,91,42,1015,
20221031,772,774,북달성,남칠곡,2584,62,49,34,43,149,2921,2635,54,54,44,33,177,2997,
20221031,773,774,북다사,남칠곡,1284,23,16,9,16,94,1442,1319,16,13,18,12,87,1465,
20221031,774,772,남칠곡,북달성,2635,54,54,44,33,177,2997,2584,62,49,34,43,149,2921,
20221031,774,773,남칠곡,북다사,1319,16,13,18,12,87,1465,1284,23,16,9,16,94,1442,
20221031,775,203,동명동호,가산,1588,56,33,43,170,78,1968,1588,52,45,51,248,83,2067,
20221031,776,777,연경,파군재,3550,37,21,14,15,267,3904,2740,31,27,13,37,185,3033,
20221031,776,779,연경,율암,5761,99,64,73,192,426,6615,6078,83,89,75,176,477,6978,
20221031,777,776,파군재,연경,2740,31,27,13,37,185,3033,3550,37,21,14,15,267,3904,
20221031,777,779,파군재,율암,2659,26,15,3,5,232,2940,2680,29,15,9,6,227,2966,
20221031,779,776,율암,연경,6078,83,89,75,176,477,6978,5761,99,64,73,192,426,6615,
20221031,779,777,율암,파군재,2680,29,15,9,6,227,2966,2659,26,15,3,5,232,2940,
20221031,876,675,양감,서오산,1924,62,27,35,36,140,2224,1775,67,38,37,45,114,2076,
20221031,876,677,양감,북평택,2012,142,165,222,179,150,2870,2222,139,165,202,175,155,3058,
20221031,981,982,서영암,강진무위사,1626,30,57,58,38,73,1882,1828,43,74,88,43,72,2148,
20221031,981,987,서영암,남순천,1220,16,74,73,288,45,1716,1885,33,87,88,295,65,2453,
20221031,982,981,강진무위사,서영암,1828,43,74,88,43,72,2148,1626,30,57,58,38,73,1882,
20221031,984,985,보성,벌교,1653,38,32,24,82,49,1878,1310,43,38,23,60,44,1518,
20221031,984,987,보성,남순천,1833,29,56,95,298,57,2368,1943,37,84,57,279,57,2457,
20221031,985,984,벌교,보성,1310,43,38,23,60,44,1518,1653,38,32,24,82,49,1878,
20221031,986,987,고흥,남순천,3431,56,98,175,208,130,4098,3954,66,122,153,211,145,4651,
20221031,987,981,남순천,서영암,1885,33,87,88,295,65,2453,1220,16,74,73,288,45,1716,
20221031,987,984,남순천,보성,1943,37,84,57,279,57,2457,1833,29,56,95,298,57,2368,
20221031,987,986,남순천,고흥,3954,66,122,153,211,145,4651,3431,56,98,175,208,130,4098,
